호선,통행일자,역명, 이용인원 , 승차인원 , 하차인원 
1,2023-07-01,계양,6115,2931,3184
1,2023-07-01,귤현,1634,779,855
1,2023-07-01,박촌,5319,2816,2503
1,2023-07-01,임학,11591,5880,5711
1,2023-07-01,계산,17098,8585,8513
1,2023-07-01,경인교대입구,8796,4342,4454
1,2023-07-01,작전,20244,10446,9798
1,2023-07-01,갈산,9145,4794,4351
1,2023-07-01,부평구청,9828,4807,5021
1,2023-07-01,부평시장,18172,9104,9068
1,2023-07-01,부평,12594,6324,6270
1,2023-07-01,동수,5455,2782,2673
1,2023-07-01,부평삼거리,3829,1910,1919
1,2023-07-01,간석오거리,16249,8537,7712
1,2023-07-01,인천시청,6891,3536,3355
1,2023-07-01,예술회관,17766,8329,9437
1,2023-07-01,인천터미널,27003,13040,13963
1,2023-07-01,문학경기장,2427,1212,1215
1,2023-07-01,선학,9926,5024,4902
1,2023-07-01,신연수,6177,3239,2938
1,2023-07-01,원인재,3612,1946,1666
1,2023-07-01,동춘,15895,7878,8017
1,2023-07-01,동막,6405,3352,3053
1,2023-07-01,캠퍼스타운,7670,4003,3667
1,2023-07-01,테크노파크,18978,9380,9598
1,2023-07-01,지식정보단지,4247,2167,2080
1,2023-07-01,인천대입구,10250,5109,5141
1,2023-07-01,센트럴파크(재외동포청),7834,3807,4027
1,2023-07-01,국제업무지구,1684,900,784
1,2023-07-01,송도달빛축제공원,7854,3932,3922
1,2023-07-02,계양,4394,2048,2346
1,2023-07-02,귤현,1135,504,631
1,2023-07-02,박촌,4026,2027,1999
1,2023-07-02,임학,8640,4303,4337
1,2023-07-02,계산,13067,6453,6614
1,2023-07-02,경인교대입구,6972,3504,3468
1,2023-07-02,작전,14083,7157,6926
1,2023-07-02,갈산,6348,3231,3117
1,2023-07-02,부평구청,7055,3441,3614
1,2023-07-02,부평시장,14296,7117,7179
1,2023-07-02,부평,8623,4552,4071
1,2023-07-02,동수,4056,2098,1958
1,2023-07-02,부평삼거리,3161,1584,1577
1,2023-07-02,간석오거리,12092,6242,5850
1,2023-07-02,인천시청,5164,2624,2540
1,2023-07-02,예술회관,11523,5582,5941
1,2023-07-02,인천터미널,21836,11091,10745
1,2023-07-02,문학경기장,1169,567,602
1,2023-07-02,선학,7869,3833,4036
1,2023-07-02,신연수,4289,2205,2084
1,2023-07-02,원인재,2554,1312,1242
1,2023-07-02,동춘,11784,5828,5956
1,2023-07-02,동막,4248,2210,2038
1,2023-07-02,캠퍼스타운,5514,2749,2765
1,2023-07-02,테크노파크,14792,7263,7529
1,2023-07-02,지식정보단지,2990,1489,1501
1,2023-07-02,인천대입구,7841,3761,4080
1,2023-07-02,센트럴파크(재외동포청),5618,2762,2856
1,2023-07-02,국제업무지구,755,384,371
1,2023-07-02,송도달빛축제공원,6353,3155,3198
1,2023-07-03,계양,7313,3689,3624
1,2023-07-03,귤현,2386,941,1445
1,2023-07-03,박촌,7695,4048,3647
1,2023-07-03,임학,15582,7906,7676
1,2023-07-03,계산,19692,9961,9731
1,2023-07-03,경인교대입구,10614,5314,5300
1,2023-07-03,작전,27185,13826,13359
1,2023-07-03,갈산,19055,9720,9335
1,2023-07-03,부평구청,13715,6809,6906
1,2023-07-03,부평시장,26277,13233,13044
1,2023-07-03,부평,12725,6480,6245
1,2023-07-03,동수,8282,4223,4059
1,2023-07-03,부평삼거리,4984,2526,2458
1,2023-07-03,간석오거리,21319,11185,10134
1,2023-07-03,인천시청,10577,5370,5207
1,2023-07-03,예술회관,23438,11521,11917
1,2023-07-03,인천터미널,25431,12522,12909
1,2023-07-03,문학경기장,3518,1764,1754
1,2023-07-03,선학,11941,5974,5967
1,2023-07-03,신연수,11009,5570,5439
1,2023-07-03,원인재,5619,3038,2581
1,2023-07-03,동춘,20106,9730,10376
1,2023-07-03,동막,10780,5732,5048
1,2023-07-03,캠퍼스타운,11602,5838,5764
1,2023-07-03,테크노파크,20845,10310,10535
1,2023-07-03,지식정보단지,9811,4772,5039
1,2023-07-03,인천대입구,13317,6559,6758
1,2023-07-03,센트럴파크(재외동포청),7218,3630,3588
1,2023-07-03,국제업무지구,3521,1808,1713
1,2023-07-03,송도달빛축제공원,9854,4955,4899
1,2023-07-04,계양,7076,3585,3491
1,2023-07-04,귤현,2254,892,1362
1,2023-07-04,박촌,7706,4022,3684
1,2023-07-04,임학,15056,7565,7491
1,2023-07-04,계산,18231,9308,8923
1,2023-07-04,경인교대입구,10127,5129,4998
1,2023-07-04,작전,25967,13100,12867
1,2023-07-04,갈산,18578,9411,9167
1,2023-07-04,부평구청,12917,6394,6523
1,2023-07-04,부평시장,25035,12544,12491
1,2023-07-04,부평,12308,6298,6010
1,2023-07-04,동수,8276,4164,4112
1,2023-07-04,부평삼거리,4704,2416,2288
1,2023-07-04,간석오거리,20471,10632,9839
1,2023-07-04,인천시청,10283,5193,5090
1,2023-07-04,예술회관,22422,11089,11333
1,2023-07-04,인천터미널,23178,11566,11612
1,2023-07-04,문학경기장,3519,1766,1753
1,2023-07-04,선학,11242,5577,5665
1,2023-07-04,신연수,10458,5313,5145
1,2023-07-04,원인재,5205,2825,2380
1,2023-07-04,동춘,18673,9040,9633
1,2023-07-04,동막,10481,5558,4923
1,2023-07-04,캠퍼스타운,10895,5479,5416
1,2023-07-04,테크노파크,20178,10097,10081
1,2023-07-04,지식정보단지,9586,4584,5002
1,2023-07-04,인천대입구,12625,6234,6391
1,2023-07-04,센트럴파크(재외동포청),6718,3302,3416
1,2023-07-04,국제업무지구,3450,1756,1694
1,2023-07-04,송도달빛축제공원,8843,4446,4397
1,2023-07-05,계양,7511,3774,3737
1,2023-07-05,귤현,2476,975,1501
1,2023-07-05,박촌,8147,4314,3833
1,2023-07-05,임학,16143,8222,7921
1,2023-07-05,계산,20419,10349,10070
1,2023-07-05,경인교대입구,11035,5510,5525
1,2023-07-05,작전,27928,14199,13729
1,2023-07-05,갈산,19443,9874,9569
1,2023-07-05,부평구청,13997,6951,7046
1,2023-07-05,부평시장,27028,13512,13516
1,2023-07-05,부평,13686,6963,6723
1,2023-07-05,동수,8615,4374,4241
1,2023-07-05,부평삼거리,5168,2686,2482
1,2023-07-05,간석오거리,22289,11583,10706
1,2023-07-05,인천시청,11591,5954,5637
1,2023-07-05,예술회관,24797,12151,12646
1,2023-07-05,인천터미널,25768,12633,13135
1,2023-07-05,문학경기장,12354,6025,6329
1,2023-07-05,선학,12725,6387,6338
1,2023-07-05,신연수,11120,5658,5462
1,2023-07-05,원인재,5964,3226,2738
1,2023-07-05,동춘,21414,10543,10871
1,2023-07-05,동막,11256,5954,5302
1,2023-07-05,캠퍼스타운,12097,6114,5983
1,2023-07-05,테크노파크,22097,10953,11144
1,2023-07-05,지식정보단지,10001,4856,5145
1,2023-07-05,인천대입구,13938,6917,7021
1,2023-07-05,센트럴파크(재외동포청),7976,3972,4004
1,2023-07-05,국제업무지구,3485,1783,1702
1,2023-07-05,송도달빛축제공원,10605,5184,5421
1,2023-07-06,계양,7945,3976,3969
1,2023-07-06,귤현,2436,1001,1435
1,2023-07-06,박촌,7892,4144,3748
1,2023-07-06,임학,16567,8359,8208
1,2023-07-06,계산,20447,10395,10052
1,2023-07-06,경인교대입구,10852,5426,5426
1,2023-07-06,작전,28064,14327,13737
1,2023-07-06,갈산,19526,9903,9623
1,2023-07-06,부평구청,14390,7062,7328
1,2023-07-06,부평시장,26993,13497,13496
1,2023-07-06,부평,13680,7046,6634
1,2023-07-06,동수,8560,4357,4203
1,2023-07-06,부평삼거리,5453,2778,2675
1,2023-07-06,간석오거리,22381,11730,10651
1,2023-07-06,인천시청,11380,5712,5668
1,2023-07-06,예술회관,24006,11722,12284
1,2023-07-06,인천터미널,26812,13244,13568
1,2023-07-06,문학경기장,15587,7526,8061
1,2023-07-06,선학,12413,6117,6296
1,2023-07-06,신연수,11185,5701,5484
1,2023-07-06,원인재,5932,3190,2742
1,2023-07-06,동춘,21544,10556,10988
1,2023-07-06,동막,11694,6130,5564
1,2023-07-06,캠퍼스타운,12303,6159,6144
1,2023-07-06,테크노파크,22715,11342,11373
1,2023-07-06,지식정보단지,10365,5121,5244
1,2023-07-06,인천대입구,14897,7427,7470
1,2023-07-06,센트럴파크(재외동포청),8130,4014,4116
1,2023-07-06,국제업무지구,3608,1840,1768
1,2023-07-06,송도달빛축제공원,10658,5353,5305
1,2023-07-07,계양,7683,3890,3793
1,2023-07-07,귤현,2510,1039,1471
1,2023-07-07,박촌,8256,4372,3884
1,2023-07-07,임학,16867,8532,8335
1,2023-07-07,계산,20995,10735,10260
1,2023-07-07,경인교대입구,11156,5597,5559
1,2023-07-07,작전,28844,14747,14097
1,2023-07-07,갈산,19485,9912,9573
1,2023-07-07,부평구청,14110,6971,7139
1,2023-07-07,부평시장,27374,13760,13614
1,2023-07-07,부평,14832,7441,7391
1,2023-07-07,동수,8566,4403,4163
1,2023-07-07,부평삼거리,5261,2697,2564
1,2023-07-07,간석오거리,22676,11883,10793
1,2023-07-07,인천시청,11551,5870,5681
1,2023-07-07,예술회관,26290,12559,13731
1,2023-07-07,인천터미널,30930,14811,16119
1,2023-07-07,문학경기장,3759,1904,1855
1,2023-07-07,선학,13223,6705,6518
1,2023-07-07,신연수,11648,6006,5642
1,2023-07-07,원인재,5987,3162,2825
1,2023-07-07,동춘,22126,10825,11301
1,2023-07-07,동막,12234,6504,5730
1,2023-07-07,캠퍼스타운,12745,6451,6294
1,2023-07-07,테크노파크,23400,11638,11762
1,2023-07-07,지식정보단지,10109,4985,5124
1,2023-07-07,인천대입구,15793,7868,7925
1,2023-07-07,센트럴파크(재외동포청),8860,4432,4428
1,2023-07-07,국제업무지구,3666,1772,1894
1,2023-07-07,송도달빛축제공원,10581,5497,5084
1,2023-07-08,계양,6292,3057,3235
1,2023-07-08,귤현,1578,682,896
1,2023-07-08,박촌,5577,2921,2656
1,2023-07-08,임학,12160,6268,5892
1,2023-07-08,계산,17397,8723,8674
1,2023-07-08,경인교대입구,8890,4554,4336
1,2023-07-08,작전,21304,10925,10379
1,2023-07-08,갈산,9523,4993,4530
1,2023-07-08,부평구청,10238,5022,5216
1,2023-07-08,부평시장,18835,9357,9478
1,2023-07-08,부평,13567,6905,6662
1,2023-07-08,동수,5661,2890,2771
1,2023-07-08,부평삼거리,4060,2022,2038
1,2023-07-08,간석오거리,16565,8729,7836
1,2023-07-08,인천시청,7528,3927,3601
1,2023-07-08,예술회관,19424,9229,10195
1,2023-07-08,인천터미널,27452,13328,14124
1,2023-07-08,문학경기장,2800,1342,1458
1,2023-07-08,선학,10433,5215,5218
1,2023-07-08,신연수,6292,3300,2992
1,2023-07-08,원인재,3945,2076,1869
1,2023-07-08,동춘,16191,7977,8214
1,2023-07-08,동막,6797,3522,3275
1,2023-07-08,캠퍼스타운,8098,4187,3911
1,2023-07-08,테크노파크,20545,10076,10469
1,2023-07-08,지식정보단지,4230,2165,2065
1,2023-07-08,인천대입구,11565,5724,5841
1,2023-07-08,센트럴파크(재외동포청),7940,3973,3967
1,2023-07-08,국제업무지구,1708,904,804
1,2023-07-08,송도달빛축제공원,8299,4176,4123
1,2023-07-09,계양,3916,1708,2208
1,2023-07-09,귤현,1023,462,561
1,2023-07-09,박촌,3836,2000,1836
1,2023-07-09,임학,7751,3872,3879
1,2023-07-09,계산,11536,5783,5753
1,2023-07-09,경인교대입구,6601,3243,3358
1,2023-07-09,작전,12758,6535,6223
1,2023-07-09,갈산,5836,2931,2905
1,2023-07-09,부평구청,6652,3210,3442
1,2023-07-09,부평시장,12972,6473,6499
1,2023-07-09,부평,8586,4520,4066
1,2023-07-09,동수,3828,1960,1868
1,2023-07-09,부평삼거리,2722,1356,1366
1,2023-07-09,간석오거리,11055,5743,5312
1,2023-07-09,인천시청,4808,2455,2353
1,2023-07-09,예술회관,11659,5568,6091
1,2023-07-09,인천터미널,20593,10569,10024
1,2023-07-09,문학경기장,1260,600,660
1,2023-07-09,선학,7068,3465,3603
1,2023-07-09,신연수,3882,2017,1865
1,2023-07-09,원인재,2382,1238,1144
1,2023-07-09,동춘,8421,4121,4300
1,2023-07-09,동막,4084,2082,2002
1,2023-07-09,캠퍼스타운,5374,2702,2672
1,2023-07-09,테크노파크,14655,7287,7368
1,2023-07-09,지식정보단지,2751,1373,1378
1,2023-07-09,인천대입구,7954,3818,4136
1,2023-07-09,센트럴파크(재외동포청),4093,1984,2109
1,2023-07-09,국제업무지구,721,385,336
1,2023-07-09,송도달빛축제공원,5773,2832,2941
1,2023-07-10,계양,7334,3685,3649
1,2023-07-10,귤현,2300,912,1388
1,2023-07-10,박촌,7787,4124,3663
1,2023-07-10,임학,15659,7883,7776
1,2023-07-10,계산,19308,9844,9464
1,2023-07-10,경인교대입구,10495,5241,5254
1,2023-07-10,작전,27086,13788,13298
1,2023-07-10,갈산,18970,9600,9370
1,2023-07-10,부평구청,13422,6655,6767
1,2023-07-10,부평시장,25962,13000,12962
1,2023-07-10,부평,12650,6431,6219
1,2023-07-10,동수,8106,4137,3969
1,2023-07-10,부평삼거리,5100,2595,2505
1,2023-07-10,간석오거리,21180,11059,10121
1,2023-07-10,인천시청,10697,5438,5259
1,2023-07-10,예술회관,23329,11468,11861
1,2023-07-10,인천터미널,23271,11428,11843
1,2023-07-10,문학경기장,3389,1733,1656
1,2023-07-10,선학,11959,5968,5991
1,2023-07-10,신연수,10870,5576,5294
1,2023-07-10,원인재,5530,2977,2553
1,2023-07-10,동춘,20507,9944,10563
1,2023-07-10,동막,10680,5703,4977
1,2023-07-10,캠퍼스타운,11519,5819,5700
1,2023-07-10,테크노파크,20977,10447,10530
1,2023-07-10,지식정보단지,9777,4751,5026
1,2023-07-10,인천대입구,12747,6269,6478
1,2023-07-10,센트럴파크(재외동포청),7115,3577,3538
1,2023-07-10,국제업무지구,3466,1777,1689
1,2023-07-10,송도달빛축제공원,9462,4764,4698
1,2023-07-11,계양,6936,3501,3435
1,2023-07-11,귤현,2231,887,1344
1,2023-07-11,박촌,7422,3881,3541
1,2023-07-11,임학,14758,7522,7236
1,2023-07-11,계산,18102,9186,8916
1,2023-07-11,경인교대입구,10062,5012,5050
1,2023-07-11,작전,25612,12980,12632
1,2023-07-11,갈산,18593,9428,9165
1,2023-07-11,부평구청,12980,6409,6571
1,2023-07-11,부평시장,24294,12119,12175
1,2023-07-11,부평,11706,5911,5795
1,2023-07-11,동수,8269,4231,4038
1,2023-07-11,부평삼거리,4869,2456,2413
1,2023-07-11,간석오거리,20568,10795,9773
1,2023-07-11,인천시청,10613,5437,5176
1,2023-07-11,예술회관,22429,11022,11407
1,2023-07-11,인천터미널,23577,11619,11958
1,2023-07-11,문학경기장,3557,1790,1767
1,2023-07-11,선학,11298,5544,5754
1,2023-07-11,신연수,10475,5347,5128
1,2023-07-11,원인재,5431,2964,2467
1,2023-07-11,동춘,19273,9442,9831
1,2023-07-11,동막,10569,5554,5015
1,2023-07-11,캠퍼스타운,11061,5539,5522
1,2023-07-11,테크노파크,19950,9860,10090
1,2023-07-11,지식정보단지,9581,4608,4973
1,2023-07-11,인천대입구,12486,6160,6326
1,2023-07-11,센트럴파크(재외동포청),6981,3502,3479
1,2023-07-11,국제업무지구,3551,1824,1727
1,2023-07-11,송도달빛축제공원,9010,4490,4520
1,2023-07-12,계양,8187,4067,4120
1,2023-07-12,귤현,2478,980,1498
1,2023-07-12,박촌,8520,4495,4025
1,2023-07-12,임학,16242,8195,8047
1,2023-07-12,계산,20192,10143,10049
1,2023-07-12,경인교대입구,11140,5614,5526
1,2023-07-12,작전,28394,14426,13968
1,2023-07-12,갈산,19586,9986,9600
1,2023-07-12,부평구청,14456,7212,7244
1,2023-07-12,부평시장,27173,13596,13577
1,2023-07-12,부평,13694,6942,6752
1,2023-07-12,동수,8841,4457,4384
1,2023-07-12,부평삼거리,5395,2738,2657
1,2023-07-12,간석오거리,22644,11796,10848
1,2023-07-12,인천시청,11287,5765,5522
1,2023-07-12,예술회관,24596,12031,12565
1,2023-07-12,인천터미널,26753,13201,13552
1,2023-07-12,문학경기장,14925,7267,7658
1,2023-07-12,선학,12863,6355,6508
1,2023-07-12,신연수,11529,5881,5648
1,2023-07-12,원인재,5954,3227,2727
1,2023-07-12,동춘,21909,10687,11222
1,2023-07-12,동막,11730,6273,5457
1,2023-07-12,캠퍼스타운,12106,6199,5907
1,2023-07-12,테크노파크,22647,11376,11271
1,2023-07-12,지식정보단지,10250,5033,5217
1,2023-07-12,인천대입구,16077,7836,8241
1,2023-07-12,센트럴파크(재외동포청),7916,4071,3845
1,2023-07-12,국제업무지구,3768,1904,1864
1,2023-07-12,송도달빛축제공원,10376,5127,5249
1,2023-07-13,계양,6746,3396,3350
1,2023-07-13,귤현,2230,870,1360
1,2023-07-13,박촌,7339,3846,3493
1,2023-07-13,임학,14720,7393,7327
1,2023-07-13,계산,17941,9168,8773
1,2023-07-13,경인교대입구,10016,5045,4971
1,2023-07-13,작전,25438,12879,12559
1,2023-07-13,갈산,18570,9469,9101
1,2023-07-13,부평구청,12852,6332,6520
1,2023-07-13,부평시장,23680,11843,11837
1,2023-07-13,부평,12175,6212,5963
1,2023-07-13,동수,8169,4121,4048
1,2023-07-13,부평삼거리,4529,2305,2224
1,2023-07-13,간석오거리,20288,10653,9635
1,2023-07-13,인천시청,10163,5095,5068
1,2023-07-13,예술회관,21871,10757,11114
1,2023-07-13,인천터미널,22771,11301,11470
1,2023-07-13,문학경기장,3256,1642,1614
1,2023-07-13,선학,11293,5584,5709
1,2023-07-13,신연수,10088,5119,4969
1,2023-07-13,원인재,5368,2901,2467
1,2023-07-13,동춘,18770,9017,9753
1,2023-07-13,동막,11370,5988,5382
1,2023-07-13,캠퍼스타운,10733,5330,5403
1,2023-07-13,테크노파크,19644,9817,9827
1,2023-07-13,지식정보단지,9244,4486,4758
1,2023-07-13,인천대입구,13489,6891,6598
1,2023-07-13,센트럴파크(재외동포청),6595,3302,3293
1,2023-07-13,국제업무지구,3443,1771,1672
1,2023-07-13,송도달빛축제공원,8685,4345,4340
1,2023-07-14,계양,6922,3463,3459
1,2023-07-14,귤현,2307,952,1355
1,2023-07-14,박촌,7718,4073,3645
1,2023-07-14,임학,15672,7912,7760
1,2023-07-14,계산,18858,9587,9271
1,2023-07-14,경인교대입구,10436,5237,5199
1,2023-07-14,작전,26922,13700,13222
1,2023-07-14,갈산,18479,9381,9098
1,2023-07-14,부평구청,12991,6394,6597
1,2023-07-14,부평시장,24869,12431,12438
1,2023-07-14,부평,13550,6784,6766
1,2023-07-14,동수,8220,4216,4004
1,2023-07-14,부평삼거리,4825,2475,2350
1,2023-07-14,간석오거리,20721,10900,9821
1,2023-07-14,인천시청,10557,5374,5183
1,2023-07-14,예술회관,23724,11303,12421
1,2023-07-14,인천터미널,26895,13020,13875
1,2023-07-14,문학경기장,3228,1665,1563
1,2023-07-14,선학,11934,5967,5967
1,2023-07-14,신연수,10274,5259,5015
1,2023-07-14,원인재,5548,2981,2567
1,2023-07-14,동춘,20125,9718,10407
1,2023-07-14,동막,10998,5830,5168
1,2023-07-14,캠퍼스타운,11357,5753,5604
1,2023-07-14,테크노파크,20794,10365,10429
1,2023-07-14,지식정보단지,9298,4541,4757
1,2023-07-14,인천대입구,13566,6741,6825
1,2023-07-14,센트럴파크(재외동포청),7132,3512,3620
1,2023-07-14,국제업무지구,3486,1786,1700
1,2023-07-14,송도달빛축제공원,9215,4637,4578
1,2023-07-15,계양,5327,2549,2778
1,2023-07-15,귤현,1518,705,813
1,2023-07-15,박촌,5169,2714,2455
1,2023-07-15,임학,10856,5542,5314
1,2023-07-15,계산,14923,7503,7420
1,2023-07-15,경인교대입구,8336,4162,4174
1,2023-07-15,작전,19460,10063,9397
1,2023-07-15,갈산,8917,4562,4355
1,2023-07-15,부평구청,9266,4565,4701
1,2023-07-15,부평시장,17774,8847,8927
1,2023-07-15,부평,12503,6324,6179
1,2023-07-15,동수,5235,2751,2484
1,2023-07-15,부평삼거리,3678,1826,1852
1,2023-07-15,간석오거리,15822,8185,7637
1,2023-07-15,인천시청,6863,3500,3363
1,2023-07-15,예술회관,17342,8190,9152
1,2023-07-15,인천터미널,26126,12792,13334
1,2023-07-15,문학경기장,1933,920,1013
1,2023-07-15,선학,9713,4927,4786
1,2023-07-15,신연수,5929,3098,2831
1,2023-07-15,원인재,3671,1946,1725
1,2023-07-15,동춘,14849,7392,7457
1,2023-07-15,동막,6453,3421,3032
1,2023-07-15,캠퍼스타운,7484,3840,3644
1,2023-07-15,테크노파크,18423,9044,9379
1,2023-07-15,지식정보단지,4072,2075,1997
1,2023-07-15,인천대입구,10623,5230,5393
1,2023-07-15,센트럴파크(재외동포청),6966,3376,3590
1,2023-07-15,국제업무지구,2031,953,1078
1,2023-07-15,송도달빛축제공원,16325,7993,8332
1,2023-07-16,계양,4096,1879,2217
1,2023-07-16,귤현,1012,466,546
1,2023-07-16,박촌,4027,2070,1957
1,2023-07-16,임학,8230,4097,4133
1,2023-07-16,계산,11636,5795,5841
1,2023-07-16,경인교대입구,6715,3358,3357
1,2023-07-16,작전,13573,6904,6669
1,2023-07-16,갈산,6139,3142,2997
1,2023-07-16,부평구청,6618,3224,3394
1,2023-07-16,부평시장,13444,6795,6649
1,2023-07-16,부평,9295,4858,4437
1,2023-07-16,동수,3987,2006,1981
1,2023-07-16,부평삼거리,3124,1550,1574
1,2023-07-16,간석오거리,11779,6241,5538
1,2023-07-16,인천시청,5024,2547,2477
1,2023-07-16,예술회관,11947,5744,6203
1,2023-07-16,인천터미널,21489,10922,10567
1,2023-07-16,문학경기장,1260,619,641
1,2023-07-16,선학,7297,3674,3623
1,2023-07-16,신연수,4291,2223,2068
1,2023-07-16,원인재,2796,1463,1333
1,2023-07-16,동춘,11198,5502,5696
1,2023-07-16,동막,4255,2193,2062
1,2023-07-16,캠퍼스타운,5605,2824,2781
1,2023-07-16,테크노파크,14783,7321,7462
1,2023-07-16,지식정보단지,2799,1401,1398
1,2023-07-16,인천대입구,8161,3968,4193
1,2023-07-16,센트럴파크(재외동포청),4721,2321,2400
1,2023-07-16,국제업무지구,733,375,358
1,2023-07-16,송도달빛축제공원,5963,3012,2951
1,2023-07-17,계양,7251,3641,3610
1,2023-07-17,귤현,2358,926,1432
1,2023-07-17,박촌,7680,4020,3660
1,2023-07-17,임학,15714,7949,7765
1,2023-07-17,계산,19396,9863,9533
1,2023-07-17,경인교대입구,10483,5257,5226
1,2023-07-17,작전,26975,13650,13325
1,2023-07-17,갈산,18699,9527,9172
1,2023-07-17,부평구청,12964,6417,6547
1,2023-07-17,부평시장,26061,13127,12934
1,2023-07-17,부평,13008,6618,6390
1,2023-07-17,동수,8447,4288,4159
1,2023-07-17,부평삼거리,5248,2646,2602
1,2023-07-17,간석오거리,20981,10935,10046
1,2023-07-17,인천시청,10666,5346,5320
1,2023-07-17,예술회관,23144,11368,11776
1,2023-07-17,인천터미널,25192,12433,12759
1,2023-07-17,문학경기장,3302,1645,1657
1,2023-07-17,선학,11788,5908,5880
1,2023-07-17,신연수,10838,5487,5351
1,2023-07-17,원인재,5622,3074,2548
1,2023-07-17,동춘,20313,9797,10516
1,2023-07-17,동막,10712,5712,5000
1,2023-07-17,캠퍼스타운,11560,5821,5739
1,2023-07-17,테크노파크,20636,10258,10378
1,2023-07-17,지식정보단지,9670,4695,4975
1,2023-07-17,인천대입구,12948,6386,6562
1,2023-07-17,센트럴파크(재외동포청),7281,3607,3674
1,2023-07-17,국제업무지구,3503,1818,1685
1,2023-07-17,송도달빛축제공원,9655,4827,4828
1,2023-07-18,계양,7327,3734,3593
1,2023-07-18,귤현,2360,915,1445
1,2023-07-18,박촌,7860,4159,3701
1,2023-07-18,임학,15914,8020,7894
1,2023-07-18,계산,18975,9609,9366
1,2023-07-18,경인교대입구,10659,5367,5292
1,2023-07-18,작전,26793,13645,13148
1,2023-07-18,갈산,18958,9564,9394
1,2023-07-18,부평구청,13695,6731,6964
1,2023-07-18,부평시장,25772,12932,12840
1,2023-07-18,부평,12544,6354,6190
1,2023-07-18,동수,8577,4338,4239
1,2023-07-18,부평삼거리,5151,2637,2514
1,2023-07-18,간석오거리,21124,11127,9997
1,2023-07-18,인천시청,11048,5612,5436
1,2023-07-18,예술회관,23668,11557,12111
1,2023-07-18,인천터미널,24927,12331,12596
1,2023-07-18,문학경기장,3604,1791,1813
1,2023-07-18,선학,11733,5794,5939
1,2023-07-18,신연수,10556,5399,5157
1,2023-07-18,원인재,5728,3080,2648
1,2023-07-18,동춘,20148,9808,10340
1,2023-07-18,동막,10751,5691,5060
1,2023-07-18,캠퍼스타운,11218,5662,5556
1,2023-07-18,테크노파크,21064,10421,10643
1,2023-07-18,지식정보단지,9786,4775,5011
1,2023-07-18,인천대입구,12760,6348,6412
1,2023-07-18,센트럴파크(재외동포청),7297,3639,3658
1,2023-07-18,국제업무지구,3448,1761,1687
1,2023-07-18,송도달빛축제공원,9292,4647,4645
1,2023-07-19,계양,7494,3804,3690
1,2023-07-19,귤현,2364,921,1443
1,2023-07-19,박촌,7902,4173,3729
1,2023-07-19,임학,16161,8126,8035
1,2023-07-19,계산,19924,9968,9956
1,2023-07-19,경인교대입구,10856,5484,5372
1,2023-07-19,작전,27721,14147,13574
1,2023-07-19,갈산,19172,9783,9389
1,2023-07-19,부평구청,13644,6720,6924
1,2023-07-19,부평시장,26840,13481,13359
1,2023-07-19,부평,13797,6968,6829
1,2023-07-19,동수,8753,4466,4287
1,2023-07-19,부평삼거리,5323,2754,2569
1,2023-07-19,간석오거리,22199,11597,10602
1,2023-07-19,인천시청,11673,5939,5734
1,2023-07-19,예술회관,24582,11964,12618
1,2023-07-19,인천터미널,26528,13072,13456
1,2023-07-19,문학경기장,3392,1693,1699
1,2023-07-19,선학,12728,6364,6364
1,2023-07-19,신연수,11216,5698,5518
1,2023-07-19,원인재,6004,3253,2751
1,2023-07-19,동춘,21161,10380,10781
1,2023-07-19,동막,12026,6371,5655
1,2023-07-19,캠퍼스타운,11785,5981,5804
1,2023-07-19,테크노파크,22231,11119,11112
1,2023-07-19,지식정보단지,9955,4900,5055
1,2023-07-19,인천대입구,13726,6852,6874
1,2023-07-19,센트럴파크(재외동포청),8578,4241,4337
1,2023-07-19,국제업무지구,3616,1834,1782
1,2023-07-19,송도달빛축제공원,9927,4941,4986
1,2023-07-20,계양,7763,3902,3861
1,2023-07-20,귤현,2378,949,1429
1,2023-07-20,박촌,7825,4094,3731
1,2023-07-20,임학,16188,8157,8031
1,2023-07-20,계산,19447,9806,9641
1,2023-07-20,경인교대입구,10771,5346,5425
1,2023-07-20,작전,27668,14162,13506
1,2023-07-20,갈산,19055,9604,9451
1,2023-07-20,부평구청,14082,6995,7087
1,2023-07-20,부평시장,26440,13332,13108
1,2023-07-20,부평,14294,7273,7021
1,2023-07-20,동수,8604,4399,4205
1,2023-07-20,부평삼거리,5537,2807,2730
1,2023-07-20,간석오거리,21588,11221,10367
1,2023-07-20,인천시청,11394,5644,5750
1,2023-07-20,예술회관,24661,12076,12585
1,2023-07-20,인천터미널,26579,13161,13418
1,2023-07-20,문학경기장,3636,1893,1743
1,2023-07-20,선학,12399,6209,6190
1,2023-07-20,신연수,10971,5615,5356
1,2023-07-20,원인재,6176,3269,2907
1,2023-07-20,동춘,21423,10444,10979
1,2023-07-20,동막,10938,5711,5227
1,2023-07-20,캠퍼스타운,11715,5900,5815
1,2023-07-20,테크노파크,22528,11163,11365
1,2023-07-20,지식정보단지,9800,4766,5034
1,2023-07-20,인천대입구,13525,6736,6789
1,2023-07-20,센트럴파크(재외동포청),8049,3942,4107
1,2023-07-20,국제업무지구,3533,1807,1726
1,2023-07-20,송도달빛축제공원,10019,5069,4950
1,2023-07-21,계양,7757,3898,3859
1,2023-07-21,귤현,2305,917,1388
1,2023-07-21,박촌,7469,3981,3488
1,2023-07-21,임학,16097,8116,7981
1,2023-07-21,계산,20056,10180,9876
1,2023-07-21,경인교대입구,11130,5515,5615
1,2023-07-21,작전,27896,14303,13593
1,2023-07-21,갈산,18959,9560,9399
1,2023-07-21,부평구청,13628,6774,6854
1,2023-07-21,부평시장,26648,13338,13310
1,2023-07-21,부평,14595,7303,7292
1,2023-07-21,동수,8550,4429,4121
1,2023-07-21,부평삼거리,4995,2584,2411
1,2023-07-21,간석오거리,22020,11580,10440
1,2023-07-21,인천시청,10982,5619,5363
1,2023-07-21,예술회관,25233,12091,13142
1,2023-07-21,인천터미널,28951,13986,14965
1,2023-07-21,문학경기장,3539,1818,1721
1,2023-07-21,선학,12740,6446,6294
1,2023-07-21,신연수,10935,5628,5307
1,2023-07-21,원인재,6146,3266,2880
1,2023-07-21,동춘,21995,10733,11262
1,2023-07-21,동막,10964,5814,5150
1,2023-07-21,캠퍼스타운,11551,5837,5714
1,2023-07-21,테크노파크,22789,11472,11317
1,2023-07-21,지식정보단지,9737,4758,4979
1,2023-07-21,인천대입구,13518,6670,6848
1,2023-07-21,센트럴파크(재외동포청),8132,4051,4081
1,2023-07-21,국제업무지구,3646,1861,1785
1,2023-07-21,송도달빛축제공원,10241,5271,4970
1,2023-07-22,계양,5529,2673,2856
1,2023-07-22,귤현,1453,677,776
1,2023-07-22,박촌,5125,2695,2430
1,2023-07-22,임학,11037,5619,5418
1,2023-07-22,계산,15809,7949,7860
1,2023-07-22,경인교대입구,8671,4368,4303
1,2023-07-22,작전,19370,9961,9409
1,2023-07-22,갈산,8962,4662,4300
1,2023-07-22,부평구청,9208,4487,4721
1,2023-07-22,부평시장,17731,8803,8928
1,2023-07-22,부평,12494,6411,6083
1,2023-07-22,동수,5252,2721,2531
1,2023-07-22,부평삼거리,3849,1894,1955
1,2023-07-22,간석오거리,15651,8197,7454
1,2023-07-22,인천시청,6978,3602,3376
1,2023-07-22,예술회관,16680,7834,8846
1,2023-07-22,인천터미널,25336,12424,12912
1,2023-07-22,문학경기장,1855,909,946
1,2023-07-22,선학,9619,4871,4748
1,2023-07-22,신연수,5939,3123,2816
1,2023-07-22,원인재,3604,1937,1667
1,2023-07-22,동춘,14715,7220,7495
1,2023-07-22,동막,6496,3423,3073
1,2023-07-22,캠퍼스타운,7192,3702,3490
1,2023-07-22,테크노파크,17866,8721,9145
1,2023-07-22,지식정보단지,4118,2065,2053
1,2023-07-22,인천대입구,9479,4600,4879
1,2023-07-22,센트럴파크(재외동포청),5951,2966,2985
1,2023-07-22,국제업무지구,1689,910,779
1,2023-07-22,송도달빛축제공원,7143,3653,3490
1,2023-07-23,계양,3246,1494,1752
1,2023-07-23,귤현,909,438,471
1,2023-07-23,박촌,3344,1738,1606
1,2023-07-23,임학,6875,3419,3456
1,2023-07-23,계산,9413,4784,4629
1,2023-07-23,경인교대입구,5846,2883,2963
1,2023-07-23,작전,11313,5693,5620
1,2023-07-23,갈산,5382,2727,2655
1,2023-07-23,부평구청,5803,2790,3013
1,2023-07-23,부평시장,11539,5801,5738
1,2023-07-23,부평,7841,4145,3696
1,2023-07-23,동수,3300,1678,1622
1,2023-07-23,부평삼거리,2301,1138,1163
1,2023-07-23,간석오거리,9905,5087,4818
1,2023-07-23,인천시청,4454,2247,2207
1,2023-07-23,예술회관,10827,5264,5563
1,2023-07-23,인천터미널,18335,9326,9009
1,2023-07-23,문학경기장,731,359,372
1,2023-07-23,선학,6094,3044,3050
1,2023-07-23,신연수,3655,1884,1771
1,2023-07-23,원인재,2218,1201,1017
1,2023-07-23,동춘,7864,3945,3919
1,2023-07-23,동막,3669,1916,1753
1,2023-07-23,캠퍼스타운,4612,2329,2283
1,2023-07-23,테크노파크,12667,6246,6421
1,2023-07-23,지식정보단지,2408,1189,1219
1,2023-07-23,인천대입구,6307,3064,3243
1,2023-07-23,센트럴파크(재외동포청),3565,1720,1845
1,2023-07-23,국제업무지구,678,365,313
1,2023-07-23,송도달빛축제공원,4907,2397,2510
1,2023-07-24,계양,7179,3551,3628
1,2023-07-24,귤현,2215,867,1348
1,2023-07-24,박촌,7052,3749,3303
1,2023-07-24,임학,15054,7642,7412
1,2023-07-24,계산,18727,9425,9302
1,2023-07-24,경인교대입구,10173,5138,5035
1,2023-07-24,작전,26294,13367,12927
1,2023-07-24,갈산,18371,9265,9106
1,2023-07-24,부평구청,13001,6472,6529
1,2023-07-24,부평시장,25073,12554,12519
1,2023-07-24,부평,13282,6718,6564
1,2023-07-24,동수,8048,4120,3928
1,2023-07-24,부평삼거리,4740,2375,2365
1,2023-07-24,간석오거리,20570,10819,9751
1,2023-07-24,인천시청,10086,5086,5000
1,2023-07-24,예술회관,22781,11157,11624
1,2023-07-24,인천터미널,24889,12390,12499
1,2023-07-24,문학경기장,3526,1784,1742
1,2023-07-24,선학,11594,5768,5826
1,2023-07-24,신연수,10607,5409,5198
1,2023-07-24,원인재,5450,2922,2528
1,2023-07-24,동춘,20502,9912,10590
1,2023-07-24,동막,10603,5665,4938
1,2023-07-24,캠퍼스타운,10838,5425,5413
1,2023-07-24,테크노파크,20723,10266,10457
1,2023-07-24,지식정보단지,9498,4598,4900
1,2023-07-24,인천대입구,12271,6091,6180
1,2023-07-24,센트럴파크(재외동포청),6951,3511,3440
1,2023-07-24,국제업무지구,3384,1710,1674
1,2023-07-24,송도달빛축제공원,9488,4792,4696
1,2023-07-25,계양,7191,3649,3542
1,2023-07-25,귤현,2335,950,1385
1,2023-07-25,박촌,7173,3785,3388
1,2023-07-25,임학,15504,7810,7694
1,2023-07-25,계산,18660,9484,9176
1,2023-07-25,경인교대입구,10406,5227,5179
1,2023-07-25,작전,26587,13582,13005
1,2023-07-25,갈산,18714,9438,9276
1,2023-07-25,부평구청,13397,6598,6799
1,2023-07-25,부평시장,25772,12994,12778
1,2023-07-25,부평,12849,6516,6333
1,2023-07-25,동수,8102,4155,3947
1,2023-07-25,부평삼거리,4663,2371,2292
1,2023-07-25,간석오거리,21206,11072,10134
1,2023-07-25,인천시청,10541,5387,5154
1,2023-07-25,예술회관,23411,11339,12072
1,2023-07-25,인천터미널,25371,12489,12882
1,2023-07-25,문학경기장,3647,1735,1912
1,2023-07-25,선학,11967,5930,6037
1,2023-07-25,신연수,10692,5462,5230
1,2023-07-25,원인재,5707,3119,2588
1,2023-07-25,동춘,20508,9992,10516
1,2023-07-25,동막,10627,5605,5022
1,2023-07-25,캠퍼스타운,10717,5387,5330
1,2023-07-25,테크노파크,20828,10390,10438
1,2023-07-25,지식정보단지,9518,4648,4870
1,2023-07-25,인천대입구,12458,6194,6264
1,2023-07-25,센트럴파크(재외동포청),7314,3646,3668
1,2023-07-25,국제업무지구,3596,1800,1796
1,2023-07-25,송도달빛축제공원,9543,4856,4687
1,2023-07-26,계양,7234,3637,3597
1,2023-07-26,귤현,2181,866,1315
1,2023-07-26,박촌,7511,3963,3548
1,2023-07-26,임학,15492,7808,7684
1,2023-07-26,계산,19114,9607,9507
1,2023-07-26,경인교대입구,10410,5187,5223
1,2023-07-26,작전,26919,13727,13192
1,2023-07-26,갈산,18875,9512,9363
1,2023-07-26,부평구청,13514,6676,6838
1,2023-07-26,부평시장,26087,13022,13065
1,2023-07-26,부평,13915,7092,6823
1,2023-07-26,동수,8236,4214,4022
1,2023-07-26,부평삼거리,4612,2318,2294
1,2023-07-26,간석오거리,21423,11155,10268
1,2023-07-26,인천시청,10610,5375,5235
1,2023-07-26,예술회관,23484,11455,12029
1,2023-07-26,인천터미널,25439,12456,12983
1,2023-07-26,문학경기장,3312,1650,1662
1,2023-07-26,선학,11860,5922,5938
1,2023-07-26,신연수,10346,5301,5045
1,2023-07-26,원인재,5779,3153,2626
1,2023-07-26,동춘,21003,10295,10708
1,2023-07-26,동막,11355,6011,5344
1,2023-07-26,캠퍼스타운,10897,5488,5409
1,2023-07-26,테크노파크,21281,10569,10712
1,2023-07-26,지식정보단지,9327,4522,4805
1,2023-07-26,인천대입구,12767,6362,6405
1,2023-07-26,센트럴파크(재외동포청),7492,3727,3765
1,2023-07-26,국제업무지구,3495,1771,1724
1,2023-07-26,송도달빛축제공원,9584,4842,4742
1,2023-07-27,계양,7183,3557,3626
1,2023-07-27,귤현,2145,875,1270
1,2023-07-27,박촌,7376,3884,3492
1,2023-07-27,임학,15395,7781,7614
1,2023-07-27,계산,18876,9573,9303
1,2023-07-27,경인교대입구,10440,5249,5191
1,2023-07-27,작전,26289,13423,12866
1,2023-07-27,갈산,18476,9242,9234
1,2023-07-27,부평구청,13363,6544,6819
1,2023-07-27,부평시장,25317,12605,12712
1,2023-07-27,부평,13544,6890,6654
1,2023-07-27,동수,8013,4096,3917
1,2023-07-27,부평삼거리,4850,2406,2444
1,2023-07-27,간석오거리,21062,11009,10053
1,2023-07-27,인천시청,10410,5269,5141
1,2023-07-27,예술회관,23633,11590,12043
1,2023-07-27,인천터미널,25952,12740,13212
1,2023-07-27,문학경기장,3561,1941,1620
1,2023-07-27,선학,11645,5879,5766
1,2023-07-27,신연수,10543,5338,5205
1,2023-07-27,원인재,5922,3145,2777
1,2023-07-27,동춘,20774,10118,10656
1,2023-07-27,동막,10341,5456,4885
1,2023-07-27,캠퍼스타운,10588,5353,5235
1,2023-07-27,테크노파크,21651,10872,10779
1,2023-07-27,지식정보단지,9431,4606,4825
1,2023-07-27,인천대입구,12532,6199,6333
1,2023-07-27,센트럴파크(재외동포청),7894,3915,3979
1,2023-07-27,국제업무지구,3445,1731,1714
1,2023-07-27,송도달빛축제공원,9435,4831,4604
1,2023-07-28,계양,7295,3624,3671
1,2023-07-28,귤현,2192,877,1315
1,2023-07-28,박촌,7229,3803,3426
1,2023-07-28,임학,15495,7886,7609
1,2023-07-28,계산,19100,9733,9367
1,2023-07-28,경인교대입구,10778,5339,5439
1,2023-07-28,작전,27028,13855,13173
1,2023-07-28,갈산,18297,9322,8975
1,2023-07-28,부평구청,13260,6594,6666
1,2023-07-28,부평시장,25801,12957,12844
1,2023-07-28,부평,14603,7352,7251
1,2023-07-28,동수,8147,4225,3922
1,2023-07-28,부평삼거리,4741,2385,2356
1,2023-07-28,간석오거리,21447,11225,10222
1,2023-07-28,인천시청,10457,5318,5139
1,2023-07-28,예술회관,24068,11392,12676
1,2023-07-28,인천터미널,29861,14433,15428
1,2023-07-28,문학경기장,12237,5832,6405
1,2023-07-28,선학,12313,6215,6098
1,2023-07-28,신연수,10455,5402,5053
1,2023-07-28,원인재,5679,3010,2669
1,2023-07-28,동춘,21373,10328,11045
1,2023-07-28,동막,10425,5619,4806
1,2023-07-28,캠퍼스타운,10977,5576,5401
1,2023-07-28,테크노파크,22334,11141,11193
1,2023-07-28,지식정보단지,9300,4542,4758
1,2023-07-28,인천대입구,12693,6391,6302
1,2023-07-28,센트럴파크(재외동포청),7673,3784,3889
1,2023-07-28,국제업무지구,3304,1683,1621
1,2023-07-28,송도달빛축제공원,9645,4928,4717
1,2023-07-29,계양,5517,2607,2910
1,2023-07-29,귤현,1408,608,800
1,2023-07-29,박촌,5169,2726,2443
1,2023-07-29,임학,10930,5575,5355
1,2023-07-29,계산,14637,7346,7291
1,2023-07-29,경인교대입구,7850,3976,3874
1,2023-07-29,작전,18923,9850,9073
1,2023-07-29,갈산,8874,4628,4246
1,2023-07-29,부평구청,8965,4320,4645
1,2023-07-29,부평시장,17228,8726,8502
1,2023-07-29,부평,12826,6615,6211
1,2023-07-29,동수,5366,2750,2616
1,2023-07-29,부평삼거리,3712,1849,1863
1,2023-07-29,간석오거리,15137,7899,7238
1,2023-07-29,인천시청,6397,3296,3101
1,2023-07-29,예술회관,16054,7400,8654
1,2023-07-29,인천터미널,27142,13105,14037
1,2023-07-29,문학경기장,13452,6568,6884
1,2023-07-29,선학,9272,4782,4490
1,2023-07-29,신연수,5704,2983,2721
1,2023-07-29,원인재,3775,1984,1791
1,2023-07-29,동춘,14811,7305,7506
1,2023-07-29,동막,5773,3112,2661
1,2023-07-29,캠퍼스타운,7807,4029,3778
1,2023-07-29,테크노파크,18532,9147,9385
1,2023-07-29,지식정보단지,3748,1900,1848
1,2023-07-29,인천대입구,9770,4862,4908
1,2023-07-29,센트럴파크(재외동포청),6619,3215,3404
1,2023-07-29,국제업무지구,1629,860,769
1,2023-07-29,송도달빛축제공원,7253,3625,3628
1,2023-07-30,계양,4081,1917,2164
1,2023-07-30,귤현,885,418,467
1,2023-07-30,박촌,3780,1923,1857
1,2023-07-30,임학,8068,4030,4038
1,2023-07-30,계산,11363,5644,5719
1,2023-07-30,경인교대입구,6542,3243,3299
1,2023-07-30,작전,12745,6422,6323
1,2023-07-30,갈산,5988,3036,2952
1,2023-07-30,부평구청,6704,3232,3472
1,2023-07-30,부평시장,13422,6673,6749
1,2023-07-30,부평,8792,4733,4059
1,2023-07-30,동수,3937,1999,1938
1,2023-07-30,부평삼거리,3108,1538,1570
1,2023-07-30,간석오거리,11389,5964,5425
1,2023-07-30,인천시청,4686,2406,2280
1,2023-07-30,예술회관,11155,5416,5739
1,2023-07-30,인천터미널,22241,11423,10818
1,2023-07-30,문학경기장,9349,4633,4716
1,2023-07-30,선학,7029,3487,3542
1,2023-07-30,신연수,4594,2336,2258
1,2023-07-30,원인재,2537,1327,1210
1,2023-07-30,동춘,11322,5656,5666
1,2023-07-30,동막,4207,2215,1992
1,2023-07-30,캠퍼스타운,5451,2748,2703
1,2023-07-30,테크노파크,14250,7044,7206
1,2023-07-30,지식정보단지,2558,1252,1306
1,2023-07-30,인천대입구,7005,3447,3558
1,2023-07-30,센트럴파크(재외동포청),5098,2491,2607
1,2023-07-30,국제업무지구,700,377,323
1,2023-07-30,송도달빛축제공원,5606,2696,2910
1,2023-07-31,계양,6514,3208,3306
1,2023-07-31,귤현,1943,762,1181
1,2023-07-31,박촌,6470,3411,3059
1,2023-07-31,임학,13847,6994,6853
1,2023-07-31,계산,17690,8908,8782
1,2023-07-31,경인교대입구,9442,4771,4671
1,2023-07-31,작전,24097,12219,11878
1,2023-07-31,갈산,15128,7735,7393
1,2023-07-31,부평구청,11435,5612,5823
1,2023-07-31,부평시장,23318,11618,11700
1,2023-07-31,부평,12513,6337,6176
1,2023-07-31,동수,7099,3648,3451
1,2023-07-31,부평삼거리,4239,2127,2112
1,2023-07-31,간석오거리,18160,9482,8678
1,2023-07-31,인천시청,8664,4398,4266
1,2023-07-31,예술회관,21349,10498,10851
1,2023-07-31,인천터미널,25498,12576,12922
1,2023-07-31,문학경기장,2960,1506,1454
1,2023-07-31,선학,10098,5039,5059
1,2023-07-31,신연수,8212,4219,3993
1,2023-07-31,원인재,4692,2566,2126
1,2023-07-31,동춘,16990,8206,8784
1,2023-07-31,동막,7888,4186,3702
1,2023-07-31,캠퍼스타운,9746,4879,4867
1,2023-07-31,테크노파크,19538,9747,9791
1,2023-07-31,지식정보단지,7501,3692,3809
1,2023-07-31,인천대입구,11430,5642,5788
1,2023-07-31,센트럴파크(재외동포청),7014,3501,3513
1,2023-07-31,국제업무지구,3137,1614,1523
1,2023-07-31,송도달빛축제공원,8573,4339,4234
1,2023-08-01,계양,6528,3230,3298
1,2023-08-01,귤현,1933,816,1117
1,2023-08-01,박촌,6519,3420,3099
1,2023-08-01,임학,14094,7165,6929
1,2023-08-01,계산,17621,8845,8776
1,2023-08-01,경인교대입구,9428,4721,4707
1,2023-08-01,작전,24087,12246,11841
1,2023-08-01,갈산,15134,7749,7385
1,2023-08-01,부평구청,11571,5639,5932
1,2023-08-01,부평시장,23317,11576,11741
1,2023-08-01,부평,12630,6572,6058
1,2023-08-01,동수,7332,3741,3591
1,2023-08-01,부평삼거리,3969,2010,1959
1,2023-08-01,간석오거리,18536,9627,8909
1,2023-08-01,인천시청,9216,4666,4550
1,2023-08-01,예술회관,21392,10383,11009
1,2023-08-01,인천터미널,24911,12370,12541
1,2023-08-01,문학경기장,3193,1613,1580
1,2023-08-01,선학,10351,5168,5183
1,2023-08-01,신연수,7948,4105,3843
1,2023-08-01,원인재,4711,2565,2146
1,2023-08-01,동춘,16775,8208,8567
1,2023-08-01,동막,7987,4300,3687
1,2023-08-01,캠퍼스타운,9780,4838,4942
1,2023-08-01,테크노파크,19651,9804,9847
1,2023-08-01,지식정보단지,7332,3620,3712
1,2023-08-01,인천대입구,11498,5643,5855
1,2023-08-01,센트럴파크(재외동포청),7144,3548,3596
1,2023-08-01,국제업무지구,3281,1693,1588
1,2023-08-01,송도달빛축제공원,8581,4336,4245
1,2023-08-02,계양,6593,3290,3303
1,2023-08-02,귤현,1890,774,1116
1,2023-08-02,박촌,6520,3435,3085
1,2023-08-02,임학,13966,7024,6942
1,2023-08-02,계산,17325,8705,8620
1,2023-08-02,경인교대입구,9443,4735,4708
1,2023-08-02,작전,23361,11944,11417
1,2023-08-02,갈산,14981,7599,7382
1,2023-08-02,부평구청,11305,5541,5764
1,2023-08-02,부평시장,22844,11424,11420
1,2023-08-02,부평,12833,6607,6226
1,2023-08-02,동수,7199,3693,3506
1,2023-08-02,부평삼거리,3986,2023,1963
1,2023-08-02,간석오거리,18554,9621,8933
1,2023-08-02,인천시청,9112,4586,4526
1,2023-08-02,예술회관,21135,10238,10897
1,2023-08-02,인천터미널,24902,12250,12652
1,2023-08-02,문학경기장,3069,1542,1527
1,2023-08-02,선학,10206,5150,5056
1,2023-08-02,신연수,7786,4014,3772
1,2023-08-02,원인재,4536,2475,2061
1,2023-08-02,동춘,16209,7944,8265
1,2023-08-02,동막,7962,4245,3717
1,2023-08-02,캠퍼스타운,9716,4851,4865
1,2023-08-02,테크노파크,19733,9829,9904
1,2023-08-02,지식정보단지,7373,3623,3750
1,2023-08-02,인천대입구,11697,5806,5891
1,2023-08-02,센트럴파크(재외동포청),7142,3558,3584
1,2023-08-02,국제업무지구,3344,1700,1644
1,2023-08-02,송도달빛축제공원,8750,4388,4362
1,2023-08-03,계양,6664,3286,3378
1,2023-08-03,귤현,1985,830,1155
1,2023-08-03,박촌,6518,3400,3118
1,2023-08-03,임학,13985,7056,6929
1,2023-08-03,계산,17444,8821,8623
1,2023-08-03,경인교대입구,9420,4746,4674
1,2023-08-03,작전,23965,12225,11740
1,2023-08-03,갈산,15798,8022,7776
1,2023-08-03,부평구청,11764,5788,5976
1,2023-08-03,부평시장,23395,11708,11687
1,2023-08-03,부평,12887,6549,6338
1,2023-08-03,동수,7304,3729,3575
1,2023-08-03,부평삼거리,4125,2060,2065
1,2023-08-03,간석오거리,18876,9858,9018
1,2023-08-03,인천시청,9289,4752,4537
1,2023-08-03,예술회관,21022,10199,10823
1,2023-08-03,인천터미널,24524,12019,12505
1,2023-08-03,문학경기장,3048,1537,1511
1,2023-08-03,선학,10218,5051,5167
1,2023-08-03,신연수,8451,4326,4125
1,2023-08-03,원인재,4920,2675,2245
1,2023-08-03,동춘,16882,8189,8693
1,2023-08-03,동막,8559,4581,3978
1,2023-08-03,캠퍼스타운,9747,4862,4885
1,2023-08-03,테크노파크,19675,9779,9896
1,2023-08-03,지식정보단지,7737,3791,3946
1,2023-08-03,인천대입구,11744,5853,5891
1,2023-08-03,센트럴파크(재외동포청),7462,3710,3752
1,2023-08-03,국제업무지구,3226,1657,1569
1,2023-08-03,송도달빛축제공원,8831,4400,4431
1,2023-08-04,계양,7027,3520,3507
1,2023-08-04,귤현,2049,834,1215
1,2023-08-04,박촌,6874,3593,3281
1,2023-08-04,임학,14396,7293,7103
1,2023-08-04,계산,18287,9286,9001
1,2023-08-04,경인교대입구,9834,4935,4899
1,2023-08-04,작전,24632,12557,12075
1,2023-08-04,갈산,16027,8096,7931
1,2023-08-04,부평구청,12273,5991,6282
1,2023-08-04,부평시장,24033,12040,11993
1,2023-08-04,부평,14487,7060,7427
1,2023-08-04,동수,7457,3875,3582
1,2023-08-04,부평삼거리,4252,2164,2088
1,2023-08-04,간석오거리,19485,10049,9436
1,2023-08-04,인천시청,9579,4810,4769
1,2023-08-04,예술회관,22250,10503,11747
1,2023-08-04,인천터미널,28175,13887,14288
1,2023-08-04,문학경기장,3066,1541,1525
1,2023-08-04,선학,10642,5311,5331
1,2023-08-04,신연수,8566,4371,4195
1,2023-08-04,원인재,5206,2608,2598
1,2023-08-04,동춘,17830,8562,9268
1,2023-08-04,동막,9342,4834,4508
1,2023-08-04,캠퍼스타운,10521,5199,5322
1,2023-08-04,테크노파크,21372,10611,10761
1,2023-08-04,지식정보단지,8191,4029,4162
1,2023-08-04,인천대입구,14982,7168,7814
1,2023-08-04,센트럴파크(재외동포청),8214,3946,4268
1,2023-08-04,국제업무지구,3661,1795,1866
1,2023-08-04,송도달빛축제공원,26899,13003,13896
1,2023-08-05,계양,5457,2604,2853
1,2023-08-05,귤현,1323,614,709
1,2023-08-05,박촌,4760,2447,2313
1,2023-08-05,임학,10189,5122,5067
1,2023-08-05,계산,14421,7262,7159
1,2023-08-05,경인교대입구,7620,3789,3831
1,2023-08-05,작전,17952,9143,8809
1,2023-08-05,갈산,8424,4363,4061
1,2023-08-05,부평구청,8723,4135,4588
1,2023-08-05,부평시장,16364,8228,8136
1,2023-08-05,부평,13062,6600,6462
1,2023-08-05,동수,5013,2590,2423
1,2023-08-05,부평삼거리,3658,1810,1848
1,2023-08-05,간석오거리,15070,7858,7212
1,2023-08-05,인천시청,6286,3263,3023
1,2023-08-05,예술회관,15908,7537,8371
1,2023-08-05,인천터미널,25806,12718,13088
1,2023-08-05,문학경기장,1615,784,831
1,2023-08-05,선학,9044,4537,4507
1,2023-08-05,신연수,5491,2828,2663
1,2023-08-05,원인재,3186,1592,1594
1,2023-08-05,동춘,14065,6867,7198
1,2023-08-05,동막,6138,3214,2924
1,2023-08-05,캠퍼스타운,7469,3852,3617
1,2023-08-05,테크노파크,17920,8766,9154
1,2023-08-05,지식정보단지,3886,2016,1870
1,2023-08-05,인천대입구,12477,6052,6425
1,2023-08-05,센트럴파크(재외동포청),7702,3707,3995
1,2023-08-05,국제업무지구,2023,994,1029
1,2023-08-05,송도달빛축제공원,27996,13484,14512
1,2023-08-06,계양,4053,1846,2207
1,2023-08-06,귤현,992,442,550
1,2023-08-06,박촌,3648,1908,1740
1,2023-08-06,임학,7625,3807,3818
1,2023-08-06,계산,11001,5486,5515
1,2023-08-06,경인교대입구,6319,3134,3185
1,2023-08-06,작전,12426,6365,6061
1,2023-08-06,갈산,6174,3146,3028
1,2023-08-06,부평구청,6634,3202,3432
1,2023-08-06,부평시장,12945,6487,6458
1,2023-08-06,부평,9278,4994,4284
1,2023-08-06,동수,3804,1902,1902
1,2023-08-06,부평삼거리,2852,1416,1436
1,2023-08-06,간석오거리,11558,6098,5460
1,2023-08-06,인천시청,4613,2318,2295
1,2023-08-06,예술회관,11265,5492,5773
1,2023-08-06,인천터미널,20932,10755,10177
1,2023-08-06,문학경기장,1021,508,513
1,2023-08-06,선학,7060,3557,3503
1,2023-08-06,신연수,4246,2210,2036
1,2023-08-06,원인재,2397,1258,1139
1,2023-08-06,동춘,11107,5466,5641
1,2023-08-06,동막,4274,2213,2061
1,2023-08-06,캠퍼스타운,5590,2829,2761
1,2023-08-06,테크노파크,14489,7131,7358
1,2023-08-06,지식정보단지,2688,1312,1376
1,2023-08-06,인천대입구,7812,3761,4051
1,2023-08-06,센트럴파크(재외동포청),5078,2486,2592
1,2023-08-06,국제업무지구,818,380,438
1,2023-08-06,송도달빛축제공원,21033,10223,10810
1,2023-08-07,계양,6746,3358,3388
1,2023-08-07,귤현,2080,831,1249
1,2023-08-07,박촌,6740,3517,3223
1,2023-08-07,임학,14222,7155,7067
1,2023-08-07,계산,17819,9055,8764
1,2023-08-07,경인교대입구,10039,5033,5006
1,2023-08-07,작전,24756,12632,12124
1,2023-08-07,갈산,17396,8781,8615
1,2023-08-07,부평구청,12326,6134,6192
1,2023-08-07,부평시장,24177,12105,12072
1,2023-08-07,부평,12601,6515,6086
1,2023-08-07,동수,7615,3844,3771
1,2023-08-07,부평삼거리,4245,2130,2115
1,2023-08-07,간석오거리,19603,10236,9367
1,2023-08-07,인천시청,9207,4650,4557
1,2023-08-07,예술회관,20785,10191,10594
1,2023-08-07,인천터미널,24204,12023,12181
1,2023-08-07,문학경기장,3140,1594,1546
1,2023-08-07,선학,10482,5203,5279
1,2023-08-07,신연수,9983,5102,4881
1,2023-08-07,원인재,5245,2848,2397
1,2023-08-07,동춘,18807,9112,9695
1,2023-08-07,동막,9538,5082,4456
1,2023-08-07,캠퍼스타운,9980,4995,4985
1,2023-08-07,테크노파크,20078,10028,10050
1,2023-08-07,지식정보단지,8905,4300,4605
1,2023-08-07,인천대입구,11501,5723,5778
1,2023-08-07,센트럴파크(재외동포청),6560,3323,3237
1,2023-08-07,국제업무지구,3084,1608,1476
1,2023-08-07,송도달빛축제공원,8774,4503,4271
1,2023-08-08,계양,6961,3480,3481
1,2023-08-08,귤현,2186,874,1312
1,2023-08-08,박촌,7168,3743,3425
1,2023-08-08,임학,14820,7485,7335
1,2023-08-08,계산,18310,9256,9054
1,2023-08-08,경인교대입구,10281,5119,5162
1,2023-08-08,작전,25681,13068,12613
1,2023-08-08,갈산,17829,9029,8800
1,2023-08-08,부평구청,13017,6388,6629
1,2023-08-08,부평시장,24404,12324,12080
1,2023-08-08,부평,12508,6405,6103
1,2023-08-08,동수,7946,4069,3877
1,2023-08-08,부평삼거리,4333,2180,2153
1,2023-08-08,간석오거리,20253,10491,9762
1,2023-08-08,인천시청,10197,5252,4945
1,2023-08-08,예술회관,22043,10778,11265
1,2023-08-08,인천터미널,24694,12223,12471
1,2023-08-08,문학경기장,7635,3695,3940
1,2023-08-08,선학,10961,5461,5500
1,2023-08-08,신연수,10122,5181,4941
1,2023-08-08,원인재,5459,2978,2481
1,2023-08-08,동춘,19531,9511,10020
1,2023-08-08,동막,9805,5174,4631
1,2023-08-08,캠퍼스타운,10404,5176,5228
1,2023-08-08,테크노파크,20863,10406,10457
1,2023-08-08,지식정보단지,9214,4451,4763
1,2023-08-08,인천대입구,12151,6059,6092
1,2023-08-08,센트럴파크(재외동포청),6858,3394,3464
1,2023-08-08,국제업무지구,3209,1634,1575
1,2023-08-08,송도달빛축제공원,9123,4591,4532
1,2023-08-09,계양,6904,3436,3468
1,2023-08-09,귤현,2207,875,1332
1,2023-08-09,박촌,7421,3885,3536
1,2023-08-09,임학,14953,7471,7482
1,2023-08-09,계산,18572,9462,9110
1,2023-08-09,경인교대입구,10200,5097,5103
1,2023-08-09,작전,25822,13114,12708
1,2023-08-09,갈산,18268,9233,9035
1,2023-08-09,부평구청,13042,6489,6553
1,2023-08-09,부평시장,25289,12605,12684
1,2023-08-09,부평,12871,6632,6239
1,2023-08-09,동수,7909,4022,3887
1,2023-08-09,부평삼거리,4468,2267,2201
1,2023-08-09,간석오거리,20655,10723,9932
1,2023-08-09,인천시청,10055,5097,4958
1,2023-08-09,예술회관,22491,11005,11486
1,2023-08-09,인천터미널,24963,12329,12634
1,2023-08-09,문학경기장,6645,3283,3362
1,2023-08-09,선학,11686,5838,5848
1,2023-08-09,신연수,10633,5442,5191
1,2023-08-09,원인재,5651,3060,2591
1,2023-08-09,동춘,19999,9787,10212
1,2023-08-09,동막,9892,5170,4722
1,2023-08-09,캠퍼스타운,10702,5376,5326
1,2023-08-09,테크노파크,20850,10349,10501
1,2023-08-09,지식정보단지,9334,4575,4759
1,2023-08-09,인천대입구,12859,6347,6512
1,2023-08-09,센트럴파크(재외동포청),7211,3583,3628
1,2023-08-09,국제업무지구,3249,1651,1598
1,2023-08-09,송도달빛축제공원,9220,4646,4574
1,2023-08-10,계양,5426,2755,2671
1,2023-08-10,귤현,1834,723,1111
1,2023-08-10,박촌,5715,2944,2771
1,2023-08-10,임학,12079,6061,6018
1,2023-08-10,계산,14677,7497,7180
1,2023-08-10,경인교대입구,8679,4363,4316
1,2023-08-10,작전,20805,10517,10288
1,2023-08-10,갈산,15973,8047,7926
1,2023-08-10,부평구청,10249,5010,5239
1,2023-08-10,부평시장,20112,9965,10147
1,2023-08-10,부평,9641,5011,4630
1,2023-08-10,동수,6758,3429,3329
1,2023-08-10,부평삼거리,3395,1698,1697
1,2023-08-10,간석오거리,16984,8832,8152
1,2023-08-10,인천시청,8071,4076,3995
1,2023-08-10,예술회관,17722,8862,8860
1,2023-08-10,인천터미널,18060,8901,9159
1,2023-08-10,문학경기장,2521,1298,1223
1,2023-08-10,선학,9017,4429,4588
1,2023-08-10,신연수,8502,4313,4189
1,2023-08-10,원인재,4475,2506,1969
1,2023-08-10,동춘,15835,7633,8202
1,2023-08-10,동막,8405,4439,3966
1,2023-08-10,캠퍼스타운,8114,4011,4103
1,2023-08-10,테크노파크,16608,8342,8266
1,2023-08-10,지식정보단지,7620,3629,3991
1,2023-08-10,인천대입구,9579,4644,4935
1,2023-08-10,센트럴파크(재외동포청),5400,2655,2745
1,2023-08-10,국제업무지구,2592,1318,1274
1,2023-08-10,송도달빛축제공원,6536,3302,3234
1,2023-08-11,계양,6498,3208,3290
1,2023-08-11,귤현,2138,851,1287
1,2023-08-11,박촌,6861,3614,3247
1,2023-08-11,임학,14324,7305,7019
1,2023-08-11,계산,17512,8916,8596
1,2023-08-11,경인교대입구,9863,4891,4972
1,2023-08-11,작전,24364,12425,11939
1,2023-08-11,갈산,17172,8722,8450
1,2023-08-11,부평구청,11961,5978,5983
1,2023-08-11,부평시장,23650,11856,11794
1,2023-08-11,부평,12450,6220,6230
1,2023-08-11,동수,7394,3836,3558
1,2023-08-11,부평삼거리,3948,1998,1950
1,2023-08-11,간석오거리,19699,10302,9397
1,2023-08-11,인천시청,9234,4751,4483
1,2023-08-11,예술회관,21511,10325,11186
1,2023-08-11,인천터미널,26071,12467,13604
1,2023-08-11,문학경기장,7258,3504,3754
1,2023-08-11,선학,11081,5525,5556
1,2023-08-11,신연수,9560,4933,4627
1,2023-08-11,원인재,4983,2706,2277
1,2023-08-11,동춘,18894,9128,9766
1,2023-08-11,동막,9480,5127,4353
1,2023-08-11,캠퍼스타운,9983,5034,4949
1,2023-08-11,테크노파크,19989,10043,9946
1,2023-08-11,지식정보단지,8546,4237,4309
1,2023-08-11,인천대입구,12223,5958,6265
1,2023-08-11,센트럴파크(재외동포청),6584,3294,3290
1,2023-08-11,국제업무지구,3072,1581,1491
1,2023-08-11,송도달빛축제공원,8360,4185,4175
1,2023-08-12,계양,5423,2561,2862
1,2023-08-12,귤현,1364,609,755
1,2023-08-12,박촌,5025,2663,2362
1,2023-08-12,임학,10635,5413,5222
1,2023-08-12,계산,14378,7224,7154
1,2023-08-12,경인교대입구,8095,4021,4074
1,2023-08-12,작전,19151,9903,9248
1,2023-08-12,갈산,8520,4432,4088
1,2023-08-12,부평구청,8846,4360,4486
1,2023-08-12,부평시장,17478,8714,8764
1,2023-08-12,부평,12041,6087,5954
1,2023-08-12,동수,5100,2616,2484
1,2023-08-12,부평삼거리,3856,1895,1961
1,2023-08-12,간석오거리,15536,8109,7427
1,2023-08-12,인천시청,6292,3245,3047
1,2023-08-12,예술회관,16060,7507,8553
1,2023-08-12,인천터미널,26998,12996,14002
1,2023-08-12,문학경기장,10362,5074,5288
1,2023-08-12,선학,9291,4659,4632
1,2023-08-12,신연수,5847,3109,2738
1,2023-08-12,원인재,3581,1869,1712
1,2023-08-12,동춘,14586,7327,7259
1,2023-08-12,동막,6373,3419,2954
1,2023-08-12,캠퍼스타운,7398,3874,3524
1,2023-08-12,테크노파크,17845,8776,9069
1,2023-08-12,지식정보단지,3928,2035,1893
1,2023-08-12,인천대입구,10797,5384,5413
1,2023-08-12,센트럴파크(재외동포청),6925,3430,3495
1,2023-08-12,국제업무지구,1598,882,716
1,2023-08-12,송도달빛축제공원,7704,3892,3812
1,2023-08-13,계양,4558,2130,2428
1,2023-08-13,귤현,1031,471,560
1,2023-08-13,박촌,3834,1962,1872
1,2023-08-13,임학,8508,4263,4245
1,2023-08-13,계산,12275,6145,6130
1,2023-08-13,경인교대입구,6742,3393,3349
1,2023-08-13,작전,13560,7007,6553
1,2023-08-13,갈산,6275,3199,3076
1,2023-08-13,부평구청,7053,3445,3608
1,2023-08-13,부평시장,13905,6992,6913
1,2023-08-13,부평,9536,4972,4564
1,2023-08-13,동수,4144,2109,2035
1,2023-08-13,부평삼거리,3189,1599,1590
1,2023-08-13,간석오거리,12190,6325,5865
1,2023-08-13,인천시청,4934,2524,2410
1,2023-08-13,예술회관,11887,5810,6077
1,2023-08-13,인천터미널,22619,11325,11294
1,2023-08-13,문학경기장,9068,4527,4541
1,2023-08-13,선학,7405,3648,3757
1,2023-08-13,신연수,4442,2265,2177
1,2023-08-13,원인재,2411,1235,1176
1,2023-08-13,동춘,9567,4781,4786
1,2023-08-13,동막,4400,2263,2137
1,2023-08-13,캠퍼스타운,5540,2772,2768
1,2023-08-13,테크노파크,15486,7640,7846
1,2023-08-13,지식정보단지,2739,1375,1364
1,2023-08-13,인천대입구,8395,4154,4241
1,2023-08-13,센트럴파크(재외동포청),5245,2570,2675
1,2023-08-13,국제업무지구,837,435,402
1,2023-08-13,송도달빛축제공원,6155,3033,3122
1,2023-08-14,계양,6648,3339,3309
1,2023-08-14,귤현,2024,851,1173
1,2023-08-14,박촌,7039,3716,3323
1,2023-08-14,임학,14000,7131,6869
1,2023-08-14,계산,18062,9163,8899
1,2023-08-14,경인교대입구,9638,4912,4726
1,2023-08-14,작전,24219,12447,11772
1,2023-08-14,갈산,15570,7954,7616
1,2023-08-14,부평구청,12393,6135,6258
1,2023-08-14,부평시장,24016,12039,11977
1,2023-08-14,부평,12901,6545,6356
1,2023-08-14,동수,7483,3894,3589
1,2023-08-14,부평삼거리,4290,2151,2139
1,2023-08-14,간석오거리,19425,10198,9227
1,2023-08-14,인천시청,9056,4639,4417
1,2023-08-14,예술회관,21887,10512,11375
1,2023-08-14,인천터미널,26826,13154,13672
1,2023-08-14,문학경기장,2964,1501,1463
1,2023-08-14,선학,11148,5554,5594
1,2023-08-14,신연수,9365,4798,4567
1,2023-08-14,원인재,4931,2622,2309
1,2023-08-14,동춘,18354,8974,9380
1,2023-08-14,동막,8990,4792,4198
1,2023-08-14,캠퍼스타운,10182,5157,5025
1,2023-08-14,테크노파크,19902,9893,10009
1,2023-08-14,지식정보단지,7568,3725,3843
1,2023-08-14,인천대입구,12508,6155,6353
1,2023-08-14,센트럴파크(재외동포청),7107,3569,3538
1,2023-08-14,국제업무지구,3109,1611,1498
1,2023-08-14,송도달빛축제공원,8902,4494,4408
1,2023-08-15,계양,4706,2243,2463
1,2023-08-15,귤현,1107,517,590
1,2023-08-15,박촌,4147,2148,1999
1,2023-08-15,임학,8865,4453,4412
1,2023-08-15,계산,12855,6352,6503
1,2023-08-15,경인교대입구,6501,3265,3236
1,2023-08-15,작전,14700,7483,7217
1,2023-08-15,갈산,7648,3843,3805
1,2023-08-15,부평구청,7219,3501,3718
1,2023-08-15,부평시장,14484,7272,7212
1,2023-08-15,부평,9549,5012,4537
1,2023-08-15,동수,4406,2253,2153
1,2023-08-15,부평삼거리,3336,1641,1695
1,2023-08-15,간석오거리,13357,6974,6383
1,2023-08-15,인천시청,5406,2793,2613
1,2023-08-15,예술회관,14144,6795,7349
1,2023-08-15,인천터미널,21290,10851,10439
1,2023-08-15,문학경기장,1932,961,971
1,2023-08-15,선학,7886,3959,3927
1,2023-08-15,신연수,5518,2807,2711
1,2023-08-15,원인재,2781,1501,1280
1,2023-08-15,동춘,13433,6625,6808
1,2023-08-15,동막,5017,2680,2337
1,2023-08-15,캠퍼스타운,5928,2991,2937
1,2023-08-15,테크노파크,16176,8044,8132
1,2023-08-15,지식정보단지,3433,1669,1764
1,2023-08-15,인천대입구,8954,4419,4535
1,2023-08-15,센트럴파크(재외동포청),5530,2734,2796
1,2023-08-15,국제업무지구,1638,854,784
1,2023-08-15,송도달빛축제공원,6374,3192,3182
1,2023-08-16,계양,7185,3614,3571
1,2023-08-16,귤현,2246,899,1347
1,2023-08-16,박촌,7725,4029,3696
1,2023-08-16,임학,15220,7714,7506
1,2023-08-16,계산,18894,9481,9413
1,2023-08-16,경인교대입구,10440,5254,5186
1,2023-08-16,작전,26448,13421,13027
1,2023-08-16,갈산,18357,9299,9058
1,2023-08-16,부평구청,13381,6615,6766
1,2023-08-16,부평시장,25509,12746,12763
1,2023-08-16,부평,12783,6584,6199
1,2023-08-16,동수,8111,4123,3988
1,2023-08-16,부평삼거리,5188,2630,2558
1,2023-08-16,간석오거리,20875,10891,9984
1,2023-08-16,인천시청,10618,5407,5211
1,2023-08-16,예술회관,23337,11392,11945
1,2023-08-16,인천터미널,25661,12697,12964
1,2023-08-16,문학경기장,3317,1633,1684
1,2023-08-16,선학,11804,5896,5908
1,2023-08-16,신연수,10412,5297,5115
1,2023-08-16,원인재,5621,3012,2609
1,2023-08-16,동춘,19923,9664,10259
1,2023-08-16,동막,10763,5796,4967
1,2023-08-16,캠퍼스타운,11221,5622,5599
1,2023-08-16,테크노파크,20568,10267,10301
1,2023-08-16,지식정보단지,9436,4573,4863
1,2023-08-16,인천대입구,13018,6471,6547
1,2023-08-16,센트럴파크(재외동포청),7387,3696,3691
1,2023-08-16,국제업무지구,3466,1791,1675
1,2023-08-16,송도달빛축제공원,9605,4802,4803
1,2023-08-17,계양,7319,3641,3678
1,2023-08-17,귤현,2338,968,1370
1,2023-08-17,박촌,7717,4026,3691
1,2023-08-17,임학,15265,7736,7529
1,2023-08-17,계산,18911,9657,9254
1,2023-08-17,경인교대입구,10456,5205,5251
1,2023-08-17,작전,26434,13425,13009
1,2023-08-17,갈산,18227,9251,8976
1,2023-08-17,부평구청,13813,6813,7000
1,2023-08-17,부평시장,25789,12863,12926
1,2023-08-17,부평,13024,6653,6371
1,2023-08-17,동수,8061,4124,3937
1,2023-08-17,부평삼거리,4981,2549,2432
1,2023-08-17,간석오거리,21162,11075,10087
1,2023-08-17,인천시청,10495,5337,5158
1,2023-08-17,예술회관,23154,11282,11872
1,2023-08-17,인천터미널,25656,12595,13061
1,2023-08-17,문학경기장,3379,1692,1687
1,2023-08-17,선학,11650,5780,5870
1,2023-08-17,신연수,10668,5375,5293
1,2023-08-17,원인재,5524,2964,2560
1,2023-08-17,동춘,19994,9798,10196
1,2023-08-17,동막,10585,5603,4982
1,2023-08-17,캠퍼스타운,11325,5664,5661
1,2023-08-17,테크노파크,20777,10339,10438
1,2023-08-17,지식정보단지,9584,4689,4895
1,2023-08-17,인천대입구,13010,6499,6511
1,2023-08-17,센트럴파크(재외동포청),7285,3652,3633
1,2023-08-17,국제업무지구,3555,1840,1715
1,2023-08-17,송도달빛축제공원,9586,4773,4813
1,2023-08-18,계양,7728,3872,3856
1,2023-08-18,귤현,2452,950,1502
1,2023-08-18,박촌,7938,4185,3753
1,2023-08-18,임학,15922,7977,7945
1,2023-08-18,계산,19801,10143,9658
1,2023-08-18,경인교대입구,10937,5450,5487
1,2023-08-18,작전,27588,14015,13573
1,2023-08-18,갈산,18701,9526,9175
1,2023-08-18,부평구청,13822,6819,7003
1,2023-08-18,부평시장,26482,13292,13190
1,2023-08-18,부평,14182,7062,7120
1,2023-08-18,동수,8373,4285,4088
1,2023-08-18,부평삼거리,5198,2667,2531
1,2023-08-18,간석오거리,21853,11428,10425
1,2023-08-18,인천시청,10610,5430,5180
1,2023-08-18,예술회관,24439,11713,12726
1,2023-08-18,인천터미널,29117,14141,14976
1,2023-08-18,문학경기장,11700,5567,6133
1,2023-08-18,선학,12366,6136,6230
1,2023-08-18,신연수,10882,5614,5268
1,2023-08-18,원인재,5975,3213,2762
1,2023-08-18,동춘,20792,10077,10715
1,2023-08-18,동막,11034,5930,5104
1,2023-08-18,캠퍼스타운,11729,5955,5774
1,2023-08-18,테크노파크,22218,11173,11045
1,2023-08-18,지식정보단지,9773,4801,4972
1,2023-08-18,인천대입구,14046,6876,7170
1,2023-08-18,센트럴파크(재외동포청),7983,3946,4037
1,2023-08-18,국제업무지구,3586,1847,1739
1,2023-08-18,송도달빛축제공원,9859,5033,4826
1,2023-08-19,계양,6264,2993,3271
1,2023-08-19,귤현,1622,756,866
1,2023-08-19,박촌,5236,2757,2479
1,2023-08-19,임학,11530,5874,5656
1,2023-08-19,계산,16255,8197,8058
1,2023-08-19,경인교대입구,8641,4318,4323
1,2023-08-19,작전,20555,10634,9921
1,2023-08-19,갈산,9259,4806,4453
1,2023-08-19,부평구청,9555,4622,4933
1,2023-08-19,부평시장,18324,9223,9101
1,2023-08-19,부평,12613,6413,6200
1,2023-08-19,동수,5700,2938,2762
1,2023-08-19,부평삼거리,3811,1902,1909
1,2023-08-19,간석오거리,16591,8675,7916
1,2023-08-19,인천시청,7086,3704,3382
1,2023-08-19,예술회관,18072,8399,9673
1,2023-08-19,인천터미널,27215,13282,13933
1,2023-08-19,문학경기장,15200,7443,7757
1,2023-08-19,선학,10146,5101,5045
1,2023-08-19,신연수,6446,3360,3086
1,2023-08-19,원인재,3820,2077,1743
1,2023-08-19,동춘,15625,7762,7863
1,2023-08-19,동막,6784,3651,3133
1,2023-08-19,캠퍼스타운,7756,3990,3766
1,2023-08-19,테크노파크,18015,8835,9180
1,2023-08-19,지식정보단지,4143,2101,2042
1,2023-08-19,인천대입구,10696,5276,5420
1,2023-08-19,센트럴파크(재외동포청),6927,3336,3591
1,2023-08-19,국제업무지구,1738,904,834
1,2023-08-19,송도달빛축제공원,7990,4016,3974
1,2023-08-20,계양,4580,2145,2435
1,2023-08-20,귤현,1058,506,552
1,2023-08-20,박촌,4022,2070,1952
1,2023-08-20,임학,8350,4166,4184
1,2023-08-20,계산,12028,6018,6010
1,2023-08-20,경인교대입구,6701,3378,3323
1,2023-08-20,작전,13904,7103,6801
1,2023-08-20,갈산,6171,3178,2993
1,2023-08-20,부평구청,7035,3499,3536
1,2023-08-20,부평시장,14010,6938,7072
1,2023-08-20,부평,8929,4758,4171
1,2023-08-20,동수,4189,2121,2068
1,2023-08-20,부평삼거리,3056,1486,1570
1,2023-08-20,간석오거리,12053,6252,5801
1,2023-08-20,인천시청,5217,2667,2550
1,2023-08-20,예술회관,12507,6053,6454
1,2023-08-20,인천터미널,21587,11022,10565
1,2023-08-20,문학경기장,9749,4774,4975
1,2023-08-20,선학,7921,4020,3901
1,2023-08-20,신연수,4945,2536,2409
1,2023-08-20,원인재,2561,1345,1216
1,2023-08-20,동춘,10866,5351,5515
1,2023-08-20,동막,4458,2223,2235
1,2023-08-20,캠퍼스타운,5560,2831,2729
1,2023-08-20,테크노파크,14283,7062,7221
1,2023-08-20,지식정보단지,2898,1427,1471
1,2023-08-20,인천대입구,7901,3885,4016
1,2023-08-20,센트럴파크(재외동포청),4971,2385,2586
1,2023-08-20,국제업무지구,783,407,376
1,2023-08-20,송도달빛축제공원,6024,2869,3155
1,2023-08-21,계양,7126,3615,3511
1,2023-08-21,귤현,2270,904,1366
1,2023-08-21,박촌,7604,3987,3617
1,2023-08-21,임학,15221,7685,7536
1,2023-08-21,계산,18958,9639,9319
1,2023-08-21,경인교대입구,10072,5038,5034
1,2023-08-21,작전,26442,13394,13048
1,2023-08-21,갈산,18223,9207,9016
1,2023-08-21,부평구청,13098,6448,6650
1,2023-08-21,부평시장,25865,13003,12862
1,2023-08-21,부평,12477,6301,6176
1,2023-08-21,동수,8250,4223,4027
1,2023-08-21,부평삼거리,4890,2523,2367
1,2023-08-21,간석오거리,20997,11035,9962
1,2023-08-21,인천시청,10255,5208,5047
1,2023-08-21,예술회관,22521,11069,11452
1,2023-08-21,인천터미널,23309,11375,11934
1,2023-08-21,문학경기장,3235,1637,1598
1,2023-08-21,선학,11462,5741,5721
1,2023-08-21,신연수,10891,5515,5376
1,2023-08-21,원인재,5674,3069,2605
1,2023-08-21,동춘,19914,9590,10324
1,2023-08-21,동막,10423,5566,4857
1,2023-08-21,캠퍼스타운,10974,5519,5455
1,2023-08-21,테크노파크,20099,10056,10043
1,2023-08-21,지식정보단지,9581,4626,4955
1,2023-08-21,인천대입구,11964,5914,6050
1,2023-08-21,센트럴파크(재외동포청),6963,3518,3445
1,2023-08-21,국제업무지구,3472,1795,1677
1,2023-08-21,송도달빛축제공원,9388,4689,4699
1,2023-08-22,계양,7082,3570,3512
1,2023-08-22,귤현,2280,855,1425
1,2023-08-22,박촌,7666,4028,3638
1,2023-08-22,임학,14947,7588,7359
1,2023-08-22,계산,18187,9222,8965
1,2023-08-22,경인교대입구,10079,5053,5026
1,2023-08-22,작전,25791,13094,12697
1,2023-08-22,갈산,18618,9404,9214
1,2023-08-22,부평구청,13055,6468,6587
1,2023-08-22,부평시장,25077,12506,12571
1,2023-08-22,부평,11773,5969,5804
1,2023-08-22,동수,8107,4154,3953
1,2023-08-22,부평삼거리,4987,2548,2439
1,2023-08-22,간석오거리,20695,10795,9900
1,2023-08-22,인천시청,10028,5087,4941
1,2023-08-22,예술회관,22072,10852,11220
1,2023-08-22,인천터미널,24254,11918,12336
1,2023-08-22,문학경기장,5087,2418,2669
1,2023-08-22,선학,11638,5739,5899
1,2023-08-22,신연수,10464,5341,5123
1,2023-08-22,원인재,5545,3006,2539
1,2023-08-22,동춘,19366,9449,9917
1,2023-08-22,동막,10567,5639,4928
1,2023-08-22,캠퍼스타운,10823,5415,5408
1,2023-08-22,테크노파크,20116,10053,10063
1,2023-08-22,지식정보단지,9427,4541,4886
1,2023-08-22,인천대입구,11884,5894,5990
1,2023-08-22,센트럴파크(재외동포청),6981,3497,3484
1,2023-08-22,국제업무지구,3580,1853,1727
1,2023-08-22,송도달빛축제공원,9084,4504,4580
1,2023-08-23,계양,6619,3340,3279
1,2023-08-23,귤현,2234,862,1372
1,2023-08-23,박촌,7290,3827,3463
1,2023-08-23,임학,14270,7199,7071
1,2023-08-23,계산,17245,8746,8499
1,2023-08-23,경인교대입구,9517,4783,4734
1,2023-08-23,작전,24327,12287,12040
1,2023-08-23,갈산,17865,9062,8803
1,2023-08-23,부평구청,12229,6024,6205
1,2023-08-23,부평시장,23472,11791,11681
1,2023-08-23,부평,11448,5752,5696
1,2023-08-23,동수,7736,3924,3812
1,2023-08-23,부평삼거리,4357,2209,2148
1,2023-08-23,간석오거리,19544,10197,9347
1,2023-08-23,인천시청,9755,4976,4779
1,2023-08-23,예술회관,21204,10425,10779
1,2023-08-23,인천터미널,22196,10896,11300
1,2023-08-23,문학경기장,3225,1638,1587
1,2023-08-23,선학,10975,5506,5469
1,2023-08-23,신연수,9733,4926,4807
1,2023-08-23,원인재,5400,2937,2463
1,2023-08-23,동춘,18422,8945,9477
1,2023-08-23,동막,10168,5478,4690
1,2023-08-23,캠퍼스타운,10601,5290,5311
1,2023-08-23,테크노파크,19195,9513,9682
1,2023-08-23,지식정보단지,9259,4496,4763
1,2023-08-23,인천대입구,11455,5626,5829
1,2023-08-23,센트럴파크(재외동포청),6652,3286,3366
1,2023-08-23,국제업무지구,3393,1754,1639
1,2023-08-23,송도달빛축제공원,8820,4405,4415
1,2023-08-24,계양,7332,3629,3703
1,2023-08-24,귤현,2401,938,1463
1,2023-08-24,박촌,7640,4014,3626
1,2023-08-24,임학,15023,7599,7424
1,2023-08-24,계산,18725,9476,9249
1,2023-08-24,경인교대입구,10344,5189,5155
1,2023-08-24,작전,26266,13314,12952
1,2023-08-24,갈산,18676,9394,9282
1,2023-08-24,부평구청,13137,6447,6690
1,2023-08-24,부평시장,25951,13021,12930
1,2023-08-24,부평,12381,6282,6099
1,2023-08-24,동수,8021,4152,3869
1,2023-08-24,부평삼거리,5156,2618,2538
1,2023-08-24,간석오거리,21091,10925,10166
1,2023-08-24,인천시청,10587,5374,5213
1,2023-08-24,예술회관,22718,11200,11518
1,2023-08-24,인천터미널,25393,12497,12896
1,2023-08-24,문학경기장,6868,3412,3456
1,2023-08-24,선학,11954,5945,6009
1,2023-08-24,신연수,10876,5579,5297
1,2023-08-24,원인재,5765,3114,2651
1,2023-08-24,동춘,19814,9640,10174
1,2023-08-24,동막,10859,5711,5148
1,2023-08-24,캠퍼스타운,11418,5737,5681
1,2023-08-24,테크노파크,20699,10261,10438
1,2023-08-24,지식정보단지,9514,4615,4899
1,2023-08-24,인천대입구,12458,6262,6196
1,2023-08-24,센트럴파크(재외동포청),7422,3712,3710
1,2023-08-24,국제업무지구,3464,1750,1714
1,2023-08-24,송도달빛축제공원,9495,4721,4774
1,2023-08-25,계양,7672,3873,3799
1,2023-08-25,귤현,2530,1018,1512
1,2023-08-25,박촌,8094,4275,3819
1,2023-08-25,임학,16267,8206,8061
1,2023-08-25,계산,20495,10411,10084
1,2023-08-25,경인교대입구,11066,5510,5556
1,2023-08-25,작전,28145,14350,13795
1,2023-08-25,갈산,19023,9632,9391
1,2023-08-25,부평구청,14115,6946,7169
1,2023-08-25,부평시장,27879,13978,13901
1,2023-08-25,부평,14477,7290,7187
1,2023-08-25,동수,8322,4342,3980
1,2023-08-25,부평삼거리,5439,2813,2626
1,2023-08-25,간석오거리,22376,11752,10624
1,2023-08-25,인천시청,11299,5729,5570
1,2023-08-25,예술회관,24834,11811,13023
1,2023-08-25,인천터미널,30045,14556,15489
1,2023-08-25,문학경기장,3824,1869,1955
1,2023-08-25,선학,12885,6423,6462
1,2023-08-25,신연수,11332,5808,5524
1,2023-08-25,원인재,6238,3335,2903
1,2023-08-25,동춘,21612,10604,11008
1,2023-08-25,동막,11515,6063,5452
1,2023-08-25,캠퍼스타운,12383,6279,6104
1,2023-08-25,테크노파크,22648,11294,11354
1,2023-08-25,지식정보단지,10180,5042,5138
1,2023-08-25,인천대입구,14876,7300,7576
1,2023-08-25,센트럴파크(재외동포청),8443,4188,4255
1,2023-08-25,국제업무지구,3801,1882,1919
1,2023-08-25,송도달빛축제공원,16352,8146,8206
1,2023-08-26,계양,6493,3090,3403
1,2023-08-26,귤현,1699,796,903
1,2023-08-26,박촌,5626,2968,2658
1,2023-08-26,임학,11978,6031,5947
1,2023-08-26,계산,17887,9015,8872
1,2023-08-26,경인교대입구,8862,4436,4426
1,2023-08-26,작전,21533,11080,10453
1,2023-08-26,갈산,9973,5104,4869
1,2023-08-26,부평구청,10537,5090,5447
1,2023-08-26,부평시장,19946,10034,9912
1,2023-08-26,부평,14474,7251,7223
1,2023-08-26,동수,5795,3005,2790
1,2023-08-26,부평삼거리,4228,2119,2109
1,2023-08-26,간석오거리,17576,9069,8507
1,2023-08-26,인천시청,7579,3895,3684
1,2023-08-26,예술회관,19916,9195,10721
1,2023-08-26,인천터미널,31599,15437,16162
1,2023-08-26,문학경기장,28497,12258,16239
1,2023-08-26,선학,11242,5709,5533
1,2023-08-26,신연수,6984,3666,3318
1,2023-08-26,원인재,4342,2217,2125
1,2023-08-26,동춘,16597,8207,8390
1,2023-08-26,동막,7354,3834,3520
1,2023-08-26,캠퍼스타운,9110,4785,4325
1,2023-08-26,테크노파크,21118,10343,10775
1,2023-08-26,지식정보단지,5158,2624,2534
1,2023-08-26,인천대입구,12956,6221,6735
1,2023-08-26,센트럴파크(재외동포청),9807,4783,5024
1,2023-08-26,국제업무지구,2399,1262,1137
1,2023-08-26,송도달빛축제공원,23589,11801,11788
1,2023-08-27,계양,4653,2140,2513
1,2023-08-27,귤현,1111,515,596
1,2023-08-27,박촌,4133,2139,1994
1,2023-08-27,임학,8784,4429,4355
1,2023-08-27,계산,13444,6650,6794
1,2023-08-27,경인교대입구,7274,3621,3653
1,2023-08-27,작전,13952,7081,6871
1,2023-08-27,갈산,6434,3293,3141
1,2023-08-27,부평구청,7170,3486,3684
1,2023-08-27,부평시장,14649,7324,7325
1,2023-08-27,부평,8862,4721,4141
1,2023-08-27,동수,4356,2201,2155
1,2023-08-27,부평삼거리,3157,1540,1617
1,2023-08-27,간석오거리,12351,6460,5891
1,2023-08-27,인천시청,5150,2646,2504
1,2023-08-27,예술회관,11841,5760,6081
1,2023-08-27,인천터미널,22200,11336,10864
1,2023-08-27,문학경기장,1479,774,705
1,2023-08-27,선학,7620,3774,3846
1,2023-08-27,신연수,5061,2618,2443
1,2023-08-27,원인재,2716,1425,1291
1,2023-08-27,동춘,9305,4651,4654
1,2023-08-27,동막,4930,2560,2370
1,2023-08-27,캠퍼스타운,6311,3157,3154
1,2023-08-27,테크노파크,15908,7875,8033
1,2023-08-27,지식정보단지,3206,1575,1631
1,2023-08-27,인천대입구,8090,4012,4078
1,2023-08-27,센트럴파크(재외동포청),5533,2750,2783
1,2023-08-27,국제업무지구,1014,524,490
1,2023-08-27,송도달빛축제공원,11467,5677,5790
1,2023-08-28,계양,7109,3587,3522
1,2023-08-28,귤현,2263,909,1354
1,2023-08-28,박촌,7489,3958,3531
1,2023-08-28,임학,15025,7638,7387
1,2023-08-28,계산,20630,10604,10026
1,2023-08-28,경인교대입구,10658,5334,5324
1,2023-08-28,작전,26170,13227,12943
1,2023-08-28,갈산,18341,9263,9078
1,2023-08-28,부평구청,12630,6235,6395
1,2023-08-28,부평시장,25238,12592,12646
1,2023-08-28,부평,11965,6063,5902
1,2023-08-28,동수,8042,4167,3875
1,2023-08-28,부평삼거리,4822,2433,2389
1,2023-08-28,간석오거리,20300,10644,9656
1,2023-08-28,인천시청,10159,5183,4976
1,2023-08-28,예술회관,21676,10729,10947
1,2023-08-28,인천터미널,24326,12050,12276
1,2023-08-28,문학경기장,3104,1556,1548
1,2023-08-28,선학,11238,5605,5633
1,2023-08-28,신연수,10363,5285,5078
1,2023-08-28,원인재,5346,2857,2489
1,2023-08-28,동춘,19299,9362,9937
1,2023-08-28,동막,10336,5456,4880
1,2023-08-28,캠퍼스타운,11559,5780,5779
1,2023-08-28,테크노파크,20034,9992,10042
1,2023-08-28,지식정보단지,9431,4598,4833
1,2023-08-28,인천대입구,12267,6066,6201
1,2023-08-28,센트럴파크(재외동포청),6810,3415,3395
1,2023-08-28,국제업무지구,3449,1785,1664
1,2023-08-28,송도달빛축제공원,9570,4718,4852
1,2023-08-29,계양,7012,3500,3512
1,2023-08-29,귤현,2340,897,1443
1,2023-08-29,박촌,7517,3933,3584
1,2023-08-29,임학,14929,7528,7401
1,2023-08-29,계산,19500,9918,9582
1,2023-08-29,경인교대입구,10719,5423,5296
1,2023-08-29,작전,25690,13004,12686
1,2023-08-29,갈산,18481,9384,9097
1,2023-08-29,부평구청,13030,6395,6635
1,2023-08-29,부평시장,24580,12306,12274
1,2023-08-29,부평,11900,6057,5843
1,2023-08-29,동수,7871,4042,3829
1,2023-08-29,부평삼거리,4778,2437,2341
1,2023-08-29,간석오거리,19886,10339,9547
1,2023-08-29,인천시청,10647,5360,5287
1,2023-08-29,예술회관,21633,10564,11069
1,2023-08-29,인천터미널,23789,11640,12149
1,2023-08-29,문학경기장,3545,1781,1764
1,2023-08-29,선학,11258,5633,5625
1,2023-08-29,신연수,10411,5276,5135
1,2023-08-29,원인재,5634,3049,2585
1,2023-08-29,동춘,19179,9333,9846
1,2023-08-29,동막,10385,5449,4936
1,2023-08-29,캠퍼스타운,11536,5771,5765
1,2023-08-29,테크노파크,20479,10331,10148
1,2023-08-29,지식정보단지,9345,4539,4806
1,2023-08-29,인천대입구,12759,6471,6288
1,2023-08-29,센트럴파크(재외동포청),6850,3405,3445
1,2023-08-29,국제업무지구,3573,1817,1756
1,2023-08-29,송도달빛축제공원,9234,4603,4631
1,2023-08-30,계양,7679,3861,3818
1,2023-08-30,귤현,2520,1004,1516
1,2023-08-30,박촌,7951,4154,3797
1,2023-08-30,임학,16046,8083,7963
1,2023-08-30,계산,21652,10953,10699
1,2023-08-30,경인교대입구,11356,5713,5643
1,2023-08-30,작전,27689,14101,13588
1,2023-08-30,갈산,19518,9916,9602
1,2023-08-30,부평구청,13897,6938,6959
1,2023-08-30,부평시장,27036,13561,13475
1,2023-08-30,부평,12609,6388,6221
1,2023-08-30,동수,8478,4302,4176
1,2023-08-30,부평삼거리,5511,2806,2705
1,2023-08-30,간석오거리,22326,11656,10670
1,2023-08-30,인천시청,11543,5819,5724
1,2023-08-30,예술회관,23695,11587,12108
1,2023-08-30,인천터미널,25718,12603,13115
1,2023-08-30,문학경기장,7932,3914,4018
1,2023-08-30,선학,12220,6019,6201
1,2023-08-30,신연수,11133,5667,5466
1,2023-08-30,원인재,5969,3242,2727
1,2023-08-30,동춘,20671,10102,10569
1,2023-08-30,동막,11456,5967,5489
1,2023-08-30,캠퍼스타운,12523,6241,6282
1,2023-08-30,테크노파크,21802,10970,10832
1,2023-08-30,지식정보단지,10101,4934,5167
1,2023-08-30,인천대입구,14420,7088,7332
1,2023-08-30,센트럴파크(재외동포청),7765,3888,3877
1,2023-08-30,국제업무지구,3656,1856,1800
1,2023-08-30,송도달빛축제공원,12320,6105,6215
1,2023-08-31,계양,7800,3942,3858
1,2023-08-31,귤현,2517,981,1536
1,2023-08-31,박촌,7901,4098,3803
1,2023-08-31,임학,16145,8090,8055
1,2023-08-31,계산,22015,11218,10797
1,2023-08-31,경인교대입구,11836,6010,5826
1,2023-08-31,작전,27780,14117,13663
1,2023-08-31,갈산,19607,10053,9554
1,2023-08-31,부평구청,14099,7089,7010
1,2023-08-31,부평시장,27389,13749,13640
1,2023-08-31,부평,13052,6639,6413
1,2023-08-31,동수,8367,4328,4039
1,2023-08-31,부평삼거리,5421,2756,2665
1,2023-08-31,간석오거리,22494,11776,10718
1,2023-08-31,인천시청,11229,5651,5578
1,2023-08-31,예술회관,23401,11393,12008
1,2023-08-31,인천터미널,27038,13378,13660
1,2023-08-31,문학경기장,9291,4458,4833
1,2023-08-31,선학,12443,6208,6235
1,2023-08-31,신연수,11422,5784,5638
1,2023-08-31,원인재,5994,3215,2779
1,2023-08-31,동춘,20886,10205,10681
1,2023-08-31,동막,11239,5941,5298
1,2023-08-31,캠퍼스타운,13025,6465,6560
1,2023-08-31,테크노파크,22338,11127,11211
1,2023-08-31,지식정보단지,10166,4951,5215
1,2023-08-31,인천대입구,14276,6958,7318
1,2023-08-31,센트럴파크(재외동포청),8584,4219,4365
1,2023-08-31,국제업무지구,3790,1881,1909
1,2023-08-31,송도달빛축제공원,14722,7363,7359
1,2023-09-01,계양,8223,4150,4073
1,2023-09-01,귤현,2585,1036,1549
1,2023-09-01,박촌,8436,4409,4027
1,2023-09-01,임학,16968,8579,8389
1,2023-09-01,계산,22530,11467,11063
1,2023-09-01,경인교대입구,11657,5839,5818
1,2023-09-01,작전,29092,14879,14213
1,2023-09-01,갈산,19332,9801,9531
1,2023-09-01,부평구청,14273,7026,7247
1,2023-09-01,부평시장,27915,14002,13913
1,2023-09-01,부평,14416,7130,7286
1,2023-09-01,동수,8593,4432,4161
1,2023-09-01,부평삼거리,5720,2956,2764
1,2023-09-01,간석오거리,23133,12152,10981
1,2023-09-01,인천시청,12007,6099,5908
1,2023-09-01,예술회관,24949,11969,12980
1,2023-09-01,인천터미널,31288,15241,16047
1,2023-09-01,문학경기장,15105,7214,7891
1,2023-09-01,선학,13035,6547,6488
1,2023-09-01,신연수,11978,6196,5782
1,2023-09-01,원인재,6408,3411,2997
1,2023-09-01,동춘,22019,10762,11257
1,2023-09-01,동막,11644,6138,5506
1,2023-09-01,캠퍼스타운,13718,7085,6633
1,2023-09-01,테크노파크,23467,11806,11661
1,2023-09-01,지식정보단지,10885,5308,5577
1,2023-09-01,인천대입구,18229,9089,9140
1,2023-09-01,센트럴파크(재외동포청),8571,4160,4411
1,2023-09-01,국제업무지구,3882,1933,1949
1,2023-09-01,송도달빛축제공원,18612,9216,9396
1,2023-09-02,계양,6791,3292,3499
1,2023-09-02,귤현,1763,813,950
1,2023-09-02,박촌,5768,3046,2722
1,2023-09-02,임학,12502,6396,6106
1,2023-09-02,계산,19019,9489,9530
1,2023-09-02,경인교대입구,9258,4699,4559
1,2023-09-02,작전,21770,11188,10582
1,2023-09-02,갈산,9955,5231,4724
1,2023-09-02,부평구청,10631,5132,5499
1,2023-09-02,부평시장,19848,10007,9841
1,2023-09-02,부평,13858,6929,6929
1,2023-09-02,동수,6047,3125,2922
1,2023-09-02,부평삼거리,4576,2319,2257
1,2023-09-02,간석오거리,18088,9468,8620
1,2023-09-02,인천시청,7862,4101,3761
1,2023-09-02,예술회관,18753,8859,9894
1,2023-09-02,인천터미널,29462,14424,15038
1,2023-09-02,문학경기장,17927,8536,9391
1,2023-09-02,선학,10863,5459,5404
1,2023-09-02,신연수,6906,3617,3289
1,2023-09-02,원인재,4567,2350,2217
1,2023-09-02,동춘,16694,8298,8396
1,2023-09-02,동막,7682,4033,3649
1,2023-09-02,캠퍼스타운,9993,5182,4811
1,2023-09-02,테크노파크,22020,10803,11217
1,2023-09-02,지식정보단지,5385,2737,2648
1,2023-09-02,인천대입구,12859,6275,6584
1,2023-09-02,센트럴파크(재외동포청),9609,4723,4886
1,2023-09-02,국제업무지구,2618,1379,1239
1,2023-09-02,송도달빛축제공원,26398,12977,13421
1,2023-09-03,계양,4717,2208,2509
1,2023-09-03,귤현,1136,538,598
1,2023-09-03,박촌,4174,2195,1979
1,2023-09-03,임학,8757,4515,4242
1,2023-09-03,계산,13562,6798,6764
1,2023-09-03,경인교대입구,7129,3493,3636
1,2023-09-03,작전,14782,7623,7159
1,2023-09-03,갈산,6512,3338,3174
1,2023-09-03,부평구청,6987,3417,3570
1,2023-09-03,부평시장,14677,7352,7325
1,2023-09-03,부평,9241,4901,4340
1,2023-09-03,동수,4364,2234,2130
1,2023-09-03,부평삼거리,3272,1621,1651
1,2023-09-03,간석오거리,12418,6462,5956
1,2023-09-03,인천시청,5443,2786,2657
1,2023-09-03,예술회관,12265,6032,6233
1,2023-09-03,인천터미널,23324,11744,11580
1,2023-09-03,문학경기장,14494,7093,7401
1,2023-09-03,선학,7815,3922,3893
1,2023-09-03,신연수,4869,2466,2403
1,2023-09-03,원인재,2604,1414,1190
1,2023-09-03,동춘,11268,5624,5644
1,2023-09-03,동막,4615,2379,2236
1,2023-09-03,캠퍼스타운,6643,3181,3462
1,2023-09-03,테크노파크,14924,7299,7625
1,2023-09-03,지식정보단지,3387,1694,1693
1,2023-09-03,인천대입구,8346,3970,4376
1,2023-09-03,센트럴파크(재외동포청),5166,2571,2595
1,2023-09-03,국제업무지구,889,459,430
1,2023-09-03,송도달빛축제공원,6141,3035,3106
1,2023-09-04,계양,7585,3842,3743
1,2023-09-04,귤현,2445,971,1474
1,2023-09-04,박촌,7924,4166,3758
1,2023-09-04,임학,16037,8138,7899
1,2023-09-04,계산,21603,11014,10589
1,2023-09-04,경인교대입구,11164,5587,5577
1,2023-09-04,작전,27777,14220,13557
1,2023-09-04,갈산,19237,9788,9449
1,2023-09-04,부평구청,13455,6608,6847
1,2023-09-04,부평시장,26665,13442,13223
1,2023-09-04,부평,12357,6308,6049
1,2023-09-04,동수,8347,4265,4082
1,2023-09-04,부평삼거리,5216,2672,2544
1,2023-09-04,간석오거리,21553,11297,10256
1,2023-09-04,인천시청,11188,5663,5525
1,2023-09-04,예술회관,22752,11274,11478
1,2023-09-04,인천터미널,26183,12703,13480
1,2023-09-04,문학경기장,3473,1771,1702
1,2023-09-04,선학,11701,5761,5940
1,2023-09-04,신연수,11702,5902,5800
1,2023-09-04,원인재,5825,3134,2691
1,2023-09-04,동춘,20027,9799,10228
1,2023-09-04,동막,10782,5704,5078
1,2023-09-04,캠퍼스타운,12516,6267,6249
1,2023-09-04,테크노파크,21333,10621,10712
1,2023-09-04,지식정보단지,10728,5183,5545
1,2023-09-04,인천대입구,18332,9088,9244
1,2023-09-04,센트럴파크(재외동포청),7310,3656,3654
1,2023-09-04,국제업무지구,3407,1733,1674
1,2023-09-04,송도달빛축제공원,9811,4981,4830
1,2023-09-05,계양,7878,4002,3876
1,2023-09-05,귤현,2539,972,1567
1,2023-09-05,박촌,8056,4215,3841
1,2023-09-05,임학,16324,8250,8074
1,2023-09-05,계산,21292,10821,10471
1,2023-09-05,경인교대입구,11373,5741,5632
1,2023-09-05,작전,28243,14444,13799
1,2023-09-05,갈산,19306,9819,9487
1,2023-09-05,부평구청,14087,7034,7053
1,2023-09-05,부평시장,26945,13434,13511
1,2023-09-05,부평,12472,6427,6045
1,2023-09-05,동수,8479,4335,4144
1,2023-09-05,부평삼거리,5390,2732,2658
1,2023-09-05,간석오거리,22309,11580,10729
1,2023-09-05,인천시청,11320,5767,5553
1,2023-09-05,예술회관,23417,11557,11860
1,2023-09-05,인천터미널,25724,12615,13109
1,2023-09-05,문학경기장,3646,1782,1864
1,2023-09-05,선학,12377,6148,6229
1,2023-09-05,신연수,12078,6096,5982
1,2023-09-05,원인재,6007,3218,2789
1,2023-09-05,동춘,20357,9911,10446
1,2023-09-05,동막,11296,5935,5361
1,2023-09-05,캠퍼스타운,13385,7128,6257
1,2023-09-05,테크노파크,21514,10739,10775
1,2023-09-05,지식정보단지,10794,5301,5493
1,2023-09-05,인천대입구,18206,9063,9143
1,2023-09-05,센트럴파크(재외동포청),7622,3806,3816
1,2023-09-05,국제업무지구,3664,1865,1799
1,2023-09-05,송도달빛축제공원,9960,4950,5010
1,2023-09-06,계양,7850,3999,3851
1,2023-09-06,귤현,2597,996,1601
1,2023-09-06,박촌,8151,4251,3900
1,2023-09-06,임학,16399,8310,8089
1,2023-09-06,계산,22238,11278,10960
1,2023-09-06,경인교대입구,11370,5764,5606
1,2023-09-06,작전,28402,14387,14015
1,2023-09-06,갈산,19319,9795,9524
1,2023-09-06,부평구청,13849,6777,7072
1,2023-09-06,부평시장,26963,13569,13394
1,2023-09-06,부평,12952,6608,6344
1,2023-09-06,동수,8610,4338,4272
1,2023-09-06,부평삼거리,5355,2720,2635
1,2023-09-06,간석오거리,22242,11614,10628
1,2023-09-06,인천시청,11504,5817,5687
1,2023-09-06,예술회관,23638,11621,12017
1,2023-09-06,인천터미널,26016,12816,13200
1,2023-09-06,문학경기장,3305,1671,1634
1,2023-09-06,선학,12473,6159,6314
1,2023-09-06,신연수,11919,6065,5854
1,2023-09-06,원인재,6268,3386,2882
1,2023-09-06,동춘,20644,10064,10580
1,2023-09-06,동막,11391,5998,5393
1,2023-09-06,캠퍼스타운,12787,6462,6325
1,2023-09-06,테크노파크,21746,10835,10911
1,2023-09-06,지식정보단지,10770,5288,5482
1,2023-09-06,인천대입구,18415,9127,9288
1,2023-09-06,센트럴파크(재외동포청),7677,3807,3870
1,2023-09-06,국제업무지구,3613,1822,1791
1,2023-09-06,송도달빛축제공원,10097,5013,5084
1,2023-09-07,계양,8018,4048,3970
1,2023-09-07,귤현,2568,1015,1553
1,2023-09-07,박촌,8256,4324,3932
1,2023-09-07,임학,16624,8392,8232
1,2023-09-07,계산,22266,11317,10949
1,2023-09-07,경인교대입구,11829,5994,5835
1,2023-09-07,작전,28246,14363,13883
1,2023-09-07,갈산,19531,9881,9650
1,2023-09-07,부평구청,14157,6973,7184
1,2023-09-07,부평시장,27488,13718,13770
1,2023-09-07,부평,12999,6494,6505
1,2023-09-07,동수,8472,4348,4124
1,2023-09-07,부평삼거리,5472,2782,2690
1,2023-09-07,간석오거리,22173,11560,10613
1,2023-09-07,인천시청,11795,5955,5840
1,2023-09-07,예술회관,23906,11702,12204
1,2023-09-07,인천터미널,26983,13359,13624
1,2023-09-07,문학경기장,3589,1821,1768
1,2023-09-07,선학,12771,6361,6410
1,2023-09-07,신연수,11953,6063,5890
1,2023-09-07,원인재,6209,3312,2897
1,2023-09-07,동춘,20840,10133,10707
1,2023-09-07,동막,11126,5888,5238
1,2023-09-07,캠퍼스타운,13128,6802,6326
1,2023-09-07,테크노파크,21931,11077,10854
1,2023-09-07,지식정보단지,10875,5284,5591
1,2023-09-07,인천대입구,19872,10005,9867
1,2023-09-07,센트럴파크(재외동포청),8051,4015,4036
1,2023-09-07,국제업무지구,3735,1882,1853
1,2023-09-07,송도달빛축제공원,10229,5080,5149
1,2023-09-08,계양,8280,4147,4133
1,2023-09-08,귤현,2574,1007,1567
1,2023-09-08,박촌,8193,4279,3914
1,2023-09-08,임학,17047,8581,8466
1,2023-09-08,계산,22341,11325,11016
1,2023-09-08,경인교대입구,11656,5962,5694
1,2023-09-08,작전,28862,14687,14175
1,2023-09-08,갈산,19643,9928,9715
1,2023-09-08,부평구청,14076,6885,7191
1,2023-09-08,부평시장,27930,13898,14032
1,2023-09-08,부평,14206,6975,7231
1,2023-09-08,동수,8658,4443,4215
1,2023-09-08,부평삼거리,5592,2826,2766
1,2023-09-08,간석오거리,22645,11930,10715
1,2023-09-08,인천시청,11608,5920,5688
1,2023-09-08,예술회관,25154,12142,13012
1,2023-09-08,인천터미널,31172,15310,15862
1,2023-09-08,문학경기장,3745,1839,1906
1,2023-09-08,선학,13583,6800,6783
1,2023-09-08,신연수,11957,6133,5824
1,2023-09-08,원인재,6258,3309,2949
1,2023-09-08,동춘,21581,10455,11126
1,2023-09-08,동막,11530,6115,5415
1,2023-09-08,캠퍼스타운,13547,6944,6603
1,2023-09-08,테크노파크,22481,11305,11176
1,2023-09-08,지식정보단지,10606,5237,5369
1,2023-09-08,인천대입구,18621,9447,9174
1,2023-09-08,센트럴파크(재외동포청),9039,4486,4553
1,2023-09-08,국제업무지구,3705,1885,1820
1,2023-09-08,송도달빛축제공원,10580,5250,5330
1,2023-09-09,계양,6829,3281,3548
1,2023-09-09,귤현,1641,743,898
1,2023-09-09,박촌,5605,3000,2605
1,2023-09-09,임학,12652,6432,6220
1,2023-09-09,계산,19141,9492,9649
1,2023-09-09,경인교대입구,9136,4603,4533
1,2023-09-09,작전,22677,11611,11066
1,2023-09-09,갈산,10298,5263,5035
1,2023-09-09,부평구청,10624,5178,5446
1,2023-09-09,부평시장,19612,9875,9737
1,2023-09-09,부평,15302,7734,7568
1,2023-09-09,동수,5926,3047,2879
1,2023-09-09,부평삼거리,4375,2197,2178
1,2023-09-09,간석오거리,17392,9131,8261
1,2023-09-09,인천시청,8024,4122,3902
1,2023-09-09,예술회관,18510,8756,9754
1,2023-09-09,인천터미널,29487,14532,14955
1,2023-09-09,문학경기장,14978,7237,7741
1,2023-09-09,선학,10786,5568,5218
1,2023-09-09,신연수,7443,3849,3594
1,2023-09-09,원인재,4334,2288,2046
1,2023-09-09,동춘,16421,8095,8326
1,2023-09-09,동막,7334,3854,3480
1,2023-09-09,캠퍼스타운,9852,5345,4507
1,2023-09-09,테크노파크,20412,10043,10369
1,2023-09-09,지식정보단지,4838,2464,2374
1,2023-09-09,인천대입구,12680,6164,6516
1,2023-09-09,센트럴파크(재외동포청),9048,4332,4716
1,2023-09-09,국제업무지구,2249,1162,1087
1,2023-09-09,송도달빛축제공원,16475,8043,8432
1,2023-09-10,계양,4688,2170,2518
1,2023-09-10,귤현,1092,525,567
1,2023-09-10,박촌,4170,2141,2029
1,2023-09-10,임학,9037,4590,4447
1,2023-09-10,계산,13758,6838,6920
1,2023-09-10,경인교대입구,7268,3570,3698
1,2023-09-10,작전,14176,7246,6930
1,2023-09-10,갈산,6694,3435,3259
1,2023-09-10,부평구청,7297,3587,3710
1,2023-09-10,부평시장,14931,7496,7435
1,2023-09-10,부평,9124,4771,4353
1,2023-09-10,동수,4263,2173,2090
1,2023-09-10,부평삼거리,3542,1740,1802
1,2023-09-10,간석오거리,12085,6225,5860
1,2023-09-10,인천시청,5561,2872,2689
1,2023-09-10,예술회관,11799,5729,6070
1,2023-09-10,인천터미널,22998,11602,11396
1,2023-09-10,문학경기장,1464,718,746
1,2023-09-10,선학,7792,3915,3877
1,2023-09-10,신연수,5141,2624,2517
1,2023-09-10,원인재,2856,1531,1325
1,2023-09-10,동춘,9155,4563,4592
1,2023-09-10,동막,4682,2404,2278
1,2023-09-10,캠퍼스타운,6345,3020,3325
1,2023-09-10,테크노파크,15364,7567,7797
1,2023-09-10,지식정보단지,2965,1459,1506
1,2023-09-10,인천대입구,8471,4091,4380
1,2023-09-10,센트럴파크(재외동포청),5735,2817,2918
1,2023-09-10,국제업무지구,858,441,417
1,2023-09-10,송도달빛축제공원,6517,3323,3194
1,2023-09-11,계양,7838,3968,3870
1,2023-09-11,귤현,2526,994,1532
1,2023-09-11,박촌,7931,4158,3773
1,2023-09-11,임학,16260,8211,8049
1,2023-09-11,계산,21960,11273,10687
1,2023-09-11,경인교대입구,11463,5734,5729
1,2023-09-11,작전,28247,14408,13839
1,2023-09-11,갈산,19375,9840,9535
1,2023-09-11,부평구청,13614,6669,6945
1,2023-09-11,부평시장,26617,13425,13192
1,2023-09-11,부평,12750,6396,6354
1,2023-09-11,동수,8479,4316,4163
1,2023-09-11,부평삼거리,5378,2758,2620
1,2023-09-11,간석오거리,21678,11353,10325
1,2023-09-11,인천시청,11064,5612,5452
1,2023-09-11,예술회관,23120,11404,11716
1,2023-09-11,인천터미널,26439,12757,13682
1,2023-09-11,문학경기장,3422,1698,1724
1,2023-09-11,선학,12256,6112,6144
1,2023-09-11,신연수,12075,6127,5948
1,2023-09-11,원인재,5984,3218,2766
1,2023-09-11,동춘,20691,10071,10620
1,2023-09-11,동막,10888,5724,5164
1,2023-09-11,캠퍼스타운,12676,6300,6376
1,2023-09-11,테크노파크,21169,10596,10573
1,2023-09-11,지식정보단지,10667,5170,5497
1,2023-09-11,인천대입구,18011,8923,9088
1,2023-09-11,센트럴파크(재외동포청),7339,3674,3665
1,2023-09-11,국제업무지구,3542,1816,1726
1,2023-09-11,송도달빛축제공원,9950,5051,4899
1,2023-09-12,계양,8109,4086,4023
1,2023-09-12,귤현,2559,992,1567
1,2023-09-12,박촌,8169,4254,3915
1,2023-09-12,임학,16689,8465,8224
1,2023-09-12,계산,21597,10937,10660
1,2023-09-12,경인교대입구,11489,5798,5691
1,2023-09-12,작전,28435,14495,13940
1,2023-09-12,갈산,19820,10103,9717
1,2023-09-12,부평구청,14595,7265,7330
1,2023-09-12,부평시장,27388,13768,13620
1,2023-09-12,부평,12411,6217,6194
1,2023-09-12,동수,8843,4520,4323
1,2023-09-12,부평삼거리,5626,2875,2751
1,2023-09-12,간석오거리,22334,11641,10693
1,2023-09-12,인천시청,11826,5958,5868
1,2023-09-12,예술회관,23903,11676,12227
1,2023-09-12,인천터미널,26159,12806,13353
1,2023-09-12,문학경기장,8803,4163,4640
1,2023-09-12,선학,12781,6395,6386
1,2023-09-12,신연수,12488,6243,6245
1,2023-09-12,원인재,6179,3315,2864
1,2023-09-12,동춘,20879,10188,10691
1,2023-09-12,동막,11478,6096,5382
1,2023-09-12,캠퍼스타운,12542,6270,6272
1,2023-09-12,테크노파크,21897,10913,10984
1,2023-09-12,지식정보단지,11088,5436,5652
1,2023-09-12,인천대입구,18771,9375,9396
1,2023-09-12,센트럴파크(재외동포청),8016,3969,4047
1,2023-09-12,국제업무지구,3827,1950,1877
1,2023-09-12,송도달빛축제공원,10118,5047,5071
1,2023-09-13,계양,7727,3949,3778
1,2023-09-13,귤현,2510,990,1520
1,2023-09-13,박촌,8082,4195,3887
1,2023-09-13,임학,16256,8236,8020
1,2023-09-13,계산,21539,10883,10656
1,2023-09-13,경인교대입구,11318,5647,5671
1,2023-09-13,작전,27811,14159,13652
1,2023-09-13,갈산,19414,9925,9489
1,2023-09-13,부평구청,13664,6794,6870
1,2023-09-13,부평시장,26468,13190,13278
1,2023-09-13,부평,12467,6357,6110
1,2023-09-13,동수,8781,4463,4318
1,2023-09-13,부평삼거리,5260,2666,2594
1,2023-09-13,간석오거리,21586,11212,10374
1,2023-09-13,인천시청,11035,5527,5508
1,2023-09-13,예술회관,23751,11727,12024
1,2023-09-13,인천터미널,25221,12348,12873
1,2023-09-13,문학경기장,3272,1672,1600
1,2023-09-13,선학,12292,6118,6174
1,2023-09-13,신연수,11658,5836,5822
1,2023-09-13,원인재,6184,3319,2865
1,2023-09-13,동춘,20355,9914,10441
1,2023-09-13,동막,11660,6110,5550
1,2023-09-13,캠퍼스타운,12177,6115,6062
1,2023-09-13,테크노파크,21079,10581,10498
1,2023-09-13,지식정보단지,10637,5087,5550
1,2023-09-13,인천대입구,18307,9094,9213
1,2023-09-13,센트럴파크(재외동포청),7600,3729,3871
1,2023-09-13,국제업무지구,3568,1803,1765
1,2023-09-13,송도달빛축제공원,9946,4984,4962
1,2023-09-14,계양,8135,4105,4030
1,2023-09-14,귤현,2610,1019,1591
1,2023-09-14,박촌,8020,4160,3860
1,2023-09-14,임학,16353,8301,8052
1,2023-09-14,계산,22334,11389,10945
1,2023-09-14,경인교대입구,11701,5981,5720
1,2023-09-14,작전,28131,14280,13851
1,2023-09-14,갈산,19759,10057,9702
1,2023-09-14,부평구청,14082,6968,7114
1,2023-09-14,부평시장,27494,13815,13679
1,2023-09-14,부평,12794,6394,6400
1,2023-09-14,동수,8702,4451,4251
1,2023-09-14,부평삼거리,5683,2841,2842
1,2023-09-14,간석오거리,22340,11680,10660
1,2023-09-14,인천시청,11212,5739,5473
1,2023-09-14,예술회관,24285,11861,12424
1,2023-09-14,인천터미널,26888,13537,13351
1,2023-09-14,문학경기장,3456,1761,1695
1,2023-09-14,선학,12594,6383,6211
1,2023-09-14,신연수,12148,6184,5964
1,2023-09-14,원인재,6409,3431,2978
1,2023-09-14,동춘,20882,10169,10713
1,2023-09-14,동막,11372,6040,5332
1,2023-09-14,캠퍼스타운,13035,6738,6297
1,2023-09-14,테크노파크,22680,11353,11327
1,2023-09-14,지식정보단지,10723,5268,5455
1,2023-09-14,인천대입구,19026,9524,9502
1,2023-09-14,센트럴파크(재외동포청),8171,3997,4174
1,2023-09-14,국제업무지구,3666,1838,1828
1,2023-09-14,송도달빛축제공원,10251,5093,5158
1,2023-09-15,계양,7951,4005,3946
1,2023-09-15,귤현,2662,1024,1638
1,2023-09-15,박촌,8102,4249,3853
1,2023-09-15,임학,16416,8318,8098
1,2023-09-15,계산,21915,11118,10797
1,2023-09-15,경인교대입구,11704,5929,5775
1,2023-09-15,작전,28544,14665,13879
1,2023-09-15,갈산,19641,10062,9579
1,2023-09-15,부평구청,13939,6938,7001
1,2023-09-15,부평시장,27436,13743,13693
1,2023-09-15,부평,14233,7002,7231
1,2023-09-15,동수,8682,4472,4210
1,2023-09-15,부평삼거리,5505,2782,2723
1,2023-09-15,간석오거리,22832,11977,10855
1,2023-09-15,인천시청,11418,5790,5628
1,2023-09-15,예술회관,25113,12038,13075
1,2023-09-15,인천터미널,30658,15115,15543
1,2023-09-15,문학경기장,3424,1733,1691
1,2023-09-15,선학,14073,7022,7051
1,2023-09-15,신연수,11676,5966,5710
1,2023-09-15,원인재,6314,3343,2971
1,2023-09-15,동춘,21188,10314,10874
1,2023-09-15,동막,11426,6037,5389
1,2023-09-15,캠퍼스타운,12951,6832,6119
1,2023-09-15,테크노파크,22347,11228,11119
1,2023-09-15,지식정보단지,10292,5008,5284
1,2023-09-15,인천대입구,18195,9315,8880
1,2023-09-15,센트럴파크(재외동포청),8716,4329,4387
1,2023-09-15,국제업무지구,3674,1887,1787
1,2023-09-15,송도달빛축제공원,10591,5351,5240
1,2023-09-16,계양,6238,3042,3196
1,2023-09-16,귤현,1570,667,903
1,2023-09-16,박촌,5470,2915,2555
1,2023-09-16,임학,11608,5963,5645
1,2023-09-16,계산,18008,8956,9052
1,2023-09-16,경인교대입구,9003,4554,4449
1,2023-09-16,작전,21131,10817,10314
1,2023-09-16,갈산,9710,5001,4709
1,2023-09-16,부평구청,9869,4839,5030
1,2023-09-16,부평시장,19301,9708,9593
1,2023-09-16,부평,13136,6599,6537
1,2023-09-16,동수,5645,2866,2779
1,2023-09-16,부평삼거리,4949,2466,2483
1,2023-09-16,간석오거리,17081,8930,8151
1,2023-09-16,인천시청,7852,3968,3884
1,2023-09-16,예술회관,17639,8374,9265
1,2023-09-16,인천터미널,28236,13969,14267
1,2023-09-16,문학경기장,4040,2027,2013
1,2023-09-16,선학,10388,5257,5131
1,2023-09-16,신연수,7228,3775,3453
1,2023-09-16,원인재,4293,2277,2016
1,2023-09-16,동춘,15232,7584,7648
1,2023-09-16,동막,6848,3565,3283
1,2023-09-16,캠퍼스타운,8650,4472,4178
1,2023-09-16,테크노파크,19040,9517,9523
1,2023-09-16,지식정보단지,4795,2475,2320
1,2023-09-16,인천대입구,12201,6111,6090
1,2023-09-16,센트럴파크(재외동포청),7506,3655,3851
1,2023-09-16,국제업무지구,1744,926,818
1,2023-09-16,송도달빛축제공원,8004,4079,3925
1,2023-09-17,계양,4506,2118,2388
1,2023-09-17,귤현,1029,499,530
1,2023-09-17,박촌,3956,2098,1858
1,2023-09-17,임학,8487,4320,4167
1,2023-09-17,계산,12717,6403,6314
1,2023-09-17,경인교대입구,7225,3547,3678
1,2023-09-17,작전,13849,7109,6740
1,2023-09-17,갈산,6448,3328,3120
1,2023-09-17,부평구청,7291,3559,3732
1,2023-09-17,부평시장,14184,7124,7060
1,2023-09-17,부평,9286,4930,4356
1,2023-09-17,동수,4276,2157,2119
1,2023-09-17,부평삼거리,4093,2079,2014
1,2023-09-17,간석오거리,12609,6601,6008
1,2023-09-17,인천시청,5459,2819,2640
1,2023-09-17,예술회관,12179,6012,6167
1,2023-09-17,인천터미널,23174,11677,11497
1,2023-09-17,문학경기장,2520,1254,1266
1,2023-09-17,선학,8180,4099,4081
1,2023-09-17,신연수,5119,2633,2486
1,2023-09-17,원인재,3046,1614,1432
1,2023-09-17,동춘,12030,6044,5986
1,2023-09-17,동막,4758,2524,2234
1,2023-09-17,캠퍼스타운,7067,3416,3651
1,2023-09-17,테크노파크,15964,7845,8119
1,2023-09-17,지식정보단지,3171,1579,1592
1,2023-09-17,인천대입구,9059,4289,4770
1,2023-09-17,센트럴파크(재외동포청),5472,2663,2809
1,2023-09-17,국제업무지구,750,404,346
1,2023-09-17,송도달빛축제공원,6449,3192,3257
1,2023-09-18,계양,7909,4046,3863
1,2023-09-18,귤현,2582,1002,1580
1,2023-09-18,박촌,8045,4232,3813
1,2023-09-18,임학,16273,8251,8022
1,2023-09-18,계산,21691,11098,10593
1,2023-09-18,경인교대입구,11168,5580,5588
1,2023-09-18,작전,27912,14262,13650
1,2023-09-18,갈산,19021,9682,9339
1,2023-09-18,부평구청,13733,6855,6878
1,2023-09-18,부평시장,27049,13557,13492
1,2023-09-18,부평,12575,6377,6198
1,2023-09-18,동수,8379,4271,4108
1,2023-09-18,부평삼거리,5768,2922,2846
1,2023-09-18,간석오거리,21706,11374,10332
1,2023-09-18,인천시청,11031,5592,5439
1,2023-09-18,예술회관,23534,11543,11991
1,2023-09-18,인천터미널,26921,13026,13895
1,2023-09-18,문학경기장,3972,1954,2018
1,2023-09-18,선학,12222,6067,6155
1,2023-09-18,신연수,11995,6024,5971
1,2023-09-18,원인재,6008,3203,2805
1,2023-09-18,동춘,20523,9999,10524
1,2023-09-18,동막,10817,5710,5107
1,2023-09-18,캠퍼스타운,12397,6154,6243
1,2023-09-18,테크노파크,21200,10583,10617
1,2023-09-18,지식정보단지,10770,5255,5515
1,2023-09-18,인천대입구,17926,8838,9088
1,2023-09-18,센트럴파크(재외동포청),7450,3687,3763
1,2023-09-18,국제업무지구,3546,1829,1717
1,2023-09-18,송도달빛축제공원,9863,4956,4907
1,2023-09-19,계양,8237,4222,4015
1,2023-09-19,귤현,2605,995,1610
1,2023-09-19,박촌,8118,4215,3903
1,2023-09-19,임학,16494,8357,8137
1,2023-09-19,계산,21354,10805,10549
1,2023-09-19,경인교대입구,11388,5704,5684
1,2023-09-19,작전,28227,14292,13935
1,2023-09-19,갈산,19581,10023,9558
1,2023-09-19,부평구청,14232,7081,7151
1,2023-09-19,부평시장,27796,13921,13875
1,2023-09-19,부평,12489,6211,6278
1,2023-09-19,동수,8660,4425,4235
1,2023-09-19,부평삼거리,5719,2884,2835
1,2023-09-19,간석오거리,22272,11614,10658
1,2023-09-19,인천시청,11243,5670,5573
1,2023-09-19,예술회관,23873,11690,12183
1,2023-09-19,인천터미널,25552,12506,13046
1,2023-09-19,문학경기장,3695,1798,1897
1,2023-09-19,선학,12713,6348,6365
1,2023-09-19,신연수,12125,6097,6028
1,2023-09-19,원인재,5974,3218,2756
1,2023-09-19,동춘,20630,10092,10538
1,2023-09-19,동막,11361,5964,5397
1,2023-09-19,캠퍼스타운,12298,6185,6113
1,2023-09-19,테크노파크,21499,10706,10793
1,2023-09-19,지식정보단지,10938,5356,5582
1,2023-09-19,인천대입구,18537,9261,9276
1,2023-09-19,센트럴파크(재외동포청),7981,3980,4001
1,2023-09-19,국제업무지구,3765,1921,1844
1,2023-09-19,송도달빛축제공원,10270,5129,5141
1,2023-09-20,계양,7957,4054,3903
1,2023-09-20,귤현,2566,964,1602
1,2023-09-20,박촌,7840,4082,3758
1,2023-09-20,임학,15605,7891,7714
1,2023-09-20,계산,20834,10618,10216
1,2023-09-20,경인교대입구,10873,5432,5441
1,2023-09-20,작전,27218,13787,13431
1,2023-09-20,갈산,19428,9883,9545
1,2023-09-20,부평구청,13435,6646,6789
1,2023-09-20,부평시장,25987,13045,12942
1,2023-09-20,부평,12158,6147,6011
1,2023-09-20,동수,8440,4319,4121
1,2023-09-20,부평삼거리,5121,2622,2499
1,2023-09-20,간석오거리,21288,11076,10212
1,2023-09-20,인천시청,10795,5464,5331
1,2023-09-20,예술회관,23194,11416,11778
1,2023-09-20,인천터미널,24548,12095,12453
1,2023-09-20,문학경기장,3212,1545,1667
1,2023-09-20,선학,11946,5967,5979
1,2023-09-20,신연수,11301,5675,5626
1,2023-09-20,원인재,5926,3171,2755
1,2023-09-20,동춘,19592,9501,10091
1,2023-09-20,동막,10830,5684,5146
1,2023-09-20,캠퍼스타운,11740,5914,5826
1,2023-09-20,테크노파크,20034,10039,9995
1,2023-09-20,지식정보단지,10714,5238,5476
1,2023-09-20,인천대입구,17882,8878,9004
1,2023-09-20,센트럴파크(재외동포청),7369,3646,3723
1,2023-09-20,국제업무지구,3642,1865,1777
1,2023-09-20,송도달빛축제공원,9139,4548,4591
1,2023-09-21,계양,8218,4209,4009
1,2023-09-21,귤현,2748,1058,1690
1,2023-09-21,박촌,8222,4293,3929
1,2023-09-21,임학,16640,8385,8255
1,2023-09-21,계산,22468,11460,11008
1,2023-09-21,경인교대입구,11836,5991,5845
1,2023-09-21,작전,28696,14609,14087
1,2023-09-21,갈산,19640,9976,9664
1,2023-09-21,부평구청,14466,7153,7313
1,2023-09-21,부평시장,28333,14182,14151
1,2023-09-21,부평,12736,6415,6321
1,2023-09-21,동수,8641,4357,4284
1,2023-09-21,부평삼거리,5941,2986,2955
1,2023-09-21,간석오거리,22468,11759,10709
1,2023-09-21,인천시청,11724,5902,5822
1,2023-09-21,예술회관,24468,12035,12433
1,2023-09-21,인천터미널,27336,13504,13832
1,2023-09-21,문학경기장,10486,5125,5361
1,2023-09-21,선학,12865,6485,6380
1,2023-09-21,신연수,12229,6190,6039
1,2023-09-21,원인재,6500,3504,2996
1,2023-09-21,동춘,21469,10449,11020
1,2023-09-21,동막,11334,5972,5362
1,2023-09-21,캠퍼스타운,13218,6799,6419
1,2023-09-21,테크노파크,21944,11002,10942
1,2023-09-21,지식정보단지,10922,5348,5574
1,2023-09-21,인천대입구,18585,9263,9322
1,2023-09-21,센트럴파크(재외동포청),8190,4032,4158
1,2023-09-21,국제업무지구,3739,1885,1854
1,2023-09-21,송도달빛축제공원,10443,5252,5191
1,2023-09-22,계양,8454,4258,4196
1,2023-09-22,귤현,2746,1086,1660
1,2023-09-22,박촌,8407,4380,4027
1,2023-09-22,임학,17293,8768,8525
1,2023-09-22,계산,23122,11714,11408
1,2023-09-22,경인교대입구,11916,6031,5885
1,2023-09-22,작전,29405,14992,14413
1,2023-09-22,갈산,20211,10268,9943
1,2023-09-22,부평구청,15003,7229,7774
1,2023-09-22,부평시장,29660,14650,15010
1,2023-09-22,부평,15008,7464,7544
1,2023-09-22,동수,8765,4493,4272
1,2023-09-22,부평삼거리,6273,3211,3062
1,2023-09-22,간석오거리,23384,12183,11201
1,2023-09-22,인천시청,12066,6126,5940
1,2023-09-22,예술회관,26127,12616,13511
1,2023-09-22,인천터미널,31489,15658,15831
1,2023-09-22,문학경기장,11653,5608,6045
1,2023-09-22,선학,13422,6794,6628
1,2023-09-22,신연수,12440,6367,6073
1,2023-09-22,원인재,6772,3613,3159
1,2023-09-22,동춘,22288,10872,11416
1,2023-09-22,동막,11781,6254,5527
1,2023-09-22,캠퍼스타운,13733,7239,6494
1,2023-09-22,테크노파크,23268,11618,11650
1,2023-09-22,지식정보단지,10795,5258,5537
1,2023-09-22,인천대입구,18113,9149,8964
1,2023-09-22,센트럴파크(재외동포청),9121,4464,4657
1,2023-09-22,국제업무지구,3765,1930,1835
1,2023-09-22,송도달빛축제공원,11191,5528,5663
1,2023-09-23,계양,7072,3380,3692
1,2023-09-23,귤현,1720,744,976
1,2023-09-23,박촌,5851,3133,2718
1,2023-09-23,임학,12995,6652,6343
1,2023-09-23,계산,19610,9816,9794
1,2023-09-23,경인교대입구,10019,4919,5100
1,2023-09-23,작전,23661,12134,11527
1,2023-09-23,갈산,11230,5768,5462
1,2023-09-23,부평구청,11744,5785,5959
1,2023-09-23,부평시장,28105,14250,13855
1,2023-09-23,부평,16609,8446,8163
1,2023-09-23,동수,6132,3148,2984
1,2023-09-23,부평삼거리,7030,3464,3566
1,2023-09-23,간석오거리,17949,9417,8532
1,2023-09-23,인천시청,8037,4195,3842
1,2023-09-23,예술회관,18980,8936,10044
1,2023-09-23,인천터미널,29762,14825,14937
1,2023-09-23,문학경기장,13489,6511,6978
1,2023-09-23,선학,10565,5398,5167
1,2023-09-23,신연수,7240,3782,3458
1,2023-09-23,원인재,5079,2576,2503
1,2023-09-23,동춘,17298,8574,8724
1,2023-09-23,동막,7388,3889,3499
1,2023-09-23,캠퍼스타운,9512,4950,4562
1,2023-09-23,테크노파크,20147,9958,10189
1,2023-09-23,지식정보단지,4775,2445,2330
1,2023-09-23,인천대입구,13116,6516,6600
1,2023-09-23,센트럴파크(재외동포청),8940,4338,4602
1,2023-09-23,국제업무지구,3211,1766,1445
1,2023-09-23,송도달빛축제공원,25408,12316,13092
1,2023-09-24,계양,4878,2313,2565
1,2023-09-24,귤현,1189,568,621
1,2023-09-24,박촌,4381,2310,2071
1,2023-09-24,임학,9362,4728,4634
1,2023-09-24,계산,14448,7173,7275
1,2023-09-24,경인교대입구,7925,3894,4031
1,2023-09-24,작전,15915,8048,7867
1,2023-09-24,갈산,7806,4021,3785
1,2023-09-24,부평구청,8662,4238,4424
1,2023-09-24,부평시장,21344,10812,10532
1,2023-09-24,부평,11719,6259,5460
1,2023-09-24,동수,4548,2298,2250
1,2023-09-24,부평삼거리,6376,3188,3188
1,2023-09-24,간석오거리,12884,6755,6129
1,2023-09-24,인천시청,5899,3006,2893
1,2023-09-24,예술회관,12291,6027,6264
1,2023-09-24,인천터미널,23354,11428,11926
1,2023-09-24,문학경기장,9144,4464,4680
1,2023-09-24,선학,8235,4141,4094
1,2023-09-24,신연수,5418,2762,2656
1,2023-09-24,원인재,3367,1750,1617
1,2023-09-24,동춘,10316,5220,5096
1,2023-09-24,동막,4884,2588,2296
1,2023-09-24,캠퍼스타운,6943,3399,3544
1,2023-09-24,테크노파크,15584,7661,7923
1,2023-09-24,지식정보단지,3102,1537,1565
1,2023-09-24,인천대입구,11351,5520,5831
1,2023-09-24,센트럴파크(재외동포청),5822,2933,2889
1,2023-09-24,국제업무지구,953,490,463
1,2023-09-24,송도달빛축제공원,6687,3455,3232
1,2023-09-25,계양,8024,4048,3976
1,2023-09-25,귤현,2643,1079,1564
1,2023-09-25,박촌,8002,4209,3793
1,2023-09-25,임학,16756,8524,8232
1,2023-09-25,계산,22543,11494,11049
1,2023-09-25,경인교대입구,11708,5918,5790
1,2023-09-25,작전,28926,14721,14205
1,2023-09-25,갈산,19917,10164,9753
1,2023-09-25,부평구청,13949,6983,6966
1,2023-09-25,부평시장,28743,14424,14319
1,2023-09-25,부평,12888,6462,6426
1,2023-09-25,동수,8841,4505,4336
1,2023-09-25,부평삼거리,6830,3507,3323
1,2023-09-25,간석오거리,21727,11436,10291
1,2023-09-25,인천시청,10935,5530,5405
1,2023-09-25,예술회관,23773,11799,11974
1,2023-09-25,인천터미널,26980,13024,13956
1,2023-09-25,문학경기장,3552,1715,1837
1,2023-09-25,선학,12314,6149,6165
1,2023-09-25,신연수,12273,6133,6140
1,2023-09-25,원인재,6275,3337,2938
1,2023-09-25,동춘,21247,10371,10876
1,2023-09-25,동막,10915,5729,5186
1,2023-09-25,캠퍼스타운,12524,6186,6338
1,2023-09-25,테크노파크,21204,10577,10627
1,2023-09-25,지식정보단지,10538,5063,5475
1,2023-09-25,인천대입구,18016,8927,9089
1,2023-09-25,센트럴파크(재외동포청),7742,3848,3894
1,2023-09-25,국제업무지구,3671,1867,1804
1,2023-09-25,송도달빛축제공원,10035,5065,4970
1,2023-09-26,계양,7596,3920,3676
1,2023-09-26,귤현,2556,1015,1541
1,2023-09-26,박촌,7975,4174,3801
1,2023-09-26,임학,16225,8140,8085
1,2023-09-26,계산,20446,10405,10041
1,2023-09-26,경인교대입구,11227,5743,5484
1,2023-09-26,작전,27597,13970,13627
1,2023-09-26,갈산,19612,10003,9609
1,2023-09-26,부평구청,13535,6726,6809
1,2023-09-26,부평시장,26983,13526,13457
1,2023-09-26,부평,12255,6170,6085
1,2023-09-26,동수,8620,4408,4212
1,2023-09-26,부평삼거리,5813,2942,2871
1,2023-09-26,간석오거리,21512,11230,10282
1,2023-09-26,인천시청,11015,5561,5454
1,2023-09-26,예술회관,23116,11360,11756
1,2023-09-26,인천터미널,26117,12657,13460
1,2023-09-26,문학경기장,3795,1900,1895
1,2023-09-26,선학,12265,6197,6068
1,2023-09-26,신연수,11510,5771,5739
1,2023-09-26,원인재,5991,3224,2767
1,2023-09-26,동춘,20782,10069,10713
1,2023-09-26,동막,10898,5727,5171
1,2023-09-26,캠퍼스타운,12052,6049,6003
1,2023-09-26,테크노파크,21418,10700,10718
1,2023-09-26,지식정보단지,10407,5080,5327
1,2023-09-26,인천대입구,18848,9369,9479
1,2023-09-26,센트럴파크(재외동포청),7392,3684,3708
1,2023-09-26,국제업무지구,3590,1784,1806
1,2023-09-26,송도달빛축제공원,9439,4754,4685
1,2023-09-27,계양,8155,4112,4043
1,2023-09-27,귤현,2576,982,1594
1,2023-09-27,박촌,8158,4288,3870
1,2023-09-27,임학,17323,8598,8725
1,2023-09-27,계산,22500,11414,11086
1,2023-09-27,경인교대입구,12018,6083,5935
1,2023-09-27,작전,29132,14697,14435
1,2023-09-27,갈산,19452,9943,9509
1,2023-09-27,부평구청,14233,7042,7191
1,2023-09-27,부평시장,29073,14395,14678
1,2023-09-27,부평,14111,6967,7144
1,2023-09-27,동수,8599,4450,4149
1,2023-09-27,부평삼거리,6838,3453,3385
1,2023-09-27,간석오거리,22387,11752,10635
1,2023-09-27,인천시청,11248,5787,5461
1,2023-09-27,예술회관,25060,12049,13011
1,2023-09-27,인천터미널,35287,16401,18886
1,2023-09-27,문학경기장,12625,6035,6590
1,2023-09-27,선학,13164,6722,6442
1,2023-09-27,신연수,11909,6102,5807
1,2023-09-27,원인재,5924,3156,2768
1,2023-09-27,동춘,22401,10673,11728
1,2023-09-27,동막,10969,5860,5109
1,2023-09-27,캠퍼스타운,13565,7313,6252
1,2023-09-27,테크노파크,22234,11247,10987
1,2023-09-27,지식정보단지,10368,5108,5260
1,2023-09-27,인천대입구,18335,9491,8844
1,2023-09-27,센트럴파크(재외동포청),7763,3747,4016
1,2023-09-27,국제업무지구,3362,1705,1657
1,2023-09-27,송도달빛축제공원,10178,5018,5160
1,2023-09-28,계양,4172,1936,2236
1,2023-09-28,귤현,940,429,511
1,2023-09-28,박촌,3544,1848,1696
1,2023-09-28,임학,7811,3885,3926
1,2023-09-28,계산,10700,5399,5301
1,2023-09-28,경인교대입구,5876,2979,2897
1,2023-09-28,작전,12041,6053,5988
1,2023-09-28,갈산,5710,2970,2740
1,2023-09-28,부평구청,5989,2922,3067
1,2023-09-28,부평시장,13363,6652,6711
1,2023-09-28,부평,8136,3987,4149
1,2023-09-28,동수,3726,1941,1785
1,2023-09-28,부평삼거리,9156,4516,4640
1,2023-09-28,간석오거리,10443,5527,4916
1,2023-09-28,인천시청,4232,2212,2020
1,2023-09-28,예술회관,10156,5048,5108
1,2023-09-28,인천터미널,21574,9415,12159
1,2023-09-28,문학경기장,906,458,448
1,2023-09-28,선학,6948,3509,3439
1,2023-09-28,신연수,4397,2286,2111
1,2023-09-28,원인재,2299,1223,1076
1,2023-09-28,동춘,11664,5687,5977
1,2023-09-28,동막,3882,2020,1862
1,2023-09-28,캠퍼스타운,5191,2886,2305
1,2023-09-28,테크노파크,13107,6574,6533
1,2023-09-28,지식정보단지,2380,1308,1072
1,2023-09-28,인천대입구,6152,3380,2772
1,2023-09-28,센트럴파크(재외동포청),5194,2552,2642
1,2023-09-28,국제업무지구,514,278,236
1,2023-09-28,송도달빛축제공원,4922,2514,2408
1,2023-09-29,계양,3440,1574,1866
1,2023-09-29,귤현,850,411,439
1,2023-09-29,박촌,3349,1766,1583
1,2023-09-29,임학,6637,3334,3303
1,2023-09-29,계산,9924,5021,4903
1,2023-09-29,경인교대입구,5145,2534,2611
1,2023-09-29,작전,11141,5646,5495
1,2023-09-29,갈산,5088,2650,2438
1,2023-09-29,부평구청,5587,2794,2793
1,2023-09-29,부평시장,9763,4881,4882
1,2023-09-29,부평,5788,2798,2990
1,2023-09-29,동수,3318,1681,1637
1,2023-09-29,부평삼거리,21995,11101,10894
1,2023-09-29,간석오거리,9598,5085,4513
1,2023-09-29,인천시청,3943,2111,1832
1,2023-09-29,예술회관,8151,3813,4338
1,2023-09-29,인천터미널,14901,7002,7899
1,2023-09-29,문학경기장,710,376,334
1,2023-09-29,선학,6014,2994,3020
1,2023-09-29,신연수,3938,2053,1885
1,2023-09-29,원인재,2195,1143,1052
1,2023-09-29,동춘,9407,4682,4725
1,2023-09-29,동막,2957,1647,1310
1,2023-09-29,캠퍼스타운,3676,1886,1790
1,2023-09-29,테크노파크,6389,3160,3229
1,2023-09-29,지식정보단지,1732,886,846
1,2023-09-29,인천대입구,4318,2210,2108
1,2023-09-29,센트럴파크(재외동포청),4010,1952,2058
1,2023-09-29,국제업무지구,353,204,149
1,2023-09-29,송도달빛축제공원,3802,1947,1855
1,2023-09-30,계양,4342,1987,2355
1,2023-09-30,귤현,994,454,540
1,2023-09-30,박촌,3468,1875,1593
1,2023-09-30,임학,7714,3876,3838
1,2023-09-30,계산,11013,5509,5504
1,2023-09-30,경인교대입구,5532,2785,2747
1,2023-09-30,작전,11949,6183,5766
1,2023-09-30,갈산,5343,2822,2521
1,2023-09-30,부평구청,5928,2881,3047
1,2023-09-30,부평시장,11437,5773,5664
1,2023-09-30,부평,8472,4233,4239
1,2023-09-30,동수,3507,1753,1754
1,2023-09-30,부평삼거리,5975,3025,2950
1,2023-09-30,간석오거리,10994,5778,5216
1,2023-09-30,인천시청,4287,2208,2079
1,2023-09-30,예술회관,10554,4785,5769
1,2023-09-30,인천터미널,21846,11127,10719
1,2023-09-30,문학경기장,11853,5827,6026
1,2023-09-30,선학,6731,3463,3268
1,2023-09-30,신연수,4146,2205,1941
1,2023-09-30,원인재,2196,1156,1040
1,2023-09-30,동춘,10818,5347,5471
1,2023-09-30,동막,3635,1916,1719
1,2023-09-30,캠퍼스타운,4882,2512,2370
1,2023-09-30,테크노파크,14804,7333,7471
1,2023-09-30,지식정보단지,2337,1168,1169
1,2023-09-30,인천대입구,5974,2909,3065
1,2023-09-30,센트럴파크(재외동포청),5762,2799,2963
1,2023-09-30,국제업무지구,510,286,224
1,2023-09-30,송도달빛축제공원,5208,2629,2579
1,2023-10-01,계양,5043,2351,2692
1,2023-10-01,귤현,1105,518,587
1,2023-10-01,박촌,4013,2130,1883
1,2023-10-01,임학,8895,4595,4300
1,2023-10-01,계산,14012,6892,7120
1,2023-10-01,경인교대입구,6994,3464,3530
1,2023-10-01,작전,14213,7417,6796
1,2023-10-01,갈산,6362,3307,3055
1,2023-10-01,부평구청,7432,3598,3834
1,2023-10-01,부평시장,13928,6918,7010
1,2023-10-01,부평,9737,4897,4840
1,2023-10-01,동수,4291,2234,2057
1,2023-10-01,부평삼거리,5305,2688,2617
1,2023-10-01,간석오거리,12740,6632,6108
1,2023-10-01,인천시청,5229,2680,2549
1,2023-10-01,예술회관,12089,5641,6448
1,2023-10-01,인천터미널,25214,13091,12123
1,2023-10-01,문학경기장,14496,7093,7403
1,2023-10-01,선학,8012,4006,4006
1,2023-10-01,신연수,4728,2480,2248
1,2023-10-01,원인재,2664,1428,1236
1,2023-10-01,동춘,12452,6179,6273
1,2023-10-01,동막,4405,2401,2004
1,2023-10-01,캠퍼스타운,5881,3004,2877
1,2023-10-01,테크노파크,16525,8175,8350
1,2023-10-01,지식정보단지,2638,1309,1329
1,2023-10-01,인천대입구,7249,3508,3741
1,2023-10-01,센트럴파크(재외동포청),6928,3318,3610
1,2023-10-01,국제업무지구,600,326,274
1,2023-10-01,송도달빛축제공원,6391,3156,3235
1,2023-10-02,계양,5721,2735,2986
1,2023-10-02,귤현,1279,595,684
1,2023-10-02,박촌,4489,2379,2110
1,2023-10-02,임학,9973,5094,4879
1,2023-10-02,계산,15489,7709,7780
1,2023-10-02,경인교대입구,7568,3810,3758
1,2023-10-02,작전,16330,8339,7991
1,2023-10-02,갈산,7531,3825,3706
1,2023-10-02,부평구청,8436,4161,4275
1,2023-10-02,부평시장,16173,8027,8146
1,2023-10-02,부평,11506,5821,5685
1,2023-10-02,동수,5013,2525,2488
1,2023-10-02,부평삼거리,4999,2466,2533
1,2023-10-02,간석오거리,13877,7334,6543
1,2023-10-02,인천시청,5686,2945,2741
1,2023-10-02,예술회관,14408,6702,7706
1,2023-10-02,인천터미널,26373,13660,12713
1,2023-10-02,문학경기장,1896,955,941
1,2023-10-02,선학,8416,4174,4242
1,2023-10-02,신연수,5798,2985,2813
1,2023-10-02,원인재,3107,1627,1480
1,2023-10-02,동춘,13721,6813,6908
1,2023-10-02,동막,5229,2723,2506
1,2023-10-02,캠퍼스타운,7169,3638,3531
1,2023-10-02,테크노파크,17089,8386,8703
1,2023-10-02,지식정보단지,3337,1657,1680
1,2023-10-02,인천대입구,11506,5575,5931
1,2023-10-02,센트럴파크(재외동포청),7043,3448,3595
1,2023-10-02,국제업무지구,1047,554,493
1,2023-10-02,송도달빛축제공원,7285,3676,3609
1,2023-10-03,계양,4991,2332,2659
1,2023-10-03,귤현,1229,583,646
1,2023-10-03,박촌,4194,2248,1946
1,2023-10-03,임학,8815,4574,4241
1,2023-10-03,계산,14114,6979,7135
1,2023-10-03,경인교대입구,6672,3246,3426
1,2023-10-03,작전,14582,7557,7025
1,2023-10-03,갈산,7553,3849,3704
1,2023-10-03,부평구청,7323,3576,3747
1,2023-10-03,부평시장,14838,7398,7440
1,2023-10-03,부평,9153,4674,4479
1,2023-10-03,동수,4063,2101,1962
1,2023-10-03,부평삼거리,4157,2056,2101
1,2023-10-03,간석오거리,13088,6792,6296
1,2023-10-03,인천시청,5105,2615,2490
1,2023-10-03,예술회관,12134,5899,6235
1,2023-10-03,인천터미널,24074,12507,11567
1,2023-10-03,문학경기장,9773,4755,5018
1,2023-10-03,선학,7615,3785,3830
1,2023-10-03,신연수,5465,2766,2699
1,2023-10-03,원인재,2864,1490,1374
1,2023-10-03,동춘,12055,6098,5957
1,2023-10-03,동막,4673,2468,2205
1,2023-10-03,캠퍼스타운,7055,3212,3843
1,2023-10-03,테크노파크,15118,7424,7694
1,2023-10-03,지식정보단지,3528,1712,1816
1,2023-10-03,인천대입구,8453,3973,4480
1,2023-10-03,센트럴파크(재외동포청),5927,2927,3000
1,2023-10-03,국제업무지구,1196,638,558
1,2023-10-03,송도달빛축제공원,6290,3120,3170
1,2023-10-04,계양,7743,3982,3761
1,2023-10-04,귤현,2606,1046,1560
1,2023-10-04,박촌,8044,4187,3857
1,2023-10-04,임학,16476,8317,8159
1,2023-10-04,계산,22124,11223,10901
1,2023-10-04,경인교대입구,11587,5795,5792
1,2023-10-04,작전,28695,14622,14073
1,2023-10-04,갈산,19467,9863,9604
1,2023-10-04,부평구청,13496,6640,6856
1,2023-10-04,부평시장,27449,13750,13699
1,2023-10-04,부평,12650,6436,6214
1,2023-10-04,동수,8822,4457,4365
1,2023-10-04,부평삼거리,5575,2804,2771
1,2023-10-04,간석오거리,21893,11410,10483
1,2023-10-04,인천시청,11326,5754,5572
1,2023-10-04,예술회관,23843,11819,12024
1,2023-10-04,인천터미널,26754,13046,13708
1,2023-10-04,문학경기장,7598,3620,3978
1,2023-10-04,선학,12424,6196,6228
1,2023-10-04,신연수,11961,6048,5913
1,2023-10-04,원인재,5898,3149,2749
1,2023-10-04,동춘,20179,9841,10338
1,2023-10-04,동막,10975,5738,5237
1,2023-10-04,캠퍼스타운,12690,6347,6343
1,2023-10-04,테크노파크,21134,10554,10580
1,2023-10-04,지식정보단지,10673,5149,5524
1,2023-10-04,인천대입구,17918,8925,8993
1,2023-10-04,센트럴파크(재외동포청),7680,3850,3830
1,2023-10-04,국제업무지구,3718,1892,1826
1,2023-10-04,송도달빛축제공원,9915,4971,4944
1,2023-10-05,계양,8084,4081,4003
1,2023-10-05,귤현,2608,997,1611
1,2023-10-05,박촌,8052,4214,3838
1,2023-10-05,임학,16890,8467,8423
1,2023-10-05,계산,22561,11409,11152
1,2023-10-05,경인교대입구,11433,5794,5639
1,2023-10-05,작전,28906,14546,14360
1,2023-10-05,갈산,19691,9967,9724
1,2023-10-05,부평구청,14255,6996,7259
1,2023-10-05,부평시장,27630,13826,13804
1,2023-10-05,부평,12995,6476,6519
1,2023-10-05,동수,8739,4454,4285
1,2023-10-05,부평삼거리,5499,2757,2742
1,2023-10-05,간석오거리,22498,11728,10770
1,2023-10-05,인천시청,11320,5677,5643
1,2023-10-05,예술회관,23813,11738,12075
1,2023-10-05,인천터미널,26931,13427,13504
1,2023-10-05,문학경기장,8276,3959,4317
1,2023-10-05,선학,12436,6190,6246
1,2023-10-05,신연수,11908,6004,5904
1,2023-10-05,원인재,6047,3253,2794
1,2023-10-05,동춘,21193,10353,10840
1,2023-10-05,동막,10988,5782,5206
1,2023-10-05,캠퍼스타운,12693,6576,6117
1,2023-10-05,테크노파크,21706,10878,10828
1,2023-10-05,지식정보단지,10704,5251,5453
1,2023-10-05,인천대입구,18206,9134,9072
1,2023-10-05,센트럴파크(재외동포청),8621,4233,4388
1,2023-10-05,국제업무지구,3721,1903,1818
1,2023-10-05,송도달빛축제공원,10331,5089,5242
1,2023-10-06,계양,8468,4266,4202
1,2023-10-06,귤현,2660,1048,1612
1,2023-10-06,박촌,8257,4347,3910
1,2023-10-06,임학,17051,8577,8474
1,2023-10-06,계산,22876,11658,11218
1,2023-10-06,경인교대입구,11727,5931,5796
1,2023-10-06,작전,29898,15200,14698
1,2023-10-06,갈산,19972,10157,9815
1,2023-10-06,부평구청,15072,7503,7569
1,2023-10-06,부평시장,28614,14361,14253
1,2023-10-06,부평,14172,7032,7140
1,2023-10-06,동수,8794,4481,4313
1,2023-10-06,부평삼거리,5759,2969,2790
1,2023-10-06,간석오거리,23110,12167,10943
1,2023-10-06,인천시청,11956,6089,5867
1,2023-10-06,예술회관,25304,12162,13142
1,2023-10-06,인천터미널,30720,15310,15410
1,2023-10-06,문학경기장,15621,7500,8121
1,2023-10-06,선학,13341,6703,6638
1,2023-10-06,신연수,12359,6294,6065
1,2023-10-06,원인재,6165,3309,2856
1,2023-10-06,동춘,22239,10888,11351
1,2023-10-06,동막,11478,6039,5439
1,2023-10-06,캠퍼스타운,13425,7009,6416
1,2023-10-06,테크노파크,23028,11561,11467
1,2023-10-06,지식정보단지,10844,5316,5528
1,2023-10-06,인천대입구,19204,9449,9755
1,2023-10-06,센트럴파크(재외동포청),8960,4486,4474
1,2023-10-06,국제업무지구,3788,1914,1874
1,2023-10-06,송도달빛축제공원,10998,5523,5475
1,2023-10-07,계양,6704,3104,3600
1,2023-10-07,귤현,1571,709,862
1,2023-10-07,박촌,5758,3077,2681
1,2023-10-07,임학,12368,6365,6003
1,2023-10-07,계산,19163,9646,9517
1,2023-10-07,경인교대입구,9297,4726,4571
1,2023-10-07,작전,22059,11422,10637
1,2023-10-07,갈산,9790,5130,4660
1,2023-10-07,부평구청,10505,5124,5381
1,2023-10-07,부평시장,19753,10058,9695
1,2023-10-07,부평,12668,6274,6394
1,2023-10-07,동수,5676,2909,2767
1,2023-10-07,부평삼거리,4077,2034,2043
1,2023-10-07,간석오거리,16536,8710,7826
1,2023-10-07,인천시청,8120,4188,3932
1,2023-10-07,예술회관,16800,7958,8842
1,2023-10-07,인천터미널,28308,13664,14644
1,2023-10-07,문학경기장,2959,1468,1491
1,2023-10-07,선학,10592,5314,5278
1,2023-10-07,신연수,7297,3833,3464
1,2023-10-07,원인재,4127,2150,1977
1,2023-10-07,동춘,16047,7989,8058
1,2023-10-07,동막,6973,3721,3252
1,2023-10-07,캠퍼스타운,9381,4906,4475
1,2023-10-07,테크노파크,19241,9514,9727
1,2023-10-07,지식정보단지,4909,2492,2417
1,2023-10-07,인천대입구,12067,6178,5889
1,2023-10-07,센트럴파크(재외동포청),9671,4691,4980
1,2023-10-07,국제업무지구,1994,1085,909
1,2023-10-07,송도달빛축제공원,11577,5832,5745
1,2023-10-08,계양,5075,2324,2751
1,2023-10-08,귤현,1256,562,694
1,2023-10-08,박촌,4446,2332,2114
1,2023-10-08,임학,9178,4686,4492
1,2023-10-08,계산,15302,7602,7700
1,2023-10-08,경인교대입구,7542,3873,3669
1,2023-10-08,작전,15303,7784,7519
1,2023-10-08,갈산,7034,3631,3403
1,2023-10-08,부평구청,7926,3812,4114
1,2023-10-08,부평시장,15254,7707,7547
1,2023-10-08,부평,9937,5138,4799
1,2023-10-08,동수,4218,2133,2085
1,2023-10-08,부평삼거리,3501,1726,1775
1,2023-10-08,간석오거리,12808,6726,6082
1,2023-10-08,인천시청,5817,2951,2866
1,2023-10-08,예술회관,12563,5986,6577
1,2023-10-08,인천터미널,22449,11129,11320
1,2023-10-08,문학경기장,1688,887,801
1,2023-10-08,선학,8191,4069,4122
1,2023-10-08,신연수,5045,2576,2469
1,2023-10-08,원인재,2799,1430,1369
1,2023-10-08,동춘,9885,4887,4998
1,2023-10-08,동막,5123,2700,2423
1,2023-10-08,캠퍼스타운,6743,3433,3310
1,2023-10-08,테크노파크,17279,8537,8742
1,2023-10-08,지식정보단지,3224,1648,1576
1,2023-10-08,인천대입구,10075,4966,5109
1,2023-10-08,센트럴파크(재외동포청),7228,3522,3706
1,2023-10-08,국제업무지구,970,496,474
1,2023-10-08,송도달빛축제공원,8806,4417,4389
1,2023-10-09,계양,5038,2416,2622
1,2023-10-09,귤현,1211,566,645
1,2023-10-09,박촌,4376,2282,2094
1,2023-10-09,임학,9308,4754,4554
1,2023-10-09,계산,14281,7110,7171
1,2023-10-09,경인교대입구,7018,3516,3502
1,2023-10-09,작전,15037,7688,7349
1,2023-10-09,갈산,7894,4019,3875
1,2023-10-09,부평구청,7543,3662,3881
1,2023-10-09,부평시장,15306,7565,7741
1,2023-10-09,부평,9159,4748,4411
1,2023-10-09,동수,4317,2225,2092
1,2023-10-09,부평삼거리,3518,1754,1764
1,2023-10-09,간석오거리,13363,6945,6418
1,2023-10-09,인천시청,5520,2840,2680
1,2023-10-09,예술회관,11747,5710,6037
1,2023-10-09,인천터미널,22876,11507,11369
1,2023-10-09,문학경기장,2152,1089,1063
1,2023-10-09,선학,8002,3937,4065
1,2023-10-09,신연수,5604,2845,2759
1,2023-10-09,원인재,2867,1503,1364
1,2023-10-09,동춘,12582,6229,6353
1,2023-10-09,동막,5118,2681,2437
1,2023-10-09,캠퍼스타운,6873,3314,3559
1,2023-10-09,테크노파크,16174,7886,8288
1,2023-10-09,지식정보단지,3673,1790,1883
1,2023-10-09,인천대입구,9217,4492,4725
1,2023-10-09,센트럴파크(재외동포청),6335,3131,3204
1,2023-10-09,국제업무지구,1538,780,758
1,2023-10-09,송도달빛축제공원,6375,3236,3139
1,2023-10-10,계양,8183,4160,4023
1,2023-10-10,귤현,2579,1017,1562
1,2023-10-10,박촌,8113,4244,3869
1,2023-10-10,임학,17053,8624,8429
1,2023-10-10,계산,21877,11092,10785
1,2023-10-10,경인교대입구,11153,5687,5466
1,2023-10-10,작전,29079,14812,14267
1,2023-10-10,갈산,20080,10194,9886
1,2023-10-10,부평구청,14486,7140,7346
1,2023-10-10,부평시장,27852,13898,13954
1,2023-10-10,부평,12463,6301,6162
1,2023-10-10,동수,8790,4474,4316
1,2023-10-10,부평삼거리,5553,2803,2750
1,2023-10-10,간석오거리,21996,11527,10469
1,2023-10-10,인천시청,11410,5756,5654
1,2023-10-10,예술회관,23675,11642,12033
1,2023-10-10,인천터미널,26824,13125,13699
1,2023-10-10,문학경기장,3724,1846,1878
1,2023-10-10,선학,12385,6204,6181
1,2023-10-10,신연수,11976,6045,5931
1,2023-10-10,원인재,5993,3206,2787
1,2023-10-10,동춘,20294,9864,10430
1,2023-10-10,동막,11032,5796,5236
1,2023-10-10,캠퍼스타운,12551,6216,6335
1,2023-10-10,테크노파크,21408,10622,10786
1,2023-10-10,지식정보단지,10875,5314,5561
1,2023-10-10,인천대입구,18232,9057,9175
1,2023-10-10,센트럴파크(재외동포청),7678,3882,3796
1,2023-10-10,국제업무지구,3737,1912,1825
1,2023-10-10,송도달빛축제공원,10267,5142,5125
1,2023-10-11,계양,8141,4101,4040
1,2023-10-11,귤현,2746,1094,1652
1,2023-10-11,박촌,8357,4346,4011
1,2023-10-11,임학,16978,8564,8414
1,2023-10-11,계산,23011,11701,11310
1,2023-10-11,경인교대입구,11119,5588,5531
1,2023-10-11,작전,29379,14950,14429
1,2023-10-11,갈산,20085,10203,9882
1,2023-10-11,부평구청,14502,7169,7333
1,2023-10-11,부평시장,28201,14138,14063
1,2023-10-11,부평,12815,6411,6404
1,2023-10-11,동수,9051,4618,4433
1,2023-10-11,부평삼거리,5619,2864,2755
1,2023-10-11,간석오거리,22353,11679,10674
1,2023-10-11,인천시청,11713,5902,5811
1,2023-10-11,예술회관,24374,12044,12330
1,2023-10-11,인천터미널,26706,13142,13564
1,2023-10-11,문학경기장,3827,1873,1954
1,2023-10-11,선학,12853,6424,6429
1,2023-10-11,신연수,12256,6203,6053
1,2023-10-11,원인재,6217,3341,2876
1,2023-10-11,동춘,21358,10515,10843
1,2023-10-11,동막,11367,6047,5320
1,2023-10-11,캠퍼스타운,12843,6442,6401
1,2023-10-11,테크노파크,21752,10839,10913
1,2023-10-11,지식정보단지,11012,5375,5637
1,2023-10-11,인천대입구,18342,9233,9109
1,2023-10-11,센트럴파크(재외동포청),8162,4027,4135
1,2023-10-11,국제업무지구,3802,1922,1880
1,2023-10-11,송도달빛축제공원,10555,5283,5272
1,2023-10-12,계양,8324,4206,4118
1,2023-10-12,귤현,2719,1056,1663
1,2023-10-12,박촌,8250,4332,3918
1,2023-10-12,임학,17209,8621,8588
1,2023-10-12,계산,22909,11575,11334
1,2023-10-12,경인교대입구,11286,5717,5569
1,2023-10-12,작전,29527,14889,14638
1,2023-10-12,갈산,20153,10206,9947
1,2023-10-12,부평구청,14592,7175,7417
1,2023-10-12,부평시장,27516,13824,13692
1,2023-10-12,부평,12969,6479,6490
1,2023-10-12,동수,8955,4515,4440
1,2023-10-12,부평삼거리,5642,2813,2829
1,2023-10-12,간석오거리,22637,11833,10804
1,2023-10-12,인천시청,11741,5947,5794
1,2023-10-12,예술회관,23823,11656,12167
1,2023-10-12,인천터미널,27402,13620,13782
1,2023-10-12,문학경기장,3757,1891,1866
1,2023-10-12,선학,12562,6271,6291
1,2023-10-12,신연수,12328,6267,6061
1,2023-10-12,원인재,6476,3431,3045
1,2023-10-12,동춘,21066,10335,10731
1,2023-10-12,동막,11661,6121,5540
1,2023-10-12,캠퍼스타운,13102,6757,6345
1,2023-10-12,테크노파크,21758,10852,10906
1,2023-10-12,지식정보단지,10835,5300,5535
1,2023-10-12,인천대입구,20717,10201,10516
1,2023-10-12,센트럴파크(재외동포청),9020,4616,4404
1,2023-10-12,국제업무지구,3877,1992,1885
1,2023-10-12,송도달빛축제공원,10570,5274,5296
1,2023-10-13,계양,8935,4446,4489
1,2023-10-13,귤현,2724,1072,1652
1,2023-10-13,박촌,8400,4444,3956
1,2023-10-13,임학,17665,8890,8775
1,2023-10-13,계산,23529,12048,11481
1,2023-10-13,경인교대입구,11681,5811,5870
1,2023-10-13,작전,30063,15333,14730
1,2023-10-13,갈산,20233,10299,9934
1,2023-10-13,부평구청,14729,7172,7557
1,2023-10-13,부평시장,28843,14406,14437
1,2023-10-13,부평,14113,6944,7169
1,2023-10-13,동수,8698,4473,4225
1,2023-10-13,부평삼거리,5713,2884,2829
1,2023-10-13,간석오거리,23200,12219,10981
1,2023-10-13,인천시청,11744,5913,5831
1,2023-10-13,예술회관,25672,12150,13522
1,2023-10-13,인천터미널,31174,15334,15840
1,2023-10-13,문학경기장,15593,7309,8284
1,2023-10-13,선학,13778,6956,6822
1,2023-10-13,신연수,12202,6262,5940
1,2023-10-13,원인재,6551,3478,3073
1,2023-10-13,동춘,22200,10857,11343
1,2023-10-13,동막,11787,6251,5536
1,2023-10-13,캠퍼스타운,13593,7106,6487
1,2023-10-13,테크노파크,23393,11634,11759
1,2023-10-13,지식정보단지,11115,5543,5572
1,2023-10-13,인천대입구,20266,10476,9790
1,2023-10-13,센트럴파크(재외동포청),9585,4665,4920
1,2023-10-13,국제업무지구,3846,1967,1879
1,2023-10-13,송도달빛축제공원,11203,5680,5523
1,2023-10-14,계양,5933,2864,3069
1,2023-10-14,귤현,1632,785,847
1,2023-10-14,박촌,5526,2912,2614
1,2023-10-14,임학,11905,6075,5830
1,2023-10-14,계산,18248,9146,9102
1,2023-10-14,경인교대입구,9001,4512,4489
1,2023-10-14,작전,22468,11564,10904
1,2023-10-14,갈산,10437,5452,4985
1,2023-10-14,부평구청,10246,5038,5208
1,2023-10-14,부평시장,19248,9619,9629
1,2023-10-14,부평,12603,6310,6293
1,2023-10-14,동수,5515,2847,2668
1,2023-10-14,부평삼거리,3777,1872,1905
1,2023-10-14,간석오거리,16603,8708,7895
1,2023-10-14,인천시청,7402,3808,3594
1,2023-10-14,예술회관,16800,7940,8860
1,2023-10-14,인천터미널,27010,13066,13944
1,2023-10-14,문학경기장,3918,1950,1968
1,2023-10-14,선학,10071,5126,4945
1,2023-10-14,신연수,6565,3442,3123
1,2023-10-14,원인재,4356,2312,2044
1,2023-10-14,동춘,15332,7552,7780
1,2023-10-14,동막,7124,3740,3384
1,2023-10-14,캠퍼스타운,8433,4462,3971
1,2023-10-14,테크노파크,18910,9377,9533
1,2023-10-14,지식정보단지,4496,2310,2186
1,2023-10-14,인천대입구,11533,5782,5751
1,2023-10-14,센트럴파크(재외동포청),8514,4125,4389
1,2023-10-14,국제업무지구,1768,940,828
1,2023-10-14,송도달빛축제공원,8018,4063,3955
1,2023-10-15,계양,5254,2442,2812
1,2023-10-15,귤현,1238,585,653
1,2023-10-15,박촌,4347,2232,2115
1,2023-10-15,임학,9616,4874,4742
1,2023-10-15,계산,15634,7746,7888
1,2023-10-15,경인교대입구,7487,3727,3760
1,2023-10-15,작전,15452,7943,7509
1,2023-10-15,갈산,6812,3516,3296
1,2023-10-15,부평구청,7794,3821,3973
1,2023-10-15,부평시장,15254,7589,7665
1,2023-10-15,부평,9569,4983,4586
1,2023-10-15,동수,4315,2209,2106
1,2023-10-15,부평삼거리,3645,1800,1845
1,2023-10-15,간석오거리,12924,6792,6132
1,2023-10-15,인천시청,5988,3068,2920
1,2023-10-15,예술회관,11874,5855,6019
1,2023-10-15,인천터미널,22821,11504,11317
1,2023-10-15,문학경기장,2498,1249,1249
1,2023-10-15,선학,8598,4251,4347
1,2023-10-15,신연수,5017,2513,2504
1,2023-10-15,원인재,3136,1668,1468
1,2023-10-15,동춘,11876,5873,6003
1,2023-10-15,동막,4795,2526,2269
1,2023-10-15,캠퍼스타운,6680,3294,3386
1,2023-10-15,테크노파크,15458,7577,7881
1,2023-10-15,지식정보단지,3130,1534,1596
1,2023-10-15,인천대입구,8892,4231,4661
1,2023-10-15,센트럴파크(재외동포청),7593,3708,3885
1,2023-10-15,국제업무지구,698,370,328
1,2023-10-15,송도달빛축제공원,6813,3367,3446
1,2023-10-16,계양,7948,3996,3952
1,2023-10-16,귤현,2511,1013,1498
1,2023-10-16,박촌,8014,4271,3743
1,2023-10-16,임학,16732,8453,8279
1,2023-10-16,계산,22225,11356,10869
1,2023-10-16,경인교대입구,11490,5744,5746
1,2023-10-16,작전,28724,14660,14064
1,2023-10-16,갈산,19584,9866,9718
1,2023-10-16,부평구청,13801,6815,6986
1,2023-10-16,부평시장,26888,13587,13301
1,2023-10-16,부평,12313,6172,6141
1,2023-10-16,동수,8546,4386,4160
1,2023-10-16,부평삼거리,5427,2733,2694
1,2023-10-16,간석오거리,21775,11440,10335
1,2023-10-16,인천시청,11296,5786,5510
1,2023-10-16,예술회관,23195,11372,11823
1,2023-10-16,인천터미널,24348,11876,12472
1,2023-10-16,문학경기장,3476,1747,1729
1,2023-10-16,선학,11940,5951,5989
1,2023-10-16,신연수,11956,6009,5947
1,2023-10-16,원인재,6127,3272,2855
1,2023-10-16,동춘,20452,9973,10479
1,2023-10-16,동막,10912,5809,5103
1,2023-10-16,캠퍼스타운,12640,6312,6328
1,2023-10-16,테크노파크,21235,10538,10697
1,2023-10-16,지식정보단지,10681,5216,5465
1,2023-10-16,인천대입구,17577,8677,8900
1,2023-10-16,센트럴파크(재외동포청),7754,3902,3852
1,2023-10-16,국제업무지구,3740,1881,1859
1,2023-10-16,송도달빛축제공원,10326,5232,5094
1,2023-10-17,계양,8516,4306,4210
1,2023-10-17,귤현,2696,1028,1668
1,2023-10-17,박촌,8143,4262,3881
1,2023-10-17,임학,16851,8487,8364
1,2023-10-17,계산,22127,11238,10889
1,2023-10-17,경인교대입구,11871,5983,5888
1,2023-10-17,작전,29420,14912,14508
1,2023-10-17,갈산,20103,10292,9811
1,2023-10-17,부평구청,14212,6938,7274
1,2023-10-17,부평시장,28082,14131,13951
1,2023-10-17,부평,12452,6233,6219
1,2023-10-17,동수,8743,4412,4331
1,2023-10-17,부평삼거리,5754,2943,2811
1,2023-10-17,간석오거리,22894,11953,10941
1,2023-10-17,인천시청,12079,6177,5902
1,2023-10-17,예술회관,23637,11613,12024
1,2023-10-17,인천터미널,26813,13035,13778
1,2023-10-17,문학경기장,18582,8467,10115
1,2023-10-17,선학,12728,6390,6338
1,2023-10-17,신연수,12451,6320,6131
1,2023-10-17,원인재,6197,3305,2892
1,2023-10-17,동춘,21263,10385,10878
1,2023-10-17,동막,11208,6016,5192
1,2023-10-17,캠퍼스타운,12727,6422,6305
1,2023-10-17,테크노파크,21810,10945,10865
1,2023-10-17,지식정보단지,11109,5440,5669
1,2023-10-17,인천대입구,18375,9209,9166
1,2023-10-17,센트럴파크(재외동포청),8446,4196,4250
1,2023-10-17,국제업무지구,3772,1906,1866
1,2023-10-17,송도달빛축제공원,10711,5255,5456
1,2023-10-18,계양,8152,4070,4082
1,2023-10-18,귤현,2604,1018,1586
1,2023-10-18,박촌,8497,4376,4121
1,2023-10-18,임학,16912,8506,8406
1,2023-10-18,계산,22513,11380,11133
1,2023-10-18,경인교대입구,11560,5796,5764
1,2023-10-18,작전,29366,14924,14442
1,2023-10-18,갈산,20344,10375,9969
1,2023-10-18,부평구청,14797,7327,7470
1,2023-10-18,부평시장,27874,13933,13941
1,2023-10-18,부평,13035,6566,6469
1,2023-10-18,동수,9004,4570,4434
1,2023-10-18,부평삼거리,5620,2837,2783
1,2023-10-18,간석오거리,22824,11945,10879
1,2023-10-18,인천시청,11681,5862,5819
1,2023-10-18,예술회관,24074,11778,12296
1,2023-10-18,인천터미널,26971,13391,13580
1,2023-10-18,문학경기장,3618,1796,1822
1,2023-10-18,선학,12755,6357,6398
1,2023-10-18,신연수,12462,6353,6109
1,2023-10-18,원인재,6272,3279,2993
1,2023-10-18,동춘,21544,10536,11008
1,2023-10-18,동막,11613,6160,5453
1,2023-10-18,캠퍼스타운,12930,6503,6427
1,2023-10-18,테크노파크,21952,10979,10973
1,2023-10-18,지식정보단지,11175,5364,5811
1,2023-10-18,인천대입구,18924,9572,9352
1,2023-10-18,센트럴파크(재외동포청),8361,4133,4228
1,2023-10-18,국제업무지구,3786,1932,1854
1,2023-10-18,송도달빛축제공원,10935,5459,5476
1,2023-10-19,계양,7859,3979,3880
1,2023-10-19,귤현,2590,984,1606
1,2023-10-19,박촌,7921,4139,3782
1,2023-10-19,임학,16490,8332,8158
1,2023-10-19,계산,21547,10953,10594
1,2023-10-19,경인교대입구,11527,5765,5762
1,2023-10-19,작전,28519,14480,14039
1,2023-10-19,갈산,19712,9914,9798
1,2023-10-19,부평구청,14207,6957,7250
1,2023-10-19,부평시장,26787,13466,13321
1,2023-10-19,부평,12743,6421,6322
1,2023-10-19,동수,8272,4237,4035
1,2023-10-19,부평삼거리,5376,2724,2652
1,2023-10-19,간석오거리,21887,11389,10498
1,2023-10-19,인천시청,10986,5512,5474
1,2023-10-19,예술회관,23080,11274,11806
1,2023-10-19,인천터미널,26146,13166,12980
1,2023-10-19,문학경기장,3532,1848,1684
1,2023-10-19,선학,12323,6184,6139
1,2023-10-19,신연수,11656,5924,5732
1,2023-10-19,원인재,5748,3071,2677
1,2023-10-19,동춘,20266,9765,10501
1,2023-10-19,동막,10965,5730,5235
1,2023-10-19,캠퍼스타운,12048,6179,5869
1,2023-10-19,테크노파크,21029,10465,10564
1,2023-10-19,지식정보단지,10721,5213,5508
1,2023-10-19,인천대입구,18481,9270,9211
1,2023-10-19,센트럴파크(재외동포청),7961,3958,4003
1,2023-10-19,국제업무지구,3853,1957,1896
1,2023-10-19,송도달빛축제공원,10012,4971,5041
1,2023-10-20,계양,8369,4172,4197
1,2023-10-20,귤현,2593,1050,1543
1,2023-10-20,박촌,8477,4437,4040
1,2023-10-20,임학,17691,8849,8842
1,2023-10-20,계산,23492,11960,11532
1,2023-10-20,경인교대입구,12070,6140,5930
1,2023-10-20,작전,30254,15425,14829
1,2023-10-20,갈산,20053,10211,9842
1,2023-10-20,부평구청,14833,7288,7545
1,2023-10-20,부평시장,29010,14486,14524
1,2023-10-20,부평,14657,7303,7354
1,2023-10-20,동수,8611,4438,4173
1,2023-10-20,부평삼거리,5559,2809,2750
1,2023-10-20,간석오거리,22903,11965,10938
1,2023-10-20,인천시청,12111,6202,5909
1,2023-10-20,예술회관,25201,12131,13070
1,2023-10-20,인천터미널,31603,15426,16177
1,2023-10-20,문학경기장,3652,1859,1793
1,2023-10-20,선학,13372,6749,6623
1,2023-10-20,신연수,12255,6295,5960
1,2023-10-20,원인재,6281,3338,2943
1,2023-10-20,동춘,22482,10831,11651
1,2023-10-20,동막,11643,6197,5446
1,2023-10-20,캠퍼스타운,13271,6726,6545
1,2023-10-20,테크노파크,23787,12063,11724
1,2023-10-20,지식정보단지,11161,5481,5680
1,2023-10-20,인천대입구,18063,9148,8915
1,2023-10-20,센트럴파크(재외동포청),9101,4453,4648
1,2023-10-20,국제업무지구,3877,1984,1893
1,2023-10-20,송도달빛축제공원,11288,5622,5666
1,2023-10-21,계양,6781,3189,3592
1,2023-10-21,귤현,1671,776,895
1,2023-10-21,박촌,5836,3136,2700
1,2023-10-21,임학,12403,6409,5994
1,2023-10-21,계산,19470,9639,9831
1,2023-10-21,경인교대입구,9485,4778,4707
1,2023-10-21,작전,22927,11831,11096
1,2023-10-21,갈산,10222,5302,4920
1,2023-10-21,부평구청,10839,5279,5560
1,2023-10-21,부평시장,19625,9842,9783
1,2023-10-21,부평,13870,6823,7047
1,2023-10-21,동수,5804,2991,2813
1,2023-10-21,부평삼거리,4240,2144,2096
1,2023-10-21,간석오거리,17185,8998,8187
1,2023-10-21,인천시청,8316,4273,4043
1,2023-10-21,예술회관,17363,8157,9206
1,2023-10-21,인천터미널,28372,13836,14536
1,2023-10-21,문학경기장,3311,1581,1730
1,2023-10-21,선학,10735,5412,5323
1,2023-10-21,신연수,6834,3588,3246
1,2023-10-21,원인재,4159,2182,1977
1,2023-10-21,동춘,17178,8456,8722
1,2023-10-21,동막,7215,3756,3459
1,2023-10-21,캠퍼스타운,9076,4748,4328
1,2023-10-21,테크노파크,20276,10078,10198
1,2023-10-21,지식정보단지,4738,2392,2346
1,2023-10-21,인천대입구,12518,6307,6211
1,2023-10-21,센트럴파크(재외동포청),10252,5080,5172
1,2023-10-21,국제업무지구,1934,1008,926
1,2023-10-21,송도달빛축제공원,8612,4384,4228
1,2023-10-22,계양,5247,2414,2833
1,2023-10-22,귤현,1209,573,636
1,2023-10-22,박촌,4330,2276,2054
1,2023-10-22,임학,9469,4748,4721
1,2023-10-22,계산,14839,7334,7505
1,2023-10-22,경인교대입구,7583,3721,3862
1,2023-10-22,작전,15473,7967,7506
1,2023-10-22,갈산,7295,3805,3490
1,2023-10-22,부평구청,7885,3840,4045
1,2023-10-22,부평시장,15118,7561,7557
1,2023-10-22,부평,9786,5093,4693
1,2023-10-22,동수,4414,2220,2194
1,2023-10-22,부평삼거리,3455,1707,1748
1,2023-10-22,간석오거리,13079,6823,6256
1,2023-10-22,인천시청,6111,3107,3004
1,2023-10-22,예술회관,12048,5966,6082
1,2023-10-22,인천터미널,25026,12793,12233
1,2023-10-22,문학경기장,18276,8679,9597
1,2023-10-22,선학,8465,4286,4179
1,2023-10-22,신연수,5070,2594,2476
1,2023-10-22,원인재,3177,1690,1487
1,2023-10-22,동춘,11086,5600,5486
1,2023-10-22,동막,4956,2558,2398
1,2023-10-22,캠퍼스타운,6727,3327,3400
1,2023-10-22,테크노파크,15744,7721,8023
1,2023-10-22,지식정보단지,3116,1531,1585
1,2023-10-22,인천대입구,8004,3872,4132
1,2023-10-22,센트럴파크(재외동포청),6874,3379,3495
1,2023-10-22,국제업무지구,780,401,379
1,2023-10-22,송도달빛축제공원,6569,3249,3320
1,2023-10-23,계양,8154,4076,4078
1,2023-10-23,귤현,2579,1000,1579
1,2023-10-23,박촌,7988,4247,3741
1,2023-10-23,임학,16717,8459,8258
1,2023-10-23,계산,22548,11569,10979
1,2023-10-23,경인교대입구,11390,5690,5700
1,2023-10-23,작전,28942,14746,14196
1,2023-10-23,갈산,20011,10207,9804
1,2023-10-23,부평구청,13863,6807,7056
1,2023-10-23,부평시장,27589,13812,13777
1,2023-10-23,부평,12785,6397,6388
1,2023-10-23,동수,8689,4436,4253
1,2023-10-23,부평삼거리,5529,2783,2746
1,2023-10-23,간석오거리,22263,11600,10663
1,2023-10-23,인천시청,11829,6009,5820
1,2023-10-23,예술회관,23797,11728,12069
1,2023-10-23,인천터미널,27057,13171,13886
1,2023-10-23,문학경기장,19825,9031,10794
1,2023-10-23,선학,12597,6401,6196
1,2023-10-23,신연수,12281,6242,6039
1,2023-10-23,원인재,6235,3325,2910
1,2023-10-23,동춘,21158,10333,10825
1,2023-10-23,동막,11054,5874,5180
1,2023-10-23,캠퍼스타운,12677,6315,6362
1,2023-10-23,테크노파크,21302,10665,10637
1,2023-10-23,지식정보단지,10828,5284,5544
1,2023-10-23,인천대입구,17410,8633,8777
1,2023-10-23,센트럴파크(재외동포청),7810,3954,3856
1,2023-10-23,국제업무지구,3716,1908,1808
1,2023-10-23,송도달빛축제공원,10311,5165,5146
1,2023-10-24,계양,7941,4006,3935
1,2023-10-24,귤현,2663,1026,1637
1,2023-10-24,박촌,8049,4250,3799
1,2023-10-24,임학,16653,8435,8218
1,2023-10-24,계산,21360,10801,10559
1,2023-10-24,경인교대입구,11366,5702,5664
1,2023-10-24,작전,28953,14630,14323
1,2023-10-24,갈산,19941,10127,9814
1,2023-10-24,부평구청,13968,6831,7137
1,2023-10-24,부평시장,27443,13794,13649
1,2023-10-24,부평,11815,5875,5940
1,2023-10-24,동수,8777,4432,4345
1,2023-10-24,부평삼거리,5467,2785,2682
1,2023-10-24,간석오거리,22106,11558,10548
1,2023-10-24,인천시청,11094,5594,5500
1,2023-10-24,예술회관,23624,11551,12073
1,2023-10-24,인천터미널,26148,12829,13319
1,2023-10-24,문학경기장,3663,1834,1829
1,2023-10-24,선학,12664,6361,6303
1,2023-10-24,신연수,12147,6189,5958
1,2023-10-24,원인재,6203,3294,2909
1,2023-10-24,동춘,20634,10098,10536
1,2023-10-24,동막,11105,5870,5235
1,2023-10-24,캠퍼스타운,11902,5966,5936
1,2023-10-24,테크노파크,21097,10515,10582
1,2023-10-24,지식정보단지,10838,5332,5506
1,2023-10-24,인천대입구,18443,9364,9079
1,2023-10-24,센트럴파크(재외동포청),8195,4107,4088
1,2023-10-24,국제업무지구,3901,1976,1925
1,2023-10-24,송도달빛축제공원,10309,5160,5149
1,2023-10-25,계양,8034,4053,3981
1,2023-10-25,귤현,2644,1011,1633
1,2023-10-25,박촌,8476,4411,4065
1,2023-10-25,임학,17131,8672,8459
1,2023-10-25,계산,22873,11590,11283
1,2023-10-25,경인교대입구,11852,5968,5884
1,2023-10-25,작전,29565,14952,14613
1,2023-10-25,갈산,20542,10436,10106
1,2023-10-25,부평구청,14473,7141,7332
1,2023-10-25,부평시장,28455,14278,14177
1,2023-10-25,부평,13050,6545,6505
1,2023-10-25,동수,8854,4546,4308
1,2023-10-25,부평삼거리,5545,2797,2748
1,2023-10-25,간석오거리,22236,11613,10623
1,2023-10-25,인천시청,11866,5951,5915
1,2023-10-25,예술회관,24491,11978,12513
1,2023-10-25,인천터미널,27210,13189,14021
1,2023-10-25,문학경기장,3740,1873,1867
1,2023-10-25,선학,13068,6543,6525
1,2023-10-25,신연수,12299,6280,6019
1,2023-10-25,원인재,6348,3306,3042
1,2023-10-25,동춘,21189,10249,10940
1,2023-10-25,동막,11360,6063,5297
1,2023-10-25,캠퍼스타운,12672,6453,6219
1,2023-10-25,테크노파크,22002,10985,11017
1,2023-10-25,지식정보단지,10897,5352,5545
1,2023-10-25,인천대입구,17705,8979,8726
1,2023-10-25,센트럴파크(재외동포청),8687,4315,4372
1,2023-10-25,국제업무지구,3825,1909,1916
1,2023-10-25,송도달빛축제공원,10744,5326,5418
1,2023-10-26,계양,8139,4083,4056
1,2023-10-26,귤현,2552,997,1555
1,2023-10-26,박촌,8090,4257,3833
1,2023-10-26,임학,16651,8402,8249
1,2023-10-26,계산,22922,11672,11250
1,2023-10-26,경인교대입구,11698,5919,5779
1,2023-10-26,작전,28766,14596,14170
1,2023-10-26,갈산,20149,10222,9927
1,2023-10-26,부평구청,14332,7009,7323
1,2023-10-26,부평시장,27802,13880,13922
1,2023-10-26,부평,12590,6318,6272
1,2023-10-26,동수,8455,4303,4152
1,2023-10-26,부평삼거리,5455,2741,2714
1,2023-10-26,간석오거리,22330,11691,10639
1,2023-10-26,인천시청,11515,5798,5717
1,2023-10-26,예술회관,23779,11533,12246
1,2023-10-26,인천터미널,27298,13653,13645
1,2023-10-26,문학경기장,3745,1893,1852
1,2023-10-26,선학,12783,6392,6391
1,2023-10-26,신연수,12167,6184,5983
1,2023-10-26,원인재,6282,3388,2894
1,2023-10-26,동춘,21701,10533,11168
1,2023-10-26,동막,11189,5897,5292
1,2023-10-26,캠퍼스타운,12694,6436,6258
1,2023-10-26,테크노파크,21825,10949,10876
1,2023-10-26,지식정보단지,10795,5259,5536
1,2023-10-26,인천대입구,18073,9114,8959
1,2023-10-26,센트럴파크(재외동포청),8712,4319,4393
1,2023-10-26,국제업무지구,3947,2014,1933
1,2023-10-26,송도달빛축제공원,10699,5292,5407
1,2023-10-27,계양,8264,4159,4105
1,2023-10-27,귤현,2726,1091,1635
1,2023-10-27,박촌,8462,4437,4025
1,2023-10-27,임학,17157,8563,8594
1,2023-10-27,계산,23129,11841,11288
1,2023-10-27,경인교대입구,12114,6114,6000
1,2023-10-27,작전,29857,15137,14720
1,2023-10-27,갈산,20231,10316,9915
1,2023-10-27,부평구청,14592,7183,7409
1,2023-10-27,부평시장,28967,14430,14537
1,2023-10-27,부평,14295,7082,7213
1,2023-10-27,동수,8709,4478,4231
1,2023-10-27,부평삼거리,5617,2868,2749
1,2023-10-27,간석오거리,22589,11902,10687
1,2023-10-27,인천시청,11938,6063,5875
1,2023-10-27,예술회관,25297,12121,13176
1,2023-10-27,인천터미널,32079,15607,16472
1,2023-10-27,문학경기장,4055,2037,2018
1,2023-10-27,선학,13178,6686,6492
1,2023-10-27,신연수,12238,6347,5891
1,2023-10-27,원인재,6530,3443,3087
1,2023-10-27,동춘,22024,10722,11302
1,2023-10-27,동막,11728,6308,5420
1,2023-10-27,캠퍼스타운,14445,7559,6886
1,2023-10-27,테크노파크,24065,12144,11921
1,2023-10-27,지식정보단지,10863,5405,5458
1,2023-10-27,인천대입구,17738,9037,8701
1,2023-10-27,센트럴파크(재외동포청),9558,4667,4891
1,2023-10-27,국제업무지구,3847,1946,1901
1,2023-10-27,송도달빛축제공원,11123,5629,5494
1,2023-10-28,계양,6718,3269,3449
1,2023-10-28,귤현,1694,727,967
1,2023-10-28,박촌,5891,3144,2747
1,2023-10-28,임학,12780,6538,6242
1,2023-10-28,계산,20940,10405,10535
1,2023-10-28,경인교대입구,9687,4895,4792
1,2023-10-28,작전,23232,11985,11247
1,2023-10-28,갈산,10871,5640,5231
1,2023-10-28,부평구청,10790,5367,5423
1,2023-10-28,부평시장,20147,10189,9958
1,2023-10-28,부평,13618,6663,6955
1,2023-10-28,동수,5760,2982,2778
1,2023-10-28,부평삼거리,4372,2197,2175
1,2023-10-28,간석오거리,16930,8981,7949
1,2023-10-28,인천시청,8517,4327,4190
1,2023-10-28,예술회관,18435,8721,9714
1,2023-10-28,인천터미널,29099,14257,14842
1,2023-10-28,문학경기장,3314,1624,1690
1,2023-10-28,선학,11341,5646,5695
1,2023-10-28,신연수,6779,3637,3142
1,2023-10-28,원인재,4247,2251,1996
1,2023-10-28,동춘,16725,8243,8482
1,2023-10-28,동막,7223,3828,3395
1,2023-10-28,캠퍼스타운,9655,5073,4582
1,2023-10-28,테크노파크,20344,10094,10250
1,2023-10-28,지식정보단지,4957,2575,2382
1,2023-10-28,인천대입구,14256,7199,7057
1,2023-10-28,센트럴파크(재외동포청),9657,4762,4895
1,2023-10-28,국제업무지구,1909,1000,909
1,2023-10-28,송도달빛축제공원,8888,4485,4403
1,2023-10-29,계양,5139,2382,2757
1,2023-10-29,귤현,1152,520,632
1,2023-10-29,박촌,4412,2289,2123
1,2023-10-29,임학,9258,4654,4604
1,2023-10-29,계산,15202,7497,7705
1,2023-10-29,경인교대입구,7627,3775,3852
1,2023-10-29,작전,15608,7951,7657
1,2023-10-29,갈산,7047,3646,3401
1,2023-10-29,부평구청,7748,3827,3921
1,2023-10-29,부평시장,15487,7664,7823
1,2023-10-29,부평,9422,4930,4492
1,2023-10-29,동수,4451,2261,2190
1,2023-10-29,부평삼거리,3474,1746,1728
1,2023-10-29,간석오거리,12634,6536,6098
1,2023-10-29,인천시청,5977,3062,2915
1,2023-10-29,예술회관,12175,5904,6271
1,2023-10-29,인천터미널,23710,11976,11734
1,2023-10-29,문학경기장,2027,1011,1016
1,2023-10-29,선학,8473,4130,4343
1,2023-10-29,신연수,4920,2458,2462
1,2023-10-29,원인재,2858,1517,1341
1,2023-10-29,동춘,11703,5834,5869
1,2023-10-29,동막,4877,2513,2364
1,2023-10-29,캠퍼스타운,7068,3359,3709
1,2023-10-29,테크노파크,16177,7996,8181
1,2023-10-29,지식정보단지,3171,1568,1603
1,2023-10-29,인천대입구,10103,4888,5215
1,2023-10-29,센트럴파크(재외동포청),7028,3417,3611
1,2023-10-29,국제업무지구,784,382,402
1,2023-10-29,송도달빛축제공원,6931,3468,3463
1,2023-10-30,계양,8025,4057,3968
1,2023-10-30,귤현,2594,1039,1555
1,2023-10-30,박촌,7929,4186,3743
1,2023-10-30,임학,16554,8399,8155
1,2023-10-30,계산,22040,11254,10786
1,2023-10-30,경인교대입구,11482,5746,5736
1,2023-10-30,작전,29010,14716,14294
1,2023-10-30,갈산,19728,9955,9773
1,2023-10-30,부평구청,13712,6699,7013
1,2023-10-30,부평시장,27392,13804,13588
1,2023-10-30,부평,12443,6226,6217
1,2023-10-30,동수,8749,4449,4300
1,2023-10-30,부평삼거리,5573,2809,2764
1,2023-10-30,간석오거리,21792,11409,10383
1,2023-10-30,인천시청,11023,5583,5440
1,2023-10-30,예술회관,23277,11492,11785
1,2023-10-30,인천터미널,26739,13003,13736
1,2023-10-30,문학경기장,3587,1784,1803
1,2023-10-30,선학,12271,6139,6132
1,2023-10-30,신연수,12158,6147,6011
1,2023-10-30,원인재,6118,3260,2858
1,2023-10-30,동춘,20292,9882,10410
1,2023-10-30,동막,10693,5716,4977
1,2023-10-30,캠퍼스타운,12604,6226,6378
1,2023-10-30,테크노파크,20973,10450,10523
1,2023-10-30,지식정보단지,10947,5279,5668
1,2023-10-30,인천대입구,17928,8911,9017
1,2023-10-30,센트럴파크(재외동포청),7756,3931,3825
1,2023-10-30,국제업무지구,3827,1939,1888
1,2023-10-30,송도달빛축제공원,10312,5196,5116
1,2023-10-31,계양,8101,4030,4071
1,2023-10-31,귤현,2653,1029,1624
1,2023-10-31,박촌,8318,4426,3892
1,2023-10-31,임학,16803,8486,8317
1,2023-10-31,계산,21816,11082,10734
1,2023-10-31,경인교대입구,11704,5945,5759
1,2023-10-31,작전,28833,14716,14117
1,2023-10-31,갈산,20166,10234,9932
1,2023-10-31,부평구청,14405,7073,7332
1,2023-10-31,부평시장,27787,14017,13770
1,2023-10-31,부평,12638,6358,6280
1,2023-10-31,동수,8658,4426,4232
1,2023-10-31,부평삼거리,5576,2778,2798
1,2023-10-31,간석오거리,22110,11527,10583
1,2023-10-31,인천시청,11446,5773,5673
1,2023-10-31,예술회관,23522,11494,12028
1,2023-10-31,인천터미널,26283,12842,13441
1,2023-10-31,문학경기장,3668,1816,1852
1,2023-10-31,선학,12562,6329,6233
1,2023-10-31,신연수,12068,6082,5986
1,2023-10-31,원인재,6173,3288,2885
1,2023-10-31,동춘,20554,10035,10519
1,2023-10-31,동막,11152,5946,5206
1,2023-10-31,캠퍼스타운,12565,6307,6258
1,2023-10-31,테크노파크,21237,10609,10628
1,2023-10-31,지식정보단지,11107,5462,5645
1,2023-10-31,인천대입구,18820,9348,9472
1,2023-10-31,센트럴파크(재외동포청),7977,4084,3893
1,2023-10-31,국제업무지구,3916,2006,1910
1,2023-10-31,송도달빛축제공원,10404,5181,5223
1,2023-11-01,계양,7770,3941,3829
1,2023-11-01,귤현,2651,1041,1610
1,2023-11-01,박촌,7964,4129,3835
1,2023-11-01,임학,16272,8196,8076
1,2023-11-01,계산,21571,10914,10657
1,2023-11-01,경인교대입구,11423,5789,5634
1,2023-11-01,작전,28204,14302,13902
1,2023-11-01,갈산,19919,10098,9821
1,2023-11-01,부평구청,13939,6780,7159
1,2023-11-01,부평시장,27092,13572,13520
1,2023-11-01,부평,12426,6150,6276
1,2023-11-01,동수,8643,4383,4260
1,2023-11-01,부평삼거리,5426,2738,2688
1,2023-11-01,간석오거리,21694,11327,10367
1,2023-11-01,인천시청,11094,5579,5515
1,2023-11-01,예술회관,23464,11424,12040
1,2023-11-01,인천터미널,25320,12583,12737
1,2023-11-01,문학경기장,4037,1982,2055
1,2023-11-01,선학,12560,6329,6231
1,2023-11-01,신연수,12141,6177,5964
1,2023-11-01,원인재,6034,3206,2828
1,2023-11-01,동춘,20832,10285,10547
1,2023-11-01,동막,11222,5938,5284
1,2023-11-01,캠퍼스타운,12687,6436,6251
1,2023-11-01,테크노파크,21403,10689,10714
1,2023-11-01,지식정보단지,11088,5439,5649
1,2023-11-01,인천대입구,18714,9221,9493
1,2023-11-01,센트럴파크(재외동포청),7736,3871,3865
1,2023-11-01,국제업무지구,3879,1983,1896
1,2023-11-01,송도달빛축제공원,10191,5109,5082
1,2023-11-02,계양,8338,4217,4121
1,2023-11-02,귤현,2672,1021,1651
1,2023-11-02,박촌,8124,4229,3895
1,2023-11-02,임학,16613,8449,8164
1,2023-11-02,계산,22348,11358,10990
1,2023-11-02,경인교대입구,11725,5919,5806
1,2023-11-02,작전,28887,14595,14292
1,2023-11-02,갈산,19946,10072,9874
1,2023-11-02,부평구청,14062,6967,7095
1,2023-11-02,부평시장,27897,13927,13970
1,2023-11-02,부평,12725,6317,6408
1,2023-11-02,동수,8664,4392,4272
1,2023-11-02,부평삼거리,5638,2873,2765
1,2023-11-02,간석오거리,22119,11594,10525
1,2023-11-02,인천시청,11959,6039,5920
1,2023-11-02,예술회관,23671,11610,12061
1,2023-11-02,인천터미널,26757,13394,13363
1,2023-11-02,문학경기장,3805,1931,1874
1,2023-11-02,선학,12807,6493,6314
1,2023-11-02,신연수,12441,6324,6117
1,2023-11-02,원인재,6252,3367,2885
1,2023-11-02,동춘,20725,10087,10638
1,2023-11-02,동막,11017,5819,5198
1,2023-11-02,캠퍼스타운,13218,6853,6365
1,2023-11-02,테크노파크,22027,11006,11021
1,2023-11-02,지식정보단지,10899,5335,5564
1,2023-11-02,인천대입구,18676,9456,9220
1,2023-11-02,센트럴파크(재외동포청),8515,4175,4340
1,2023-11-02,국제업무지구,3907,1974,1933
1,2023-11-02,송도달빛축제공원,10774,5348,5426
1,2023-11-03,계양,7962,3953,4009
1,2023-11-03,귤현,2623,1037,1586
1,2023-11-03,박촌,8082,4203,3879
1,2023-11-03,임학,16565,8347,8218
1,2023-11-03,계산,21760,11010,10750
1,2023-11-03,경인교대입구,11396,5779,5617
1,2023-11-03,작전,28996,14830,14166
1,2023-11-03,갈산,19664,10051,9613
1,2023-11-03,부평구청,14113,6993,7120
1,2023-11-03,부평시장,27540,13688,13852
1,2023-11-03,부평,13920,6812,7108
1,2023-11-03,동수,8494,4343,4151
1,2023-11-03,부평삼거리,5481,2803,2678
1,2023-11-03,간석오거리,22003,11510,10493
1,2023-11-03,인천시청,11415,5826,5589
1,2023-11-03,예술회관,24961,11923,13038
1,2023-11-03,인천터미널,30627,14991,15636
1,2023-11-03,문학경기장,3941,2001,1940
1,2023-11-03,선학,13344,6708,6636
1,2023-11-03,신연수,12022,6223,5799
1,2023-11-03,원인재,6167,3317,2850
1,2023-11-03,동춘,21292,10467,10825
1,2023-11-03,동막,11585,6159,5426
1,2023-11-03,캠퍼스타운,13317,6987,6330
1,2023-11-03,테크노파크,22538,11282,11256
1,2023-11-03,지식정보단지,10524,5127,5397
1,2023-11-03,인천대입구,18882,9657,9225
1,2023-11-03,센트럴파크(재외동포청),8479,4217,4262
1,2023-11-03,국제업무지구,3944,2026,1918
1,2023-11-03,송도달빛축제공원,10795,5460,5335
1,2023-11-04,계양,6536,3141,3395
1,2023-11-04,귤현,1700,782,918
1,2023-11-04,박촌,5558,2962,2596
1,2023-11-04,임학,12520,6373,6147
1,2023-11-04,계산,19690,9899,9791
1,2023-11-04,경인교대입구,9026,4536,4490
1,2023-11-04,작전,22072,11420,10652
1,2023-11-04,갈산,10703,5600,5103
1,2023-11-04,부평구청,10625,5159,5466
1,2023-11-04,부평시장,19571,9728,9843
1,2023-11-04,부평,13440,6664,6776
1,2023-11-04,동수,5604,2840,2764
1,2023-11-04,부평삼거리,4533,2234,2299
1,2023-11-04,간석오거리,16817,8783,8034
1,2023-11-04,인천시청,8121,4191,3930
1,2023-11-04,예술회관,17647,8216,9431
1,2023-11-04,인천터미널,28695,14030,14665
1,2023-11-04,문학경기장,3460,1696,1764
1,2023-11-04,선학,10712,5355,5357
1,2023-11-04,신연수,6829,3653,3176
1,2023-11-04,원인재,4046,2146,1900
1,2023-11-04,동춘,15921,7922,7999
1,2023-11-04,동막,7136,3839,3297
1,2023-11-04,캠퍼스타운,8984,4745,4239
1,2023-11-04,테크노파크,19772,9672,10100
1,2023-11-04,지식정보단지,4650,2429,2221
1,2023-11-04,인천대입구,12045,6009,6036
1,2023-11-04,센트럴파크(재외동포청),9274,4577,4697
1,2023-11-04,국제업무지구,1948,1031,917
1,2023-11-04,송도달빛축제공원,10146,5132,5014
1,2023-11-05,계양,3966,1810,2156
1,2023-11-05,귤현,987,461,526
1,2023-11-05,박촌,3779,1925,1854
1,2023-11-05,임학,8120,4074,4046
1,2023-11-05,계산,11169,5583,5586
1,2023-11-05,경인교대입구,6728,3309,3419
1,2023-11-05,작전,13153,6736,6417
1,2023-11-05,갈산,5983,3071,2912
1,2023-11-05,부평구청,7116,3564,3552
1,2023-11-05,부평시장,13221,6599,6622
1,2023-11-05,부평,8332,4464,3868
1,2023-11-05,동수,3905,1981,1924
1,2023-11-05,부평삼거리,2790,1378,1412
1,2023-11-05,간석오거리,11079,5790,5289
1,2023-11-05,인천시청,5021,2542,2479
1,2023-11-05,예술회관,11346,5591,5755
1,2023-11-05,인천터미널,21316,10947,10369
1,2023-11-05,문학경기장,1696,853,843
1,2023-11-05,선학,6946,3464,3482
1,2023-11-05,신연수,4224,2147,2077
1,2023-11-05,원인재,2427,1308,1119
1,2023-11-05,동춘,10035,5005,5030
1,2023-11-05,동막,4205,2119,2086
1,2023-11-05,캠퍼스타운,5951,2896,3055
1,2023-11-05,테크노파크,13371,6584,6787
1,2023-11-05,지식정보단지,2725,1322,1403
1,2023-11-05,인천대입구,7431,3507,3924
1,2023-11-05,센트럴파크(재외동포청),5082,2434,2648
1,2023-11-05,국제업무지구,711,372,339
1,2023-11-05,송도달빛축제공원,5462,2693,2769
1,2023-11-06,계양,7355,3719,3636
1,2023-11-06,귤현,2414,958,1456
1,2023-11-06,박촌,7646,4010,3636
1,2023-11-06,임학,15443,7828,7615
1,2023-11-06,계산,20364,10437,9927
1,2023-11-06,경인교대입구,11105,5573,5532
1,2023-11-06,작전,27440,13961,13479
1,2023-11-06,갈산,19101,9694,9407
1,2023-11-06,부평구청,12666,6194,6472
1,2023-11-06,부평시장,25619,12930,12689
1,2023-11-06,부평,11949,5978,5971
1,2023-11-06,동수,8199,4218,3981
1,2023-11-06,부평삼거리,4946,2515,2431
1,2023-11-06,간석오거리,20511,10715,9796
1,2023-11-06,인천시청,10637,5407,5230
1,2023-11-06,예술회관,22261,11066,11195
1,2023-11-06,인천터미널,23851,11329,12522
1,2023-11-06,문학경기장,3472,1740,1732
1,2023-11-06,선학,11382,5695,5687
1,2023-11-06,신연수,11287,5667,5620
1,2023-11-06,원인재,5493,2929,2564
1,2023-11-06,동춘,19242,9360,9882
1,2023-11-06,동막,10262,5434,4828
1,2023-11-06,캠퍼스타운,11669,5753,5916
1,2023-11-06,테크노파크,19907,9961,9946
1,2023-11-06,지식정보단지,10227,4960,5267
1,2023-11-06,인천대입구,16779,8189,8590
1,2023-11-06,센트럴파크(재외동포청),6693,3337,3356
1,2023-11-06,국제업무지구,3623,1877,1746
1,2023-11-06,송도달빛축제공원,9026,4546,4480
1,2023-11-07,계양,7906,3971,3935
1,2023-11-07,귤현,2589,1022,1567
1,2023-11-07,박촌,8138,4266,3872
1,2023-11-07,임학,16372,8242,8130
1,2023-11-07,계산,21195,10719,10476
1,2023-11-07,경인교대입구,11443,5797,5646
1,2023-11-07,작전,28467,14454,14013
1,2023-11-07,갈산,19864,10078,9786
1,2023-11-07,부평구청,13796,6780,7016
1,2023-11-07,부평시장,27292,13695,13597
1,2023-11-07,부평,12526,6265,6261
1,2023-11-07,동수,8541,4325,4216
1,2023-11-07,부평삼거리,5365,2708,2657
1,2023-11-07,간석오거리,21856,11418,10438
1,2023-11-07,인천시청,11294,5717,5577
1,2023-11-07,예술회관,23259,11400,11859
1,2023-11-07,인천터미널,25989,12544,13445
1,2023-11-07,문학경기장,4189,2150,2039
1,2023-11-07,선학,12631,6332,6299
1,2023-11-07,신연수,12072,6112,5960
1,2023-11-07,원인재,5888,3148,2740
1,2023-11-07,동춘,20188,9836,10352
1,2023-11-07,동막,11074,5876,5198
1,2023-11-07,캠퍼스타운,12395,6247,6148
1,2023-11-07,테크노파크,21422,10696,10726
1,2023-11-07,지식정보단지,10896,5348,5548
1,2023-11-07,인천대입구,18486,9301,9185
1,2023-11-07,센트럴파크(재외동포청),7668,3856,3812
1,2023-11-07,국제업무지구,3904,1985,1919
1,2023-11-07,송도달빛축제공원,10168,5083,5085
1,2023-11-08,계양,7972,4054,3918
1,2023-11-08,귤현,2647,1040,1607
1,2023-11-08,박촌,8178,4262,3916
1,2023-11-08,임학,16691,8414,8277
1,2023-11-08,계산,22059,11236,10823
1,2023-11-08,경인교대입구,11525,5762,5763
1,2023-11-08,작전,28845,14637,14208
1,2023-11-08,갈산,20183,10232,9951
1,2023-11-08,부평구청,14033,6832,7201
1,2023-11-08,부평시장,27759,13836,13923
1,2023-11-08,부평,13090,6575,6515
1,2023-11-08,동수,8621,4380,4241
1,2023-11-08,부평삼거리,5564,2835,2729
1,2023-11-08,간석오거리,22373,11678,10695
1,2023-11-08,인천시청,11514,5794,5720
1,2023-11-08,예술회관,24363,11942,12421
1,2023-11-08,인천터미널,27103,13311,13792
1,2023-11-08,문학경기장,3752,1885,1867
1,2023-11-08,선학,12812,6437,6375
1,2023-11-08,신연수,12077,6155,5922
1,2023-11-08,원인재,6131,3276,2855
1,2023-11-08,동춘,20985,10277,10708
1,2023-11-08,동막,11373,6020,5353
1,2023-11-08,캠퍼스타운,12641,6355,6286
1,2023-11-08,테크노파크,22318,11208,11110
1,2023-11-08,지식정보단지,11031,5450,5581
1,2023-11-08,인천대입구,18735,9425,9310
1,2023-11-08,센트럴파크(재외동포청),8325,4071,4254
1,2023-11-08,국제업무지구,3818,1935,1883
1,2023-11-08,송도달빛축제공원,10652,5333,5319
1,2023-11-09,계양,7848,3956,3892
1,2023-11-09,귤현,2586,1007,1579
1,2023-11-09,박촌,7985,4176,3809
1,2023-11-09,임학,16447,8271,8176
1,2023-11-09,계산,21654,10960,10694
1,2023-11-09,경인교대입구,11320,5748,5572
1,2023-11-09,작전,27987,14160,13827
1,2023-11-09,갈산,19710,9948,9762
1,2023-11-09,부평구청,13762,6763,6999
1,2023-11-09,부평시장,27003,13576,13427
1,2023-11-09,부평,12780,6329,6451
1,2023-11-09,동수,8519,4330,4189
1,2023-11-09,부평삼거리,5443,2772,2671
1,2023-11-09,간석오거리,21986,11439,10547
1,2023-11-09,인천시청,11306,5705,5601
1,2023-11-09,예술회관,23344,11518,11826
1,2023-11-09,인천터미널,26711,13275,13436
1,2023-11-09,문학경기장,3682,1904,1778
1,2023-11-09,선학,12371,6208,6163
1,2023-11-09,신연수,11892,5982,5910
1,2023-11-09,원인재,6061,3241,2820
1,2023-11-09,동춘,20517,9970,10547
1,2023-11-09,동막,11060,5812,5248
1,2023-11-09,캠퍼스타운,13046,6810,6236
1,2023-11-09,테크노파크,21809,10908,10901
1,2023-11-09,지식정보단지,10744,5245,5499
1,2023-11-09,인천대입구,18134,9097,9037
1,2023-11-09,센트럴파크(재외동포청),8052,4012,4040
1,2023-11-09,국제업무지구,3824,1935,1889
1,2023-11-09,송도달빛축제공원,10307,5158,5149
1,2023-11-10,계양,8109,4040,4069
1,2023-11-10,귤현,2698,1074,1624
1,2023-11-10,박촌,8290,4293,3997
1,2023-11-10,임학,16620,8400,8220
1,2023-11-10,계산,21894,11194,10700
1,2023-11-10,경인교대입구,11583,5885,5698
1,2023-11-10,작전,28714,14650,14064
1,2023-11-10,갈산,19506,9960,9546
1,2023-11-10,부평구청,14080,6915,7165
1,2023-11-10,부평시장,27296,13627,13669
1,2023-11-10,부평,14380,7070,7310
1,2023-11-10,동수,8404,4317,4087
1,2023-11-10,부평삼거리,5411,2803,2608
1,2023-11-10,간석오거리,22211,11642,10569
1,2023-11-10,인천시청,11266,5698,5568
1,2023-11-10,예술회관,24838,11922,12916
1,2023-11-10,인천터미널,31369,15164,16205
1,2023-11-10,문학경기장,3707,1908,1799
1,2023-11-10,선학,13074,6618,6456
1,2023-11-10,신연수,11682,5984,5698
1,2023-11-10,원인재,6000,3166,2834
1,2023-11-10,동춘,21918,10752,11166
1,2023-11-10,동막,11558,6148,5410
1,2023-11-10,캠퍼스타운,13182,6879,6303
1,2023-11-10,테크노파크,23603,11906,11697
1,2023-11-10,지식정보단지,10649,5261,5388
1,2023-11-10,인천대입구,20109,10404,9705
1,2023-11-10,센트럴파크(재외동포청),8384,4073,4311
1,2023-11-10,국제업무지구,3838,1960,1878
1,2023-11-10,송도달빛축제공원,10350,5208,5142
1,2023-11-11,계양,5754,2791,2963
1,2023-11-11,귤현,1625,749,876
1,2023-11-11,박촌,5749,3087,2662
1,2023-11-11,임학,12318,6245,6073
1,2023-11-11,계산,19274,9665,9609
1,2023-11-11,경인교대입구,9147,4585,4562
1,2023-11-11,작전,22389,11591,10798
1,2023-11-11,갈산,10232,5306,4926
1,2023-11-11,부평구청,9926,4851,5075
1,2023-11-11,부평시장,18537,9364,9173
1,2023-11-11,부평,13809,6907,6902
1,2023-11-11,동수,5511,2800,2711
1,2023-11-11,부평삼거리,3768,1898,1870
1,2023-11-11,간석오거리,16537,8584,7953
1,2023-11-11,인천시청,7815,4070,3745
1,2023-11-11,예술회관,17396,8230,9166
1,2023-11-11,인천터미널,28694,13839,14855
1,2023-11-11,문학경기장,3171,1575,1596
1,2023-11-11,선학,10238,5131,5107
1,2023-11-11,신연수,6462,3408,3054
1,2023-11-11,원인재,4129,2184,1945
1,2023-11-11,동춘,16241,8016,8225
1,2023-11-11,동막,6921,3686,3235
1,2023-11-11,캠퍼스타운,8599,4510,4089
1,2023-11-11,테크노파크,21197,10622,10575
1,2023-11-11,지식정보단지,4592,2354,2238
1,2023-11-11,인천대입구,11350,5705,5645
1,2023-11-11,센트럴파크(재외동포청),8300,4064,4236
1,2023-11-11,국제업무지구,1811,941,870
1,2023-11-11,송도달빛축제공원,8135,4140,3995
1,2023-11-12,계양,4316,1945,2371
1,2023-11-12,귤현,1082,507,575
1,2023-11-12,박촌,4137,2153,1984
1,2023-11-12,임학,8796,4482,4314
1,2023-11-12,계산,13751,6804,6947
1,2023-11-12,경인교대입구,7528,3721,3807
1,2023-11-12,작전,14277,7350,6927
1,2023-11-12,갈산,6540,3302,3238
1,2023-11-12,부평구청,7131,3458,3673
1,2023-11-12,부평시장,14189,7097,7092
1,2023-11-12,부평,9417,5021,4396
1,2023-11-12,동수,4113,2077,2036
1,2023-11-12,부평삼거리,2853,1434,1419
1,2023-11-12,간석오거리,12155,6294,5861
1,2023-11-12,인천시청,5213,2632,2581
1,2023-11-12,예술회관,11011,5370,5641
1,2023-11-12,인천터미널,23354,11860,11494
1,2023-11-12,문학경기장,2296,1124,1172
1,2023-11-12,선학,8022,3968,4054
1,2023-11-12,신연수,4735,2434,2301
1,2023-11-12,원인재,2512,1347,1165
1,2023-11-12,동춘,9861,4879,4982
1,2023-11-12,동막,4521,2294,2227
1,2023-11-12,캠퍼스타운,6384,3062,3322
1,2023-11-12,테크노파크,16190,7981,8209
1,2023-11-12,지식정보단지,2923,1431,1492
1,2023-11-12,인천대입구,7809,3715,4094
1,2023-11-12,센트럴파크(재외동포청),5015,2420,2595
1,2023-11-12,국제업무지구,785,422,363
1,2023-11-12,송도달빛축제공원,5889,2911,2978
1,2023-11-13,계양,7664,3848,3816
1,2023-11-13,귤현,2432,958,1474
1,2023-11-13,박촌,7743,4062,3681
1,2023-11-13,임학,16077,8115,7962
1,2023-11-13,계산,21071,10775,10296
1,2023-11-13,경인교대입구,11365,5670,5695
1,2023-11-13,작전,27677,14046,13631
1,2023-11-13,갈산,19280,9738,9542
1,2023-11-13,부평구청,13274,6523,6751
1,2023-11-13,부평시장,26313,13171,13142
1,2023-11-13,부평,12427,6212,6215
1,2023-11-13,동수,8255,4238,4017
1,2023-11-13,부평삼거리,5030,2573,2457
1,2023-11-13,간석오거리,21146,11011,10135
1,2023-11-13,인천시청,10635,5401,5234
1,2023-11-13,예술회관,23028,11272,11756
1,2023-11-13,인천터미널,25994,12515,13479
1,2023-11-13,문학경기장,3615,1787,1828
1,2023-11-13,선학,11688,5846,5842
1,2023-11-13,신연수,11515,5815,5700
1,2023-11-13,원인재,5660,3054,2606
1,2023-11-13,동춘,20178,9831,10347
1,2023-11-13,동막,10628,5619,5009
1,2023-11-13,캠퍼스타운,11970,5930,6040
1,2023-11-13,테크노파크,21147,10613,10534
1,2023-11-13,지식정보단지,10351,5050,5301
1,2023-11-13,인천대입구,17464,8664,8800
1,2023-11-13,센트럴파크(재외동포청),6930,3496,3434
1,2023-11-13,국제업무지구,3725,1914,1811
1,2023-11-13,송도달빛축제공원,9737,4891,4846
1,2023-11-14,계양,8061,4039,4022
1,2023-11-14,귤현,2570,986,1584
1,2023-11-14,박촌,8081,4169,3912
1,2023-11-14,임학,16354,8290,8064
1,2023-11-14,계산,20832,10626,10206
1,2023-11-14,경인교대입구,11375,5688,5687
1,2023-11-14,작전,28638,14621,14017
1,2023-11-14,갈산,19600,9959,9641
1,2023-11-14,부평구청,13841,6769,7072
1,2023-11-14,부평시장,26868,13454,13414
1,2023-11-14,부평,12436,6231,6205
1,2023-11-14,동수,8475,4334,4141
1,2023-11-14,부평삼거리,5349,2659,2690
1,2023-11-14,간석오거리,21878,11477,10401
1,2023-11-14,인천시청,11306,5645,5661
1,2023-11-14,예술회관,23054,11350,11704
1,2023-11-14,인천터미널,25580,12445,13135
1,2023-11-14,문학경기장,3696,1855,1841
1,2023-11-14,선학,12498,6284,6214
1,2023-11-14,신연수,11845,5999,5846
1,2023-11-14,원인재,5894,3189,2705
1,2023-11-14,동춘,20755,10135,10620
1,2023-11-14,동막,10756,5666,5090
1,2023-11-14,캠퍼스타운,12223,6090,6133
1,2023-11-14,테크노파크,21173,10489,10684
1,2023-11-14,지식정보단지,10570,5157,5413
1,2023-11-14,인천대입구,18120,9127,8993
1,2023-11-14,센트럴파크(재외동포청),7432,3697,3735
1,2023-11-14,국제업무지구,4019,2057,1962
1,2023-11-14,송도달빛축제공원,10328,5114,5214
1,2023-11-15,계양,8117,4135,3982
1,2023-11-15,귤현,2695,1055,1640
1,2023-11-15,박촌,8307,4327,3980
1,2023-11-15,임학,16885,8503,8382
1,2023-11-15,계산,21967,11180,10787
1,2023-11-15,경인교대입구,11616,5885,5731
1,2023-11-15,작전,29449,14897,14552
1,2023-11-15,갈산,19917,10116,9801
1,2023-11-15,부평구청,14166,6928,7238
1,2023-11-15,부평시장,27878,13960,13918
1,2023-11-15,부평,13227,6597,6630
1,2023-11-15,동수,8509,4323,4186
1,2023-11-15,부평삼거리,5541,2777,2764
1,2023-11-15,간석오거리,22457,11753,10704
1,2023-11-15,인천시청,11439,5763,5676
1,2023-11-15,예술회관,24731,12133,12598
1,2023-11-15,인천터미널,26550,12956,13594
1,2023-11-15,문학경기장,3802,1926,1876
1,2023-11-15,선학,12775,6369,6406
1,2023-11-15,신연수,12283,6303,5980
1,2023-11-15,원인재,6105,3223,2882
1,2023-11-15,동춘,21487,10532,10955
1,2023-11-15,동막,11263,5923,5340
1,2023-11-15,캠퍼스타운,13448,6795,6653
1,2023-11-15,테크노파크,22594,11354,11240
1,2023-11-15,지식정보단지,11043,5396,5647
1,2023-11-15,인천대입구,18333,9211,9122
1,2023-11-15,센트럴파크(재외동포청),7868,3871,3997
1,2023-11-15,국제업무지구,3834,1933,1901
1,2023-11-15,송도달빛축제공원,10703,5271,5432
1,2023-11-16,계양,7428,3759,3669
1,2023-11-16,귤현,2355,876,1479
1,2023-11-16,박촌,7206,3727,3479
1,2023-11-16,임학,15799,7958,7841
1,2023-11-16,계산,19936,10145,9791
1,2023-11-16,경인교대입구,10825,5455,5370
1,2023-11-16,작전,27123,13791,13332
1,2023-11-16,갈산,18785,9570,9215
1,2023-11-16,부평구청,13267,6538,6729
1,2023-11-16,부평시장,24938,12458,12480
1,2023-11-16,부평,12655,6366,6289
1,2023-11-16,동수,8104,4118,3986
1,2023-11-16,부평삼거리,4260,2151,2109
1,2023-11-16,간석오거리,20443,10617,9826
1,2023-11-16,인천시청,10104,5078,5026
1,2023-11-16,예술회관,22573,11092,11481
1,2023-11-16,인천터미널,24771,12395,12376
1,2023-11-16,문학경기장,3123,1568,1555
1,2023-11-16,선학,11834,5919,5915
1,2023-11-16,신연수,10979,5560,5419
1,2023-11-16,원인재,5543,2977,2566
1,2023-11-16,동춘,19795,9549,10246
1,2023-11-16,동막,10321,5388,4933
1,2023-11-16,캠퍼스타운,12270,6369,5901
1,2023-11-16,테크노파크,21572,10839,10733
1,2023-11-16,지식정보단지,10229,4966,5263
1,2023-11-16,인천대입구,17717,8919,8798
1,2023-11-16,센트럴파크(재외동포청),7198,3575,3623
1,2023-11-16,국제업무지구,3755,1905,1850
1,2023-11-16,송도달빛축제공원,9628,4824,4804
1,2023-11-17,계양,7920,3975,3945
1,2023-11-17,귤현,2503,976,1527
1,2023-11-17,박촌,8279,4429,3850
1,2023-11-17,임학,16775,8328,8447
1,2023-11-17,계산,21548,10977,10571
1,2023-11-17,경인교대입구,11495,5777,5718
1,2023-11-17,작전,29026,14748,14278
1,2023-11-17,갈산,19119,9703,9416
1,2023-11-17,부평구청,14049,6840,7209
1,2023-11-17,부평시장,27887,14029,13858
1,2023-11-17,부평,14549,7179,7370
1,2023-11-17,동수,8300,4246,4054
1,2023-11-17,부평삼거리,5400,2764,2636
1,2023-11-17,간석오거리,22155,11578,10577
1,2023-11-17,인천시청,11176,5641,5535
1,2023-11-17,예술회관,25236,12074,13162
1,2023-11-17,인천터미널,30971,15055,15916
1,2023-11-17,문학경기장,4020,2085,1935
1,2023-11-17,선학,12900,6460,6440
1,2023-11-17,신연수,11731,6059,5672
1,2023-11-17,원인재,5971,3182,2789
1,2023-11-17,동춘,22953,11184,11769
1,2023-11-17,동막,11190,5867,5323
1,2023-11-17,캠퍼스타운,13197,6896,6301
1,2023-11-17,테크노파크,24037,12104,11933
1,2023-11-17,지식정보단지,10737,5321,5416
1,2023-11-17,인천대입구,17972,9191,8781
1,2023-11-17,센트럴파크(재외동포청),8108,3978,4130
1,2023-11-17,국제업무지구,3948,2022,1926
1,2023-11-17,송도달빛축제공원,10340,5239,5101
1,2023-11-18,계양,5751,2790,2961
1,2023-11-18,귤현,1493,695,798
1,2023-11-18,박촌,5392,2904,2488
1,2023-11-18,임학,12060,6095,5965
1,2023-11-18,계산,17237,8738,8499
1,2023-11-18,경인교대입구,8771,4416,4355
1,2023-11-18,작전,21118,10784,10334
1,2023-11-18,갈산,10111,5180,4931
1,2023-11-18,부평구청,9663,4704,4959
1,2023-11-18,부평시장,18217,9098,9119
1,2023-11-18,부평,13468,6641,6827
1,2023-11-18,동수,5476,2838,2638
1,2023-11-18,부평삼거리,3702,1871,1831
1,2023-11-18,간석오거리,15889,8371,7518
1,2023-11-18,인천시청,6992,3593,3399
1,2023-11-18,예술회관,17407,8254,9153
1,2023-11-18,인천터미널,27771,13370,14401
1,2023-11-18,문학경기장,2829,1401,1428
1,2023-11-18,선학,10379,5259,5120
1,2023-11-18,신연수,6595,3510,3085
1,2023-11-18,원인재,3773,2024,1749
1,2023-11-18,동춘,16140,7942,8198
1,2023-11-18,동막,6639,3558,3081
1,2023-11-18,캠퍼스타운,8447,4429,4018
1,2023-11-18,테크노파크,19387,9630,9757
1,2023-11-18,지식정보단지,4118,2136,1982
1,2023-11-18,인천대입구,10573,5240,5333
1,2023-11-18,센트럴파크(재외동포청),7648,3767,3881
1,2023-11-18,국제업무지구,1803,956,847
1,2023-11-18,송도달빛축제공원,7812,3979,3833
1,2023-11-19,계양,4347,2008,2339
1,2023-11-19,귤현,1096,510,586
1,2023-11-19,박촌,4152,2180,1972
1,2023-11-19,임학,8867,4459,4408
1,2023-11-19,계산,13384,6619,6765
1,2023-11-19,경인교대입구,7032,3496,3536
1,2023-11-19,작전,14679,7493,7186
1,2023-11-19,갈산,6862,3536,3326
1,2023-11-19,부평구청,7136,3500,3636
1,2023-11-19,부평시장,14312,7065,7247
1,2023-11-19,부평,9580,4984,4596
1,2023-11-19,동수,4200,2105,2095
1,2023-11-19,부평삼거리,3369,1717,1652
1,2023-11-19,간석오거리,12293,6351,5942
1,2023-11-19,인천시청,5326,2675,2651
1,2023-11-19,예술회관,11749,5774,5975
1,2023-11-19,인천터미널,23091,11654,11437
1,2023-11-19,문학경기장,1872,923,949
1,2023-11-19,선학,8015,3953,4062
1,2023-11-19,신연수,4889,2512,2377
1,2023-11-19,원인재,2640,1405,1235
1,2023-11-19,동춘,12822,6355,6467
1,2023-11-19,동막,4676,2425,2251
1,2023-11-19,캠퍼스타운,6741,3224,3517
1,2023-11-19,테크노파크,15982,7859,8123
1,2023-11-19,지식정보단지,3056,1518,1538
1,2023-11-19,인천대입구,9408,4513,4895
1,2023-11-19,센트럴파크(재외동포청),5580,2722,2858
1,2023-11-19,국제업무지구,803,415,388
1,2023-11-19,송도달빛축제공원,6177,3054,3123
1,2023-11-20,계양,7769,3952,3817
1,2023-11-20,귤현,2558,1049,1509
1,2023-11-20,박촌,7894,4131,3763
1,2023-11-20,임학,16342,8271,8071
1,2023-11-20,계산,21362,10868,10494
1,2023-11-20,경인교대입구,11355,5681,5674
1,2023-11-20,작전,27869,14185,13684
1,2023-11-20,갈산,19209,9779,9430
1,2023-11-20,부평구청,13351,6499,6852
1,2023-11-20,부평시장,26662,13350,13312
1,2023-11-20,부평,12547,6262,6285
1,2023-11-20,동수,8290,4212,4078
1,2023-11-20,부평삼거리,5254,2672,2582
1,2023-11-20,간석오거리,21745,11336,10409
1,2023-11-20,인천시청,11041,5511,5530
1,2023-11-20,예술회관,23133,11450,11683
1,2023-11-20,인천터미널,26366,12715,13651
1,2023-11-20,문학경기장,3481,1749,1732
1,2023-11-20,선학,12251,6093,6158
1,2023-11-20,신연수,11576,5875,5701
1,2023-11-20,원인재,5642,3016,2626
1,2023-11-20,동춘,20127,9839,10288
1,2023-11-20,동막,10602,5627,4975
1,2023-11-20,캠퍼스타운,12439,6116,6323
1,2023-11-20,테크노파크,21731,10882,10849
1,2023-11-20,지식정보단지,10665,5223,5442
1,2023-11-20,인천대입구,17620,8661,8959
1,2023-11-20,센트럴파크(재외동포청),7135,3588,3547
1,2023-11-20,국제업무지구,3725,1909,1816
1,2023-11-20,송도달빛축제공원,10149,5062,5087
1,2023-11-21,계양,8187,4178,4009
1,2023-11-21,귤현,2643,1016,1627
1,2023-11-21,박촌,8071,4220,3851
1,2023-11-21,임학,17260,8719,8541
1,2023-11-21,계산,21150,10709,10441
1,2023-11-21,경인교대입구,11407,5725,5682
1,2023-11-21,작전,28509,14478,14031
1,2023-11-21,갈산,19823,10093,9730
1,2023-11-21,부평구청,14388,7106,7282
1,2023-11-21,부평시장,27714,13907,13807
1,2023-11-21,부평,12459,6147,6312
1,2023-11-21,동수,8528,4323,4205
1,2023-11-21,부평삼거리,5312,2686,2626
1,2023-11-21,간석오거리,22262,11579,10683
1,2023-11-21,인천시청,11486,5791,5695
1,2023-11-21,예술회관,23603,11652,11951
1,2023-11-21,인천터미널,25705,12577,13128
1,2023-11-21,문학경기장,3660,1857,1803
1,2023-11-21,선학,12229,6142,6087
1,2023-11-21,신연수,11841,6000,5841
1,2023-11-21,원인재,5749,3053,2696
1,2023-11-21,동춘,20341,9991,10350
1,2023-11-21,동막,10950,5806,5144
1,2023-11-21,캠퍼스타운,12580,6348,6232
1,2023-11-21,테크노파크,22145,11097,11048
1,2023-11-21,지식정보단지,10874,5340,5534
1,2023-11-21,인천대입구,18098,9041,9057
1,2023-11-21,센트럴파크(재외동포청),7804,3883,3921
1,2023-11-21,국제업무지구,3834,1959,1875
1,2023-11-21,송도달빛축제공원,10384,5154,5230
1,2023-11-22,계양,8034,4118,3916
1,2023-11-22,귤현,2589,997,1592
1,2023-11-22,박촌,8042,4208,3834
1,2023-11-22,임학,16817,8498,8319
1,2023-11-22,계산,21970,11101,10869
1,2023-11-22,경인교대입구,11728,5920,5808
1,2023-11-22,작전,28659,14570,14089
1,2023-11-22,갈산,19794,10030,9764
1,2023-11-22,부평구청,13822,6812,7010
1,2023-11-22,부평시장,27254,13602,13652
1,2023-11-22,부평,13103,6609,6494
1,2023-11-22,동수,8499,4315,4184
1,2023-11-22,부평삼거리,5370,2709,2661
1,2023-11-22,간석오거리,22001,11486,10515
1,2023-11-22,인천시청,11456,5768,5688
1,2023-11-22,예술회관,23996,11703,12293
1,2023-11-22,인천터미널,25626,12591,13035
1,2023-11-22,문학경기장,3513,1786,1727
1,2023-11-22,선학,12704,6375,6329
1,2023-11-22,신연수,11848,6039,5809
1,2023-11-22,원인재,5806,3032,2774
1,2023-11-22,동춘,20508,10059,10449
1,2023-11-22,동막,11472,6098,5374
1,2023-11-22,캠퍼스타운,12800,6488,6312
1,2023-11-22,테크노파크,21774,10891,10883
1,2023-11-22,지식정보단지,10835,5321,5514
1,2023-11-22,인천대입구,18157,9087,9070
1,2023-11-22,센트럴파크(재외동포청),7995,3964,4031
1,2023-11-22,국제업무지구,3750,1904,1846
1,2023-11-22,송도달빛축제공원,10572,5255,5317
1,2023-11-23,계양,8048,4028,4020
1,2023-11-23,귤현,2548,972,1576
1,2023-11-23,박촌,8019,4217,3802
1,2023-11-23,임학,16360,8181,8179
1,2023-11-23,계산,21740,11067,10673
1,2023-11-23,경인교대입구,11995,6064,5931
1,2023-11-23,작전,28802,14622,14180
1,2023-11-23,갈산,19299,9813,9486
1,2023-11-23,부평구청,14145,6954,7191
1,2023-11-23,부평시장,27458,13691,13767
1,2023-11-23,부평,12692,6463,6229
1,2023-11-23,동수,8505,4260,4245
1,2023-11-23,부평삼거리,5229,2685,2544
1,2023-11-23,간석오거리,22073,11473,10600
1,2023-11-23,인천시청,11412,5704,5708
1,2023-11-23,예술회관,23703,11631,12072
1,2023-11-23,인천터미널,26410,13095,13315
1,2023-11-23,문학경기장,3726,1890,1836
1,2023-11-23,선학,12471,6310,6161
1,2023-11-23,신연수,11766,5994,5772
1,2023-11-23,원인재,5368,2856,2512
1,2023-11-23,동춘,20522,9966,10556
1,2023-11-23,동막,10926,5736,5190
1,2023-11-23,캠퍼스타운,13033,6676,6357
1,2023-11-23,테크노파크,22140,11156,10984
1,2023-11-23,지식정보단지,10870,5319,5551
1,2023-11-23,인천대입구,18604,9411,9193
1,2023-11-23,센트럴파크(재외동포청),7938,3979,3959
1,2023-11-23,국제업무지구,3858,1963,1895
1,2023-11-23,송도달빛축제공원,10312,5096,5216
1,2023-11-24,계양,7886,3922,3964
1,2023-11-24,귤현,2626,1084,1542
1,2023-11-24,박촌,8145,4265,3880
1,2023-11-24,임학,16558,8341,8217
1,2023-11-24,계산,22024,11201,10823
1,2023-11-24,경인교대입구,11556,5799,5757
1,2023-11-24,작전,28653,14500,14153
1,2023-11-24,갈산,19290,9849,9441
1,2023-11-24,부평구청,13814,6727,7087
1,2023-11-24,부평시장,27258,13606,13652
1,2023-11-24,부평,14023,6837,7186
1,2023-11-24,동수,8452,4329,4123
1,2023-11-24,부평삼거리,5237,2623,2614
1,2023-11-24,간석오거리,21763,11401,10362
1,2023-11-24,인천시청,11495,5779,5716
1,2023-11-24,예술회관,25043,11951,13092
1,2023-11-24,인천터미널,30913,15050,15863
1,2023-11-24,문학경기장,3847,1993,1854
1,2023-11-24,선학,12480,6268,6212
1,2023-11-24,신연수,11567,5999,5568
1,2023-11-24,원인재,5640,2939,2701
1,2023-11-24,동춘,21097,10276,10821
1,2023-11-24,동막,11110,5851,5259
1,2023-11-24,캠퍼스타운,12820,6699,6121
1,2023-11-24,테크노파크,23004,11667,11337
1,2023-11-24,지식정보단지,10441,5172,5269
1,2023-11-24,인천대입구,18021,9058,8963
1,2023-11-24,센트럴파크(재외동포청),8364,4141,4223
1,2023-11-24,국제업무지구,3773,1902,1871
1,2023-11-24,송도달빛축제공원,10230,5117,5113
1,2023-11-25,계양,5557,2681,2876
1,2023-11-25,귤현,1497,690,807
1,2023-11-25,박촌,5399,2839,2560
1,2023-11-25,임학,11717,5907,5810
1,2023-11-25,계산,17781,8910,8871
1,2023-11-25,경인교대입구,8554,4322,4232
1,2023-11-25,작전,21158,10684,10474
1,2023-11-25,갈산,10279,5314,4965
1,2023-11-25,부평구청,9676,4729,4947
1,2023-11-25,부평시장,18264,9132,9132
1,2023-11-25,부평,13288,6619,6669
1,2023-11-25,동수,5504,2798,2706
1,2023-11-25,부평삼거리,3684,1859,1825
1,2023-11-25,간석오거리,15613,8210,7403
1,2023-11-25,인천시청,7198,3715,3483
1,2023-11-25,예술회관,17431,8300,9131
1,2023-11-25,인천터미널,27380,13105,14275
1,2023-11-25,문학경기장,3044,1499,1545
1,2023-11-25,선학,10155,5165,4990
1,2023-11-25,신연수,6200,3286,2914
1,2023-11-25,원인재,3377,1802,1575
1,2023-11-25,동춘,15215,7551,7664
1,2023-11-25,동막,6742,3595,3147
1,2023-11-25,캠퍼스타운,8235,4366,3869
1,2023-11-25,테크노파크,19495,9697,9798
1,2023-11-25,지식정보단지,4320,2206,2114
1,2023-11-25,인천대입구,12237,6271,5966
1,2023-11-25,센트럴파크(재외동포청),7331,3632,3699
1,2023-11-25,국제업무지구,1711,908,803
1,2023-11-25,송도달빛축제공원,7703,3897,3806
1,2023-11-26,계양,4033,1836,2197
1,2023-11-26,귤현,1025,485,540
1,2023-11-26,박촌,4129,2138,1991
1,2023-11-26,임학,8574,4338,4236
1,2023-11-26,계산,13036,6539,6497
1,2023-11-26,경인교대입구,7199,3532,3667
1,2023-11-26,작전,14204,7296,6908
1,2023-11-26,갈산,6418,3282,3136
1,2023-11-26,부평구청,6852,3342,3510
1,2023-11-26,부평시장,14020,7003,7017
1,2023-11-26,부평,8973,4687,4286
1,2023-11-26,동수,3932,2009,1923
1,2023-11-26,부평삼거리,2956,1451,1505
1,2023-11-26,간석오거리,11858,6217,5641
1,2023-11-26,인천시청,5094,2565,2529
1,2023-11-26,예술회관,11529,5570,5959
1,2023-11-26,인천터미널,22612,11409,11203
1,2023-11-26,문학경기장,1820,899,921
1,2023-11-26,선학,7603,3784,3819
1,2023-11-26,신연수,4403,2260,2143
1,2023-11-26,원인재,2395,1279,1116
1,2023-11-26,동춘,9473,4749,4724
1,2023-11-26,동막,4427,2267,2160
1,2023-11-26,캠퍼스타운,6273,2987,3286
1,2023-11-26,테크노파크,15857,7831,8026
1,2023-11-26,지식정보단지,2788,1398,1390
1,2023-11-26,인천대입구,9116,4268,4848
1,2023-11-26,센트럴파크(재외동포청),4894,2411,2483
1,2023-11-26,국제업무지구,773,425,348
1,2023-11-26,송도달빛축제공원,6003,2953,3050
1,2023-11-27,계양,7414,3774,3640
1,2023-11-27,귤현,2381,921,1460
1,2023-11-27,박촌,7501,3956,3545
1,2023-11-27,임학,15673,7939,7734
1,2023-11-27,계산,20662,10546,10116
1,2023-11-27,경인교대입구,11084,5535,5549
1,2023-11-27,작전,27488,13988,13500
1,2023-11-27,갈산,19039,9624,9415
1,2023-11-27,부평구청,13143,6498,6645
1,2023-11-27,부평시장,25786,12986,12800
1,2023-11-27,부평,12303,6181,6122
1,2023-11-27,동수,8111,4137,3974
1,2023-11-27,부평삼거리,4954,2508,2446
1,2023-11-27,간석오거리,20803,10860,9943
1,2023-11-27,인천시청,10646,5417,5229
1,2023-11-27,예술회관,22849,11231,11618
1,2023-11-27,인천터미널,25211,12209,13002
1,2023-11-27,문학경기장,3569,1786,1783
1,2023-11-27,선학,11660,5849,5811
1,2023-11-27,신연수,11230,5650,5580
1,2023-11-27,원인재,5407,2851,2556
1,2023-11-27,동춘,19720,9619,10101
1,2023-11-27,동막,10515,5616,4899
1,2023-11-27,캠퍼스타운,11905,5874,6031
1,2023-11-27,테크노파크,20431,10331,10100
1,2023-11-27,지식정보단지,10307,5040,5267
1,2023-11-27,인천대입구,17301,8536,8765
1,2023-11-27,센트럴파크(재외동포청),6863,3418,3445
1,2023-11-27,국제업무지구,3708,1905,1803
1,2023-11-27,송도달빛축제공원,9749,4857,4892
1,2023-11-28,계양,7875,3964,3911
1,2023-11-28,귤현,2541,982,1559
1,2023-11-28,박촌,8113,4225,3888
1,2023-11-28,임학,16313,8215,8098
1,2023-11-28,계산,20943,10591,10352
1,2023-11-28,경인교대입구,11463,5831,5632
1,2023-11-28,작전,28231,14308,13923
1,2023-11-28,갈산,19711,9916,9795
1,2023-11-28,부평구청,14076,6911,7165
1,2023-11-28,부평시장,27175,13530,13645
1,2023-11-28,부평,12437,6310,6127
1,2023-11-28,동수,8488,4328,4160
1,2023-11-28,부평삼거리,5370,2678,2692
1,2023-11-28,간석오거리,21921,11421,10500
1,2023-11-28,인천시청,11392,5750,5642
1,2023-11-28,예술회관,23442,11521,11921
1,2023-11-28,인천터미널,25446,12333,13113
1,2023-11-28,문학경기장,3706,1854,1852
1,2023-11-28,선학,12207,6145,6062
1,2023-11-28,신연수,11736,5947,5789
1,2023-11-28,원인재,5607,2995,2612
1,2023-11-28,동춘,20539,10127,10412
1,2023-11-28,동막,10680,5621,5059
1,2023-11-28,캠퍼스타운,12115,6073,6042
1,2023-11-28,테크노파크,21404,10710,10694
1,2023-11-28,지식정보단지,10689,5246,5443
1,2023-11-28,인천대입구,17838,8867,8971
1,2023-11-28,센트럴파크(재외동포청),7421,3700,3721
1,2023-11-28,국제업무지구,3919,2023,1896
1,2023-11-28,송도달빛축제공원,9986,4987,4999
1,2023-11-29,계양,7659,3913,3746
1,2023-11-29,귤현,2607,1018,1589
1,2023-11-29,박촌,8026,4123,3903
1,2023-11-29,임학,16129,8105,8024
1,2023-11-29,계산,21781,11070,10711
1,2023-11-29,경인교대입구,11463,5801,5662
1,2023-11-29,작전,28540,14564,13976
1,2023-11-29,갈산,19947,10141,9806
1,2023-11-29,부평구청,13793,6784,7009
1,2023-11-29,부평시장,27271,13626,13645
1,2023-11-29,부평,12802,6498,6304
1,2023-11-29,동수,8432,4216,4216
1,2023-11-29,부평삼거리,5259,2627,2632
1,2023-11-29,간석오거리,21989,11456,10533
1,2023-11-29,인천시청,11454,5743,5711
1,2023-11-29,예술회관,23881,11722,12159
1,2023-11-29,인천터미널,25502,12585,12917
1,2023-11-29,문학경기장,3844,1930,1914
1,2023-11-29,선학,12473,6259,6214
1,2023-11-29,신연수,11840,6038,5802
1,2023-11-29,원인재,5360,2858,2502
1,2023-11-29,동춘,20297,9880,10417
1,2023-11-29,동막,10730,5670,5060
1,2023-11-29,캠퍼스타운,12381,6197,6184
1,2023-11-29,테크노파크,21430,10806,10624
1,2023-11-29,지식정보단지,10724,5322,5402
1,2023-11-29,인천대입구,18615,9198,9417
1,2023-11-29,센트럴파크(재외동포청),7450,3761,3689
1,2023-11-29,국제업무지구,3891,1954,1937
1,2023-11-29,송도달빛축제공원,9970,4939,5031
1,2023-11-30,계양,7602,3821,3781
1,2023-11-30,귤현,2483,966,1517
1,2023-11-30,박촌,7622,3968,3654
1,2023-11-30,임학,15874,7938,7936
1,2023-11-30,계산,20926,10647,10279
1,2023-11-30,경인교대입구,11277,5731,5546
1,2023-11-30,작전,27692,13938,13754
1,2023-11-30,갈산,19499,9884,9615
1,2023-11-30,부평구청,13843,6793,7050
1,2023-11-30,부평시장,26525,13200,13325
1,2023-11-30,부평,12539,6315,6224
1,2023-11-30,동수,8265,4217,4048
1,2023-11-30,부평삼거리,5144,2584,2560
1,2023-11-30,간석오거리,21550,11228,10322
1,2023-11-30,인천시청,11041,5587,5454
1,2023-11-30,예술회관,23218,11443,11775
1,2023-11-30,인천터미널,25817,12856,12961
1,2023-11-30,문학경기장,3418,1716,1702
1,2023-11-30,선학,12224,6122,6102
1,2023-11-30,신연수,11281,5687,5594
1,2023-11-30,원인재,5204,2744,2460
1,2023-11-30,동춘,20072,9759,10313
1,2023-11-30,동막,11067,5834,5233
1,2023-11-30,캠퍼스타운,12146,6287,5859
1,2023-11-30,테크노파크,21308,10735,10573
1,2023-11-30,지식정보단지,10302,5054,5248
1,2023-11-30,인천대입구,18585,9223,9362
1,2023-11-30,센트럴파크(재외동포청),7448,3734,3714
1,2023-11-30,국제업무지구,3827,1957,1870
1,2023-11-30,송도달빛축제공원,9772,4864,4908
1,2023-12-01,계양,7693,3871,3822
1,2023-12-01,귤현,2570,1029,1541
1,2023-12-01,박촌,7961,4149,3812
1,2023-12-01,임학,16543,8285,8258
1,2023-12-01,계산,21696,11116,10580
1,2023-12-01,경인교대입구,11281,5736,5545
1,2023-12-01,작전,28246,14383,13863
1,2023-12-01,갈산,19346,9843,9503
1,2023-12-01,부평구청,13525,6666,6859
1,2023-12-01,부평시장,26900,13399,13501
1,2023-12-01,부평,14206,7010,7196
1,2023-12-01,동수,8377,4309,4068
1,2023-12-01,부평삼거리,5383,2723,2660
1,2023-12-01,간석오거리,21592,11326,10266
1,2023-12-01,인천시청,11568,5964,5604
1,2023-12-01,예술회관,25081,11999,13082
1,2023-12-01,인천터미널,30086,14621,15465
1,2023-12-01,문학경기장,3861,1999,1862
1,2023-12-01,선학,12844,6466,6378
1,2023-12-01,신연수,11199,5764,5435
1,2023-12-01,원인재,5292,2837,2455
1,2023-12-01,동춘,21172,10277,10895
1,2023-12-01,동막,10905,5769,5136
1,2023-12-01,캠퍼스타운,12548,6518,6030
1,2023-12-01,테크노파크,22125,11220,10905
1,2023-12-01,지식정보단지,10453,5149,5304
1,2023-12-01,인천대입구,17419,8830,8589
1,2023-12-01,센트럴파크(재외동포청),7942,3922,4020
1,2023-12-01,국제업무지구,3739,1930,1809
1,2023-12-01,송도달빛축제공원,10122,5109,5013
1,2023-12-02,계양,5807,2739,3068
1,2023-12-02,귤현,1504,685,819
1,2023-12-02,박촌,5389,2880,2509
1,2023-12-02,임학,12143,6200,5943
1,2023-12-02,계산,18339,9168,9171
1,2023-12-02,경인교대입구,9073,4561,4512
1,2023-12-02,작전,21986,11257,10729
1,2023-12-02,갈산,10286,5307,4979
1,2023-12-02,부평구청,10008,4953,5055
1,2023-12-02,부평시장,18864,9418,9446
1,2023-12-02,부평,13179,6608,6571
1,2023-12-02,동수,5168,2641,2527
1,2023-12-02,부평삼거리,4096,1997,2099
1,2023-12-02,간석오거리,15951,8401,7550
1,2023-12-02,인천시청,7611,3872,3739
1,2023-12-02,예술회관,17702,8376,9326
1,2023-12-02,인천터미널,27623,13410,14213
1,2023-12-02,문학경기장,2845,1383,1462
1,2023-12-02,선학,10263,5168,5095
1,2023-12-02,신연수,6280,3270,3010
1,2023-12-02,원인재,3469,1792,1677
1,2023-12-02,동춘,15898,7918,7980
1,2023-12-02,동막,6415,3393,3022
1,2023-12-02,캠퍼스타운,8458,4478,3980
1,2023-12-02,테크노파크,19168,9443,9725
1,2023-12-02,지식정보단지,4211,2181,2030
1,2023-12-02,인천대입구,10904,5397,5507
1,2023-12-02,센트럴파크(재외동포청),7149,3493,3656
1,2023-12-02,국제업무지구,1619,854,765
1,2023-12-02,송도달빛축제공원,7932,4035,3897
1,2023-12-03,계양,4267,1998,2269
1,2023-12-03,귤현,1004,460,544
1,2023-12-03,박촌,4010,2082,1928
1,2023-12-03,임학,8745,4478,4267
1,2023-12-03,계산,12796,6269,6527
1,2023-12-03,경인교대입구,7163,3615,3548
1,2023-12-03,작전,14342,7311,7031
1,2023-12-03,갈산,6457,3294,3163
1,2023-12-03,부평구청,7070,3441,3629
1,2023-12-03,부평시장,14264,7157,7107
1,2023-12-03,부평,8935,4736,4199
1,2023-12-03,동수,3947,2004,1943
1,2023-12-03,부평삼거리,3192,1574,1618
1,2023-12-03,간석오거리,12055,6291,5764
1,2023-12-03,인천시청,5450,2788,2662
1,2023-12-03,예술회관,12084,5863,6221
1,2023-12-03,인천터미널,22155,11179,10976
1,2023-12-03,문학경기장,1923,946,977
1,2023-12-03,선학,7985,3962,4023
1,2023-12-03,신연수,4607,2338,2269
1,2023-12-03,원인재,2238,1167,1071
1,2023-12-03,동춘,11635,5739,5896
1,2023-12-03,동막,4271,2212,2059
1,2023-12-03,캠퍼스타운,6380,3082,3298
1,2023-12-03,테크노파크,15160,7477,7683
1,2023-12-03,지식정보단지,2893,1447,1446
1,2023-12-03,인천대입구,7714,3670,4044
1,2023-12-03,센트럴파크(재외동포청),5039,2430,2609
1,2023-12-03,국제업무지구,766,414,352
1,2023-12-03,송도달빛축제공원,5982,2975,3007
1,2023-12-04,계양,7523,3826,3697
1,2023-12-04,귤현,2473,987,1486
1,2023-12-04,박촌,7809,4119,3690
1,2023-12-04,임학,16128,8178,7950
1,2023-12-04,계산,20889,10631,10258
1,2023-12-04,경인교대입구,11149,5563,5586
1,2023-12-04,작전,27867,14175,13692
1,2023-12-04,갈산,19164,9697,9467
1,2023-12-04,부평구청,13346,6541,6805
1,2023-12-04,부평시장,26743,13374,13369
1,2023-12-04,부평,12692,6419,6273
1,2023-12-04,동수,8271,4193,4078
1,2023-12-04,부평삼거리,5139,2587,2552
1,2023-12-04,간석오거리,21553,11268,10285
1,2023-12-04,인천시청,11001,5574,5427
1,2023-12-04,예술회관,23443,11567,11876
1,2023-12-04,인천터미널,25858,12495,13363
1,2023-12-04,문학경기장,3626,1799,1827
1,2023-12-04,선학,11927,5988,5939
1,2023-12-04,신연수,11512,5803,5709
1,2023-12-04,원인재,5512,2962,2550
1,2023-12-04,동춘,20128,9793,10335
1,2023-12-04,동막,11427,5944,5483
1,2023-12-04,캠퍼스타운,12302,6088,6214
1,2023-12-04,테크노파크,20861,10487,10374
1,2023-12-04,지식정보단지,10541,5172,5369
1,2023-12-04,인천대입구,17438,8630,8808
1,2023-12-04,센트럴파크(재외동포청),7167,3585,3582
1,2023-12-04,국제업무지구,3717,1897,1820
1,2023-12-04,송도달빛축제공원,9993,4999,4994
1,2023-12-05,계양,7949,3981,3968
1,2023-12-05,귤현,2646,1033,1613
1,2023-12-05,박촌,7985,4164,3821
1,2023-12-05,임학,16435,8275,8160
1,2023-12-05,계산,20982,10652,10330
1,2023-12-05,경인교대입구,11208,5675,5533
1,2023-12-05,작전,28937,14682,14255
1,2023-12-05,갈산,19550,9910,9640
1,2023-12-05,부평구청,14043,6890,7153
1,2023-12-05,부평시장,27468,13798,13670
1,2023-12-05,부평,12488,6241,6247
1,2023-12-05,동수,8466,4284,4182
1,2023-12-05,부평삼거리,5313,2655,2658
1,2023-12-05,간석오거리,22009,11454,10555
1,2023-12-05,인천시청,11424,5761,5663
1,2023-12-05,예술회관,23578,11631,11947
1,2023-12-05,인천터미널,26274,12833,13441
1,2023-12-05,문학경기장,3857,1967,1890
1,2023-12-05,선학,12655,6354,6301
1,2023-12-05,신연수,11746,5981,5765
1,2023-12-05,원인재,5696,3039,2657
1,2023-12-05,동춘,20628,10125,10503
1,2023-12-05,동막,10742,5664,5078
1,2023-12-05,캠퍼스타운,12276,6156,6120
1,2023-12-05,테크노파크,21045,10507,10538
1,2023-12-05,지식정보단지,10735,5252,5483
1,2023-12-05,인천대입구,19153,9587,9566
1,2023-12-05,센트럴파크(재외동포청),7993,4023,3970
1,2023-12-05,국제업무지구,3791,1901,1890
1,2023-12-05,송도달빛축제공원,10225,5138,5087
1,2023-12-06,계양,7705,3875,3830
1,2023-12-06,귤현,2507,980,1527
1,2023-12-06,박촌,7944,4148,3796
1,2023-12-06,임학,16275,8216,8059
1,2023-12-06,계산,21175,10763,10412
1,2023-12-06,경인교대입구,10816,5487,5329
1,2023-12-06,작전,27834,14107,13727
1,2023-12-06,갈산,19443,9838,9605
1,2023-12-06,부평구청,13735,6716,7019
1,2023-12-06,부평시장,26388,13175,13213
1,2023-12-06,부평,12406,6219,6187
1,2023-12-06,동수,8229,4171,4058
1,2023-12-06,부평삼거리,4997,2504,2493
1,2023-12-06,간석오거리,21574,11270,10304
1,2023-12-06,인천시청,11260,5669,5591
1,2023-12-06,예술회관,24581,12104,12477
1,2023-12-06,인천터미널,25011,12323,12688
1,2023-12-06,문학경기장,3727,1898,1829
1,2023-12-06,선학,12431,6209,6222
1,2023-12-06,신연수,11289,5739,5550
1,2023-12-06,원인재,5582,2945,2637
1,2023-12-06,동춘,20219,9882,10337
1,2023-12-06,동막,11213,5999,5214
1,2023-12-06,캠퍼스타운,12002,5971,6031
1,2023-12-06,테크노파크,21528,10838,10690
1,2023-12-06,지식정보단지,10695,5219,5476
1,2023-12-06,인천대입구,17257,8642,8615
1,2023-12-06,센트럴파크(재외동포청),7331,3659,3672
1,2023-12-06,국제업무지구,3694,1851,1843
1,2023-12-06,송도달빛축제공원,9897,4936,4961
1,2023-12-07,계양,7908,3978,3930
1,2023-12-07,귤현,2515,981,1534
1,2023-12-07,박촌,7989,4186,3803
1,2023-12-07,임학,16665,8408,8257
1,2023-12-07,계산,21967,11214,10753
1,2023-12-07,경인교대입구,11447,5774,5673
1,2023-12-07,작전,28831,14516,14315
1,2023-12-07,갈산,20074,10199,9875
1,2023-12-07,부평구청,14278,7065,7213
1,2023-12-07,부평시장,27702,13859,13843
1,2023-12-07,부평,12998,6500,6498
1,2023-12-07,동수,8387,4233,4154
1,2023-12-07,부평삼거리,5469,2781,2688
1,2023-12-07,간석오거리,22025,11514,10511
1,2023-12-07,인천시청,11610,5853,5757
1,2023-12-07,예술회관,24732,12115,12617
1,2023-12-07,인천터미널,27575,13615,13960
1,2023-12-07,문학경기장,3861,1953,1908
1,2023-12-07,선학,12661,6368,6293
1,2023-12-07,신연수,11703,5946,5757
1,2023-12-07,원인재,5913,3093,2820
1,2023-12-07,동춘,21185,10395,10790
1,2023-12-07,동막,10735,5609,5126
1,2023-12-07,캠퍼스타운,12785,6607,6178
1,2023-12-07,테크노파크,22028,10927,11101
1,2023-12-07,지식정보단지,10706,5236,5470
1,2023-12-07,인천대입구,17680,8821,8859
1,2023-12-07,센트럴파크(재외동포청),7907,3950,3957
1,2023-12-07,국제업무지구,3874,1989,1885
1,2023-12-07,송도달빛축제공원,10434,5255,5179
1,2023-12-08,계양,8277,4124,4153
1,2023-12-08,귤현,2636,1056,1580
1,2023-12-08,박촌,8167,4307,3860
1,2023-12-08,임학,17244,8721,8523
1,2023-12-08,계산,22207,11398,10809
1,2023-12-08,경인교대입구,11719,5941,5778
1,2023-12-08,작전,29866,15186,14680
1,2023-12-08,갈산,19981,10243,9738
1,2023-12-08,부평구청,14197,7009,7188
1,2023-12-08,부평시장,28471,14150,14321
1,2023-12-08,부평,14737,7063,7674
1,2023-12-08,동수,8574,4408,4166
1,2023-12-08,부평삼거리,5487,2757,2730
1,2023-12-08,간석오거리,22541,11823,10718
1,2023-12-08,인천시청,12396,6264,6132
1,2023-12-08,예술회관,26473,12694,13779
1,2023-12-08,인천터미널,31376,15131,16245
1,2023-12-08,문학경기장,3839,1978,1861
1,2023-12-08,선학,13340,6703,6637
1,2023-12-08,신연수,11578,5986,5592
1,2023-12-08,원인재,5949,3135,2814
1,2023-12-08,동춘,21889,10772,11117
1,2023-12-08,동막,11118,5846,5272
1,2023-12-08,캠퍼스타운,12751,6583,6168
1,2023-12-08,테크노파크,22818,11403,11415
1,2023-12-08,지식정보단지,10522,5125,5397
1,2023-12-08,인천대입구,17429,8756,8673
1,2023-12-08,센트럴파크(재외동포청),8412,4202,4210
1,2023-12-08,국제업무지구,3723,1884,1839
1,2023-12-08,송도달빛축제공원,10885,5541,5344
1,2023-12-09,계양,6590,3162,3428
1,2023-12-09,귤현,1665,795,870
1,2023-12-09,박촌,5963,3190,2773
1,2023-12-09,임학,12757,6545,6212
1,2023-12-09,계산,18699,9350,9349
1,2023-12-09,경인교대입구,9466,4755,4711
1,2023-12-09,작전,23208,12019,11189
1,2023-12-09,갈산,10756,5533,5223
1,2023-12-09,부평구청,10669,5267,5402
1,2023-12-09,부평시장,20020,9983,10037
1,2023-12-09,부평,13860,6733,7127
1,2023-12-09,동수,5584,2873,2711
1,2023-12-09,부평삼거리,4332,2172,2160
1,2023-12-09,간석오거리,17104,8909,8195
1,2023-12-09,인천시청,8176,4190,3986
1,2023-12-09,예술회관,19125,8943,10182
1,2023-12-09,인천터미널,29507,14409,15098
1,2023-12-09,문학경기장,3201,1568,1633
1,2023-12-09,선학,11057,5580,5477
1,2023-12-09,신연수,6492,3413,3079
1,2023-12-09,원인재,3568,1864,1704
1,2023-12-09,동춘,16445,8191,8254
1,2023-12-09,동막,7028,3736,3292
1,2023-12-09,캠퍼스타운,8465,4515,3950
1,2023-12-09,테크노파크,19820,9818,10002
1,2023-12-09,지식정보단지,4458,2299,2159
1,2023-12-09,인천대입구,11796,5831,5965
1,2023-12-09,센트럴파크(재외동포청),7652,3765,3887
1,2023-12-09,국제업무지구,1862,992,870
1,2023-12-09,송도달빛축제공원,8731,4509,4222
1,2023-12-10,계양,4616,2175,2441
1,2023-12-10,귤현,1065,476,589
1,2023-12-10,박촌,4242,2251,1991
1,2023-12-10,임학,9243,4690,4553
1,2023-12-10,계산,13882,6833,7049
1,2023-12-10,경인교대입구,7466,3752,3714
1,2023-12-10,작전,14924,7669,7255
1,2023-12-10,갈산,7095,3689,3406
1,2023-12-10,부평구청,7313,3557,3756
1,2023-12-10,부평시장,14918,7461,7457
1,2023-12-10,부평,9398,4914,4484
1,2023-12-10,동수,4108,2058,2050
1,2023-12-10,부평삼거리,3342,1645,1697
1,2023-12-10,간석오거리,12135,6351,5784
1,2023-12-10,인천시청,5696,2875,2821
1,2023-12-10,예술회관,12466,6027,6439
1,2023-12-10,인천터미널,23510,11810,11700
1,2023-12-10,문학경기장,2022,982,1040
1,2023-12-10,선학,8217,4106,4111
1,2023-12-10,신연수,4647,2379,2268
1,2023-12-10,원인재,2438,1273,1165
1,2023-12-10,동춘,9420,4668,4752
1,2023-12-10,동막,4653,2396,2257
1,2023-12-10,캠퍼스타운,6128,3016,3112
1,2023-12-10,테크노파크,15285,7486,7799
1,2023-12-10,지식정보단지,2784,1381,1403
1,2023-12-10,인천대입구,8243,3960,4283
1,2023-12-10,센트럴파크(재외동포청),4675,2323,2352
1,2023-12-10,국제업무지구,833,420,413
1,2023-12-10,송도달빛축제공원,6264,3147,3117
1,2023-12-11,계양,7268,3660,3608
1,2023-12-11,귤현,2320,915,1405
1,2023-12-11,박촌,7400,3865,3535
1,2023-12-11,임학,15349,7723,7626
1,2023-12-11,계산,19304,9847,9457
1,2023-12-11,경인교대입구,10660,5341,5319
1,2023-12-11,작전,26521,13439,13082
1,2023-12-11,갈산,18796,9506,9290
1,2023-12-11,부평구청,13009,6409,6600
1,2023-12-11,부평시장,25138,12578,12560
1,2023-12-11,부평,12131,6126,6005
1,2023-12-11,동수,8086,4089,3997
1,2023-12-11,부평삼거리,4819,2480,2339
1,2023-12-11,간석오거리,20589,10706,9883
1,2023-12-11,인천시청,10549,5340,5209
1,2023-12-11,예술회관,23527,11714,11813
1,2023-12-11,인천터미널,24257,11715,12542
1,2023-12-11,문학경기장,3546,1767,1779
1,2023-12-11,선학,11300,5636,5664
1,2023-12-11,신연수,10625,5353,5272
1,2023-12-11,원인재,5183,2747,2436
1,2023-12-11,동춘,19046,9255,9791
1,2023-12-11,동막,10103,5383,4720
1,2023-12-11,캠퍼스타운,11350,5630,5720
1,2023-12-11,테크노파크,20197,10134,10063
1,2023-12-11,지식정보단지,10043,4927,5116
1,2023-12-11,인천대입구,16127,8060,8067
1,2023-12-11,센트럴파크(재외동포청),6515,3244,3271
1,2023-12-11,국제업무지구,3596,1858,1738
1,2023-12-11,송도달빛축제공원,9201,4637,4564
1,2023-12-12,계양,7936,4001,3935
1,2023-12-12,귤현,2486,990,1496
1,2023-12-12,박촌,7901,4147,3754
1,2023-12-12,임학,16431,8303,8128
1,2023-12-12,계산,20600,10464,10136
1,2023-12-12,경인교대입구,11252,5650,5602
1,2023-12-12,작전,28704,14572,14132
1,2023-12-12,갈산,19606,9909,9697
1,2023-12-12,부평구청,13849,6731,7118
1,2023-12-12,부평시장,27107,13462,13645
1,2023-12-12,부평,13230,6669,6561
1,2023-12-12,동수,8459,4318,4141
1,2023-12-12,부평삼거리,5290,2650,2640
1,2023-12-12,간석오거리,22109,11512,10597
1,2023-12-12,인천시청,11404,5712,5692
1,2023-12-12,예술회관,24739,12100,12639
1,2023-12-12,인천터미널,26631,13066,13565
1,2023-12-12,문학경기장,3923,2005,1918
1,2023-12-12,선학,12779,6368,6411
1,2023-12-12,신연수,11585,5899,5686
1,2023-12-12,원인재,5463,2903,2560
1,2023-12-12,동춘,20587,10121,10466
1,2023-12-12,동막,11132,5960,5172
1,2023-12-12,캠퍼스타운,11915,5982,5933
1,2023-12-12,테크노파크,21316,10623,10693
1,2023-12-12,지식정보단지,10707,5209,5498
1,2023-12-12,인천대입구,17350,8708,8642
1,2023-12-12,센트럴파크(재외동포청),8103,4025,4078
1,2023-12-12,국제업무지구,3783,1927,1856
1,2023-12-12,송도달빛축제공원,10177,5082,5095
1,2023-12-13,계양,8113,4076,4037
1,2023-12-13,귤현,2521,1013,1508
1,2023-12-13,박촌,8101,4242,3859
1,2023-12-13,임학,16642,8370,8272
1,2023-12-13,계산,20790,10509,10281
1,2023-12-13,경인교대입구,11319,5673,5646
1,2023-12-13,작전,28953,14725,14228
1,2023-12-13,갈산,19872,10026,9846
1,2023-12-13,부평구청,14043,6863,7180
1,2023-12-13,부평시장,27974,14013,13961
1,2023-12-13,부평,13201,6561,6640
1,2023-12-13,동수,8371,4268,4103
1,2023-12-13,부평삼거리,5475,2730,2745
1,2023-12-13,간석오거리,21959,11483,10476
1,2023-12-13,인천시청,11874,5976,5898
1,2023-12-13,예술회관,25634,12657,12977
1,2023-12-13,인천터미널,27204,13413,13791
1,2023-12-13,문학경기장,3797,1924,1873
1,2023-12-13,선학,12977,6493,6484
1,2023-12-13,신연수,11787,6020,5767
1,2023-12-13,원인재,5812,3070,2742
1,2023-12-13,동춘,21562,10563,10999
1,2023-12-13,동막,10937,5817,5120
1,2023-12-13,캠퍼스타운,12090,6116,5974
1,2023-12-13,테크노파크,22271,11169,11102
1,2023-12-13,지식정보단지,10690,5261,5429
1,2023-12-13,인천대입구,17822,8982,8840
1,2023-12-13,센트럴파크(재외동포청),7787,3913,3874
1,2023-12-13,국제업무지구,3822,1972,1850
1,2023-12-13,송도달빛축제공원,10683,5325,5358
1,2023-12-14,계양,7643,3833,3810
1,2023-12-14,귤현,2446,987,1459
1,2023-12-14,박촌,7904,4089,3815
1,2023-12-14,임학,16120,8099,8021
1,2023-12-14,계산,19848,10080,9768
1,2023-12-14,경인교대입구,11293,5707,5586
1,2023-12-14,작전,27545,13912,13633
1,2023-12-14,갈산,19377,9852,9525
1,2023-12-14,부평구청,13537,6627,6910
1,2023-12-14,부평시장,26464,13197,13267
1,2023-12-14,부평,13086,6623,6463
1,2023-12-14,동수,8225,4136,4089
1,2023-12-14,부평삼거리,5006,2532,2474
1,2023-12-14,간석오거리,21268,11080,10188
1,2023-12-14,인천시청,10924,5493,5431
1,2023-12-14,예술회관,23825,11697,12128
1,2023-12-14,인천터미널,26210,13070,13140
1,2023-12-14,문학경기장,3556,1798,1758
1,2023-12-14,선학,12511,6220,6291
1,2023-12-14,신연수,11046,5589,5457
1,2023-12-14,원인재,5394,2832,2562
1,2023-12-14,동춘,20441,9971,10470
1,2023-12-14,동막,10919,5766,5153
1,2023-12-14,캠퍼스타운,11929,6076,5853
1,2023-12-14,테크노파크,22156,11087,11069
1,2023-12-14,지식정보단지,10319,4966,5353
1,2023-12-14,인천대입구,17475,8810,8665
1,2023-12-14,센트럴파크(재외동포청),7866,3912,3954
1,2023-12-14,국제업무지구,3672,1862,1810
1,2023-12-14,송도달빛축제공원,9760,4908,4852
1,2023-12-15,계양,7769,3818,3951
1,2023-12-15,귤현,2349,947,1402
1,2023-12-15,박촌,7756,4066,3690
1,2023-12-15,임학,16283,8195,8088
1,2023-12-15,계산,20414,10372,10042
1,2023-12-15,경인교대입구,11974,6042,5932
1,2023-12-15,작전,27972,14219,13753
1,2023-12-15,갈산,19217,9738,9479
1,2023-12-15,부평구청,13438,6600,6838
1,2023-12-15,부평시장,26925,13443,13482
1,2023-12-15,부평,14574,7144,7430
1,2023-12-15,동수,8163,4175,3988
1,2023-12-15,부평삼거리,4808,2476,2332
1,2023-12-15,간석오거리,21401,11240,10161
1,2023-12-15,인천시청,11600,5857,5743
1,2023-12-15,예술회관,25457,12157,13300
1,2023-12-15,인천터미널,30352,14864,15488
1,2023-12-15,문학경기장,3673,1921,1752
1,2023-12-15,선학,12944,6566,6378
1,2023-12-15,신연수,10747,5441,5306
1,2023-12-15,원인재,5479,2845,2634
1,2023-12-15,동춘,20859,10169,10690
1,2023-12-15,동막,10715,5629,5086
1,2023-12-15,캠퍼스타운,11759,6118,5641
1,2023-12-15,테크노파크,22957,11439,11518
1,2023-12-15,지식정보단지,10189,5024,5165
1,2023-12-15,인천대입구,16297,8172,8125
1,2023-12-15,센트럴파크(재외동포청),8076,4011,4065
1,2023-12-15,국제업무지구,3691,1914,1777
1,2023-12-15,송도달빛축제공원,10336,5230,5106
1,2023-12-16,계양,6048,2888,3160
1,2023-12-16,귤현,1598,753,845
1,2023-12-16,박촌,5831,3093,2738
1,2023-12-16,임학,12789,6518,6271
1,2023-12-16,계산,18784,9432,9352
1,2023-12-16,경인교대입구,9399,4744,4655
1,2023-12-16,작전,23106,11771,11335
1,2023-12-16,갈산,10674,5494,5180
1,2023-12-16,부평구청,10636,5199,5437
1,2023-12-16,부평시장,19937,9916,10021
1,2023-12-16,부평,14476,7256,7220
1,2023-12-16,동수,5685,2922,2763
1,2023-12-16,부평삼거리,4238,2123,2115
1,2023-12-16,간석오거리,16861,8741,8120
1,2023-12-16,인천시청,7720,4002,3718
1,2023-12-16,예술회관,19323,9063,10260
1,2023-12-16,인천터미널,30821,15067,15754
1,2023-12-16,문학경기장,2820,1395,1425
1,2023-12-16,선학,11071,5635,5436
1,2023-12-16,신연수,6176,3263,2913
1,2023-12-16,원인재,3620,1914,1706
1,2023-12-16,동춘,16344,8210,8134
1,2023-12-16,동막,7236,3816,3420
1,2023-12-16,캠퍼스타운,8758,4580,4178
1,2023-12-16,테크노파크,19589,9661,9928
1,2023-12-16,지식정보단지,4569,2340,2229
1,2023-12-16,인천대입구,12254,5963,6291
1,2023-12-16,센트럴파크(재외동포청),7102,3423,3679
1,2023-12-16,국제업무지구,1835,1010,825
1,2023-12-16,송도달빛축제공원,8005,4077,3928
1,2023-12-17,계양,3783,1698,2085
1,2023-12-17,귤현,992,447,545
1,2023-12-17,박촌,3842,1979,1863
1,2023-12-17,임학,8370,4189,4181
1,2023-12-17,계산,11823,5860,5963
1,2023-12-17,경인교대입구,6887,3534,3353
1,2023-12-17,작전,14111,7162,6949
1,2023-12-17,갈산,6156,3212,2944
1,2023-12-17,부평구청,6705,3247,3458
1,2023-12-17,부평시장,13488,6748,6740
1,2023-12-17,부평,9498,5077,4421
1,2023-12-17,동수,3971,2015,1956
1,2023-12-17,부평삼거리,2699,1347,1352
1,2023-12-17,간석오거리,11464,6032,5432
1,2023-12-17,인천시청,4888,2499,2389
1,2023-12-17,예술회관,11392,5466,5926
1,2023-12-17,인천터미널,22392,11210,11182
1,2023-12-17,문학경기장,1311,647,664
1,2023-12-17,선학,7738,3843,3895
1,2023-12-17,신연수,4241,2190,2051
1,2023-12-17,원인재,2124,1099,1025
1,2023-12-17,동춘,11006,5384,5622
1,2023-12-17,동막,4380,2205,2175
1,2023-12-17,캠퍼스타운,5579,2751,2828
1,2023-12-17,테크노파크,15066,7528,7538
1,2023-12-17,지식정보단지,2745,1347,1398
1,2023-12-17,인천대입구,7678,3751,3927
1,2023-12-17,센트럴파크(재외동포청),4934,2394,2540
1,2023-12-17,국제업무지구,698,374,324
1,2023-12-17,송도달빛축제공원,5504,2701,2803
1,2023-12-18,계양,7193,3567,3626
1,2023-12-18,귤현,2201,896,1305
1,2023-12-18,박촌,7415,3894,3521
1,2023-12-18,임학,15203,7706,7497
1,2023-12-18,계산,18454,9340,9114
1,2023-12-18,경인교대입구,10031,5047,4984
1,2023-12-18,작전,26734,13641,13093
1,2023-12-18,갈산,18756,9418,9338
1,2023-12-18,부평구청,12795,6254,6541
1,2023-12-18,부평시장,25598,12777,12821
1,2023-12-18,부평,12788,6510,6278
1,2023-12-18,동수,8056,4105,3951
1,2023-12-18,부평삼거리,4756,2415,2341
1,2023-12-18,간석오거리,20410,10603,9807
1,2023-12-18,인천시청,10680,5439,5241
1,2023-12-18,예술회관,23360,11549,11811
1,2023-12-18,인천터미널,26210,12741,13469
1,2023-12-18,문학경기장,3542,1762,1780
1,2023-12-18,선학,11721,5821,5900
1,2023-12-18,신연수,10442,5366,5076
1,2023-12-18,원인재,4990,2633,2357
1,2023-12-18,동춘,19451,9494,9957
1,2023-12-18,동막,9987,5311,4676
1,2023-12-18,캠퍼스타운,11419,5719,5700
1,2023-12-18,테크노파크,21061,10588,10473
1,2023-12-18,지식정보단지,9578,4604,4974
1,2023-12-18,인천대입구,14795,7242,7553
1,2023-12-18,센트럴파크(재외동포청),6998,3516,3482
1,2023-12-18,국제업무지구,3712,1920,1792
1,2023-12-18,송도달빛축제공원,9405,4734,4671
1,2023-12-19,계양,7557,3826,3731
1,2023-12-19,귤현,2302,928,1374
1,2023-12-19,박촌,7746,4026,3720
1,2023-12-19,임학,16280,8194,8086
1,2023-12-19,계산,19543,9888,9655
1,2023-12-19,경인교대입구,10475,5249,5226
1,2023-12-19,작전,28242,14317,13925
1,2023-12-19,갈산,19422,9794,9628
1,2023-12-19,부평구청,13901,6748,7153
1,2023-12-19,부평시장,27146,13521,13625
1,2023-12-19,부평,13080,6625,6455
1,2023-12-19,동수,8225,4167,4058
1,2023-12-19,부평삼거리,5100,2569,2531
1,2023-12-19,간석오거리,21935,11416,10519
1,2023-12-19,인천시청,11200,5637,5563
1,2023-12-19,예술회관,24684,12221,12463
1,2023-12-19,인천터미널,27033,13205,13828
1,2023-12-19,문학경기장,3598,1812,1786
1,2023-12-19,선학,12594,6260,6334
1,2023-12-19,신연수,10865,5577,5288
1,2023-12-19,원인재,5292,2782,2510
1,2023-12-19,동춘,20769,10153,10616
1,2023-12-19,동막,11001,5839,5162
1,2023-12-19,캠퍼스타운,11798,5932,5866
1,2023-12-19,테크노파크,22044,11156,10888
1,2023-12-19,지식정보단지,10012,4763,5249
1,2023-12-19,인천대입구,15521,7737,7784
1,2023-12-19,센트럴파크(재외동포청),7644,3822,3822
1,2023-12-19,국제업무지구,3755,1914,1841
1,2023-12-19,송도달빛축제공원,9871,4940,4931
1,2023-12-20,계양,7947,4001,3946
1,2023-12-20,귤현,2417,997,1420
1,2023-12-20,박촌,8525,4490,4035
1,2023-12-20,임학,16464,8326,8138
1,2023-12-20,계산,19979,10151,9828
1,2023-12-20,경인교대입구,10842,5460,5382
1,2023-12-20,작전,28499,14469,14030
1,2023-12-20,갈산,20304,10258,10046
1,2023-12-20,부평구청,14090,6891,7199
1,2023-12-20,부평시장,26960,13484,13476
1,2023-12-20,부평,13927,7041,6886
1,2023-12-20,동수,8580,4333,4247
1,2023-12-20,부평삼거리,5105,2594,2511
1,2023-12-20,간석오거리,22128,11495,10633
1,2023-12-20,인천시청,11826,5959,5867
1,2023-12-20,예술회관,25681,12643,13038
1,2023-12-20,인천터미널,27853,13673,14180
1,2023-12-20,문학경기장,3518,1822,1696
1,2023-12-20,선학,12997,6526,6471
1,2023-12-20,신연수,11357,5731,5626
1,2023-12-20,원인재,5044,2635,2409
1,2023-12-20,동춘,21972,10624,11348
1,2023-12-20,동막,11468,6064,5404
1,2023-12-20,캠퍼스타운,12894,6539,6355
1,2023-12-20,테크노파크,22913,11437,11476
1,2023-12-20,지식정보단지,10511,5016,5495
1,2023-12-20,인천대입구,15355,7617,7738
1,2023-12-20,센트럴파크(재외동포청),7691,3881,3810
1,2023-12-20,국제업무지구,4004,2045,1959
1,2023-12-20,송도달빛축제공원,10380,5256,5124
1,2023-12-21,계양,7060,3457,3603
1,2023-12-21,귤현,2185,882,1303
1,2023-12-21,박촌,7433,3835,3598
1,2023-12-21,임학,15058,7612,7446
1,2023-12-21,계산,18404,9381,9023
1,2023-12-21,경인교대입구,10156,5071,5085
1,2023-12-21,작전,26498,13477,13021
1,2023-12-21,갈산,18800,9437,9363
1,2023-12-21,부평구청,12651,6188,6463
1,2023-12-21,부평시장,25374,12637,12737
1,2023-12-21,부평,12883,6618,6265
1,2023-12-21,동수,7704,3932,3772
1,2023-12-21,부평삼거리,4562,2302,2260
1,2023-12-21,간석오거리,20496,10619,9877
1,2023-12-21,인천시청,10685,5409,5276
1,2023-12-21,예술회관,23463,11533,11930
1,2023-12-21,인천터미널,25791,12682,13109
1,2023-12-21,문학경기장,3273,1659,1614
1,2023-12-21,선학,11966,5968,5998
1,2023-12-21,신연수,10461,5347,5114
1,2023-12-21,원인재,4543,2393,2150
1,2023-12-21,동춘,20468,10010,10458
1,2023-12-21,동막,10553,5528,5025
1,2023-12-21,캠퍼스타운,11434,5834,5600
1,2023-12-21,테크노파크,21327,10655,10672
1,2023-12-21,지식정보단지,9588,4601,4987
1,2023-12-21,인천대입구,14183,7125,7058
1,2023-12-21,센트럴파크(재외동포청),7156,3578,3578
1,2023-12-21,국제업무지구,3658,1836,1822
1,2023-12-21,송도달빛축제공원,9256,4606,4650
1,2023-12-22,계양,7306,3625,3681
1,2023-12-22,귤현,2228,936,1292
1,2023-12-22,박촌,7840,4142,3698
1,2023-12-22,임학,15611,7887,7724
1,2023-12-22,계산,19056,9675,9381
1,2023-12-22,경인교대입구,10811,5367,5444
1,2023-12-22,작전,27223,13926,13297
1,2023-12-22,갈산,19050,9615,9435
1,2023-12-22,부평구청,13007,6434,6573
1,2023-12-22,부평시장,26178,13030,13148
1,2023-12-22,부평,14972,7443,7529
1,2023-12-22,동수,8023,4073,3950
1,2023-12-22,부평삼거리,5110,2645,2465
1,2023-12-22,간석오거리,21263,11168,10095
1,2023-12-22,인천시청,10643,5390,5253
1,2023-12-22,예술회관,25264,12097,13167
1,2023-12-22,인천터미널,30038,14689,15349
1,2023-12-22,문학경기장,3349,1737,1612
1,2023-12-22,선학,12840,6473,6367
1,2023-12-22,신연수,10471,5339,5132
1,2023-12-22,원인재,5041,2655,2386
1,2023-12-22,동춘,21565,10424,11141
1,2023-12-22,동막,10452,5585,4867
1,2023-12-22,캠퍼스타운,11724,6011,5713
1,2023-12-22,테크노파크,23057,11431,11626
1,2023-12-22,지식정보단지,9284,4536,4748
1,2023-12-22,인천대입구,14296,7078,7218
1,2023-12-22,센트럴파크(재외동포청),7820,3786,4034
1,2023-12-22,국제업무지구,3593,1872,1721
1,2023-12-22,송도달빛축제공원,9741,4972,4769
1,2023-12-23,계양,5374,2529,2845
1,2023-12-23,귤현,1327,613,714
1,2023-12-23,박촌,5169,2757,2412
1,2023-12-23,임학,11645,5964,5681
1,2023-12-23,계산,15670,7911,7759
1,2023-12-23,경인교대입구,8649,4333,4316
1,2023-12-23,작전,20941,10778,10163
1,2023-12-23,갈산,9453,4893,4560
1,2023-12-23,부평구청,9534,4711,4823
1,2023-12-23,부평시장,18024,9049,8975
1,2023-12-23,부평,13565,6771,6794
1,2023-12-23,동수,5376,2757,2619
1,2023-12-23,부평삼거리,3747,1899,1848
1,2023-12-23,간석오거리,16143,8470,7673
1,2023-12-23,인천시청,6746,3463,3283
1,2023-12-23,예술회관,17530,8337,9193
1,2023-12-23,인천터미널,29482,14278,15204
1,2023-12-23,문학경기장,2385,1157,1228
1,2023-12-23,선학,10291,5246,5045
1,2023-12-23,신연수,6000,3112,2888
1,2023-12-23,원인재,3067,1599,1468
1,2023-12-23,동춘,16370,8116,8254
1,2023-12-23,동막,6809,3471,3338
1,2023-12-23,캠퍼스타운,7542,3951,3591
1,2023-12-23,테크노파크,20995,10454,10541
1,2023-12-23,지식정보단지,3941,2032,1909
1,2023-12-23,인천대입구,11994,6002,5992
1,2023-12-23,센트럴파크(재외동포청),7151,3529,3622
1,2023-12-23,국제업무지구,1687,923,764
1,2023-12-23,송도달빛축제공원,7530,3775,3755
1,2023-12-24,계양,4230,1891,2339
1,2023-12-24,귤현,1047,472,575
1,2023-12-24,박촌,4672,2434,2238
1,2023-12-24,임학,9890,5101,4789
1,2023-12-24,계산,13085,6638,6447
1,2023-12-24,경인교대입구,7568,3836,3732
1,2023-12-24,작전,15755,8111,7644
1,2023-12-24,갈산,6999,3683,3316
1,2023-12-24,부평구청,7387,3647,3740
1,2023-12-24,부평시장,15560,7759,7801
1,2023-12-24,부평,12329,6254,6075
1,2023-12-24,동수,4318,2227,2091
1,2023-12-24,부평삼거리,3370,1740,1630
1,2023-12-24,간석오거리,13728,7097,6631
1,2023-12-24,인천시청,5719,2960,2759
1,2023-12-24,예술회관,14648,6899,7749
1,2023-12-24,인천터미널,27067,13298,13769
1,2023-12-24,문학경기장,1279,621,658
1,2023-12-24,선학,8680,4389,4291
1,2023-12-24,신연수,4828,2542,2286
1,2023-12-24,원인재,2371,1215,1156
1,2023-12-24,동춘,12083,6008,6075
1,2023-12-24,동막,4975,2628,2347
1,2023-12-24,캠퍼스타운,6019,3054,2965
1,2023-12-24,테크노파크,23875,11889,11986
1,2023-12-24,지식정보단지,3020,1530,1490
1,2023-12-24,인천대입구,9249,4487,4762
1,2023-12-24,센트럴파크(재외동포청),5756,2803,2953
1,2023-12-24,국제업무지구,837,457,380
1,2023-12-24,송도달빛축제공원,7190,3526,3664
1,2023-12-25,계양,4391,1970,2421
1,2023-12-25,귤현,977,432,545
1,2023-12-25,박촌,4576,2382,2194
1,2023-12-25,임학,9543,4859,4684
1,2023-12-25,계산,12346,6159,6187
1,2023-12-25,경인교대입구,7241,3651,3590
1,2023-12-25,작전,15926,8166,7760
1,2023-12-25,갈산,7103,3680,3423
1,2023-12-25,부평구청,7290,3547,3743
1,2023-12-25,부평시장,14554,7222,7332
1,2023-12-25,부평,12027,6216,5811
1,2023-12-25,동수,4365,2207,2158
1,2023-12-25,부평삼거리,3108,1561,1547
1,2023-12-25,간석오거리,13432,7016,6416
1,2023-12-25,인천시청,5480,2797,2683
1,2023-12-25,예술회관,14735,6929,7806
1,2023-12-25,인천터미널,27227,13664,13563
1,2023-12-25,문학경기장,1455,747,708
1,2023-12-25,선학,8422,4192,4230
1,2023-12-25,신연수,5110,2580,2530
1,2023-12-25,원인재,2471,1291,1180
1,2023-12-25,동춘,15329,7691,7638
1,2023-12-25,동막,4935,2620,2315
1,2023-12-25,캠퍼스타운,6692,3433,3259
1,2023-12-25,테크노파크,25298,12652,12646
1,2023-12-25,지식정보단지,2972,1476,1496
1,2023-12-25,인천대입구,9551,4577,4974
1,2023-12-25,센트럴파크(재외동포청),5989,2906,3083
1,2023-12-25,국제업무지구,1408,728,680
1,2023-12-25,송도달빛축제공원,7343,3702,3641
1,2023-12-26,계양,7597,3781,3816
1,2023-12-26,귤현,2299,917,1382
1,2023-12-26,박촌,7714,4055,3659
1,2023-12-26,임학,15573,7855,7718
1,2023-12-26,계산,18561,9456,9105
1,2023-12-26,경인교대입구,10110,5110,5000
1,2023-12-26,작전,27322,13847,13475
1,2023-12-26,갈산,18681,9431,9250
1,2023-12-26,부평구청,13391,6601,6790
1,2023-12-26,부평시장,26667,13340,13327
1,2023-12-26,부평,12984,6560,6424
1,2023-12-26,동수,8044,4113,3931
1,2023-12-26,부평삼거리,5060,2544,2516
1,2023-12-26,간석오거리,20841,10859,9982
1,2023-12-26,인천시청,10521,5307,5214
1,2023-12-26,예술회관,23996,11886,12110
1,2023-12-26,인천터미널,27721,13561,14160
1,2023-12-26,문학경기장,3494,1731,1763
1,2023-12-26,선학,12514,6244,6270
1,2023-12-26,신연수,10927,5594,5333
1,2023-12-26,원인재,4917,2577,2340
1,2023-12-26,동춘,20499,10133,10366
1,2023-12-26,동막,10146,5365,4781
1,2023-12-26,캠퍼스타운,11056,5572,5484
1,2023-12-26,테크노파크,20766,10319,10447
1,2023-12-26,지식정보단지,9329,4496,4833
1,2023-12-26,인천대입구,13598,6816,6782
1,2023-12-26,센트럴파크(재외동포청),7320,3682,3638
1,2023-12-26,국제업무지구,3841,1965,1876
1,2023-12-26,송도달빛축제공원,9821,5007,4814
1,2023-12-27,계양,7556,3754,3802
1,2023-12-27,귤현,2410,999,1411
1,2023-12-27,박촌,7903,4119,3784
1,2023-12-27,임학,16193,8247,7946
1,2023-12-27,계산,19481,9795,9686
1,2023-12-27,경인교대입구,10474,5219,5255
1,2023-12-27,작전,28501,14527,13974
1,2023-12-27,갈산,19395,9807,9588
1,2023-12-27,부평구청,13290,6545,6745
1,2023-12-27,부평시장,27445,13632,13813
1,2023-12-27,부평,13703,6904,6799
1,2023-12-27,동수,8176,4142,4034
1,2023-12-27,부평삼거리,5072,2536,2536
1,2023-12-27,간석오거리,21221,11058,10163
1,2023-12-27,인천시청,11306,5728,5578
1,2023-12-27,예술회관,24584,12014,12570
1,2023-12-27,인천터미널,27636,13515,14121
1,2023-12-27,문학경기장,3715,1881,1834
1,2023-12-27,선학,12820,6445,6375
1,2023-12-27,신연수,10729,5519,5210
1,2023-12-27,원인재,5199,2745,2454
1,2023-12-27,동춘,20524,10004,10520
1,2023-12-27,동막,11325,6079,5246
1,2023-12-27,캠퍼스타운,11371,5758,5613
1,2023-12-27,테크노파크,21412,10640,10772
1,2023-12-27,지식정보단지,9552,4664,4888
1,2023-12-27,인천대입구,14127,7026,7101
1,2023-12-27,센트럴파크(재외동포청),7255,3642,3613
1,2023-12-27,국제업무지구,4065,2055,2010
1,2023-12-27,송도달빛축제공원,10176,5095,5081
1,2023-12-28,계양,7467,3727,3740
1,2023-12-28,귤현,2293,951,1342
1,2023-12-28,박촌,7678,4028,3650
1,2023-12-28,임학,15896,7999,7897
1,2023-12-28,계산,19236,9736,9500
1,2023-12-28,경인교대입구,10764,5431,5333
1,2023-12-28,작전,27908,14307,13601
1,2023-12-28,갈산,18955,9542,9413
1,2023-12-28,부평구청,13092,6409,6683
1,2023-12-28,부평시장,27060,13599,13461
1,2023-12-28,부평,13719,6947,6772
1,2023-12-28,동수,8031,4068,3963
1,2023-12-28,부평삼거리,5106,2615,2491
1,2023-12-28,간석오거리,21157,11054,10103
1,2023-12-28,인천시청,11236,5669,5567
1,2023-12-28,예술회관,24426,11835,12591
1,2023-12-28,인천터미널,28142,13781,14361
1,2023-12-28,문학경기장,3456,1782,1674
1,2023-12-28,선학,12654,6402,6252
1,2023-12-28,신연수,10413,5318,5095
1,2023-12-28,원인재,5175,2707,2468
1,2023-12-28,동춘,20158,9845,10313
1,2023-12-28,동막,10226,5457,4769
1,2023-12-28,캠퍼스타운,11104,5625,5479
1,2023-12-28,테크노파크,21381,10612,10769
1,2023-12-28,지식정보단지,9225,4430,4795
1,2023-12-28,인천대입구,13421,6680,6741
1,2023-12-28,센트럴파크(재외동포청),7402,3673,3729
1,2023-12-28,국제업무지구,3895,1935,1960
1,2023-12-28,송도달빛축제공원,9901,4982,4919
1,2023-12-29,계양,7522,3781,3741
1,2023-12-29,귤현,2293,931,1362
1,2023-12-29,박촌,8063,4245,3818
1,2023-12-29,임학,16277,8243,8034
1,2023-12-29,계산,19665,9907,9758
1,2023-12-29,경인교대입구,10892,5521,5371
1,2023-12-29,작전,28589,14630,13959
1,2023-12-29,갈산,18283,9313,8970
1,2023-12-29,부평구청,13238,6562,6676
1,2023-12-29,부평시장,27474,13667,13807
1,2023-12-29,부평,15370,7574,7796
1,2023-12-29,동수,8031,4081,3950
1,2023-12-29,부평삼거리,5222,2664,2558
1,2023-12-29,간석오거리,21454,11273,10181
1,2023-12-29,인천시청,10633,5399,5234
1,2023-12-29,예술회관,25234,11920,13314
1,2023-12-29,인천터미널,31780,15213,16567
1,2023-12-29,문학경기장,3345,1690,1655
1,2023-12-29,선학,13074,6532,6542
1,2023-12-29,신연수,10197,5250,4947
1,2023-12-29,원인재,4919,2570,2349
1,2023-12-29,동춘,20476,10026,10450
1,2023-12-29,동막,9985,5378,4607
1,2023-12-29,캠퍼스타운,11153,5717,5436
1,2023-12-29,테크노파크,21829,10897,10932
1,2023-12-29,지식정보단지,8603,4284,4319
1,2023-12-29,인천대입구,14026,7048,6978
1,2023-12-29,센트럴파크(재외동포청),7963,3974,3989
1,2023-12-29,국제업무지구,3482,1807,1675
1,2023-12-29,송도달빛축제공원,10183,5215,4968
1,2023-12-30,계양,5216,2555,2661
1,2023-12-30,귤현,1458,677,781
1,2023-12-30,박촌,5394,2890,2504
1,2023-12-30,임학,11439,5861,5578
1,2023-12-30,계산,14476,7339,7137
1,2023-12-30,경인교대입구,8067,4013,4054
1,2023-12-30,작전,20167,10252,9915
1,2023-12-30,갈산,8695,4444,4251
1,2023-12-30,부평구청,8919,4332,4587
1,2023-12-30,부평시장,17186,8600,8586
1,2023-12-30,부평,12652,6422,6230
1,2023-12-30,동수,4920,2533,2387
1,2023-12-30,부평삼거리,3615,1798,1817
1,2023-12-30,간석오거리,15027,7749,7278
1,2023-12-30,인천시청,6428,3371,3057
1,2023-12-30,예술회관,16561,7636,8925
1,2023-12-30,인천터미널,27745,13236,14509
1,2023-12-30,문학경기장,2147,1081,1066
1,2023-12-30,선학,9767,4935,4832
1,2023-12-30,신연수,5425,2821,2604
1,2023-12-30,원인재,2741,1383,1358
1,2023-12-30,동춘,14245,6989,7256
1,2023-12-30,동막,6007,3175,2832
1,2023-12-30,캠퍼스타운,7089,3673,3416
1,2023-12-30,테크노파크,17946,8851,9095
1,2023-12-30,지식정보단지,3626,1807,1819
1,2023-12-30,인천대입구,11084,5491,5593
1,2023-12-30,센트럴파크(재외동포청),6326,3139,3187
1,2023-12-30,국제업무지구,1599,869,730
1,2023-12-30,송도달빛축제공원,7106,3445,3661
1,2023-12-31,계양,3985,1915,2070
1,2023-12-31,귤현,978,445,533
1,2023-12-31,박촌,4018,2189,1829
1,2023-12-31,임학,8837,4519,4318
1,2023-12-31,계산,11377,5838,5539
1,2023-12-31,경인교대입구,6937,3442,3495
1,2023-12-31,작전,14155,7289,6866
1,2023-12-31,갈산,6110,3220,2890
1,2023-12-31,부평구청,6711,3301,3410
1,2023-12-31,부평시장,14324,7172,7152
1,2023-12-31,부평,10377,5076,5301
1,2023-12-31,동수,4106,2151,1955
1,2023-12-31,부평삼거리,3487,1777,1710
1,2023-12-31,간석오거리,12647,6700,5947
1,2023-12-31,인천시청,5082,2687,2395
1,2023-12-31,예술회관,15863,7151,8712
1,2023-12-31,인천터미널,23571,11326,12245
1,2023-12-31,문학경기장,1160,574,586
1,2023-12-31,선학,8016,4041,3975
1,2023-12-31,신연수,4459,2387,2072
1,2023-12-31,원인재,2313,1162,1151
1,2023-12-31,동춘,12223,6092,6131
1,2023-12-31,동막,4301,2313,1988
1,2023-12-31,캠퍼스타운,5438,2856,2582
1,2023-12-31,테크노파크,15886,7841,8045
1,2023-12-31,지식정보단지,2572,1350,1222
1,2023-12-31,인천대입구,7684,3755,3929
1,2023-12-31,센트럴파크(재외동포청),5555,2748,2807
1,2023-12-31,국제업무지구,627,322,305
1,2023-12-31,송도달빛축제공원,6119,3033,3086
1,2024-01-01,계양,3620,1626,1994
1,2024-01-01,귤현,799,381,418
1,2024-01-01,박촌,3134,1640,1494
1,2024-01-01,임학,7151,3608,3543
1,2024-01-01,계산,12883,6293,6590
1,2024-01-01,경인교대입구,5229,2640,2589
1,2024-01-01,작전,11084,5537,5547
1,2024-01-01,갈산,5159,2623,2536
1,2024-01-01,부평구청,5679,2789,2890
1,2024-01-01,부평시장,11157,5493,5664
1,2024-01-01,부평,7751,4151,3600
1,2024-01-01,동수,2945,1485,1460
1,2024-01-01,부평삼거리,4461,2216,2245
1,2024-01-01,간석오거리,10626,5520,5106
1,2024-01-01,인천시청,4121,2063,2058
1,2024-01-01,예술회관,10164,5064,5100
1,2024-01-01,인천터미널,16711,8902,7809
1,2024-01-01,문학경기장,973,496,477
1,2024-01-01,선학,6782,3216,3566
1,2024-01-01,신연수,3578,1789,1789
1,2024-01-01,원인재,1868,975,893
1,2024-01-01,동춘,10768,5298,5470
1,2024-01-01,동막,3492,1857,1635
1,2024-01-01,캠퍼스타운,4365,2128,2237
1,2024-01-01,테크노파크,13690,6815,6875
1,2024-01-01,지식정보단지,2153,980,1173
1,2024-01-01,인천대입구,5964,2871,3093
1,2024-01-01,센트럴파크(재외동포청),3592,1788,1804
1,2024-01-01,국제업무지구,497,286,211
1,2024-01-01,송도달빛축제공원,5227,2586,2641
1,2024-01-02,계양,6969,3478,3491
1,2024-01-02,귤현,2224,904,1320
1,2024-01-02,박촌,7035,3651,3384
1,2024-01-02,임학,15097,7628,7469
1,2024-01-02,계산,17238,8750,8488
1,2024-01-02,경인교대입구,9635,4831,4804
1,2024-01-02,작전,26303,13344,12959
1,2024-01-02,갈산,17891,9006,8885
1,2024-01-02,부평구청,12487,6109,6378
1,2024-01-02,부평시장,25596,12823,12773
1,2024-01-02,부평,12342,6234,6108
1,2024-01-02,동수,7778,3959,3819
1,2024-01-02,부평삼거리,4432,2209,2223
1,2024-01-02,간석오거리,19750,10250,9500
1,2024-01-02,인천시청,10451,5321,5130
1,2024-01-02,예술회관,22578,11039,11539
1,2024-01-02,인천터미널,25735,12653,13082
1,2024-01-02,문학경기장,3513,1762,1751
1,2024-01-02,선학,11292,5701,5591
1,2024-01-02,신연수,10165,5196,4969
1,2024-01-02,원인재,5082,2703,2379
1,2024-01-02,동춘,19014,9345,9669
1,2024-01-02,동막,9553,5054,4499
1,2024-01-02,캠퍼스타운,10555,5321,5234
1,2024-01-02,테크노파크,19619,9781,9838
1,2024-01-02,지식정보단지,9157,4512,4645
1,2024-01-02,인천대입구,12555,6163,6392
1,2024-01-02,센트럴파크(재외동포청),6933,3482,3451
1,2024-01-02,국제업무지구,3677,1866,1811
1,2024-01-02,송도달빛축제공원,9430,4799,4631
1,2024-01-03,계양,7084,3542,3542
1,2024-01-03,귤현,2254,877,1377
1,2024-01-03,박촌,7218,3792,3426
1,2024-01-03,임학,15304,7750,7554
1,2024-01-03,계산,17841,9061,8780
1,2024-01-03,경인교대입구,10170,5107,5063
1,2024-01-03,작전,26518,13434,13084
1,2024-01-03,갈산,18724,9443,9281
1,2024-01-03,부평구청,12517,6168,6349
1,2024-01-03,부평시장,25777,12893,12884
1,2024-01-03,부평,13009,6552,6457
1,2024-01-03,동수,8106,4105,4001
1,2024-01-03,부평삼거리,4578,2284,2294
1,2024-01-03,간석오거리,20635,10611,10024
1,2024-01-03,인천시청,10563,5319,5244
1,2024-01-03,예술회관,22884,11243,11641
1,2024-01-03,인천터미널,25008,12323,12685
1,2024-01-03,문학경기장,3405,1726,1679
1,2024-01-03,선학,11670,5771,5899
1,2024-01-03,신연수,10335,5280,5055
1,2024-01-03,원인재,5210,2809,2401
1,2024-01-03,동춘,19444,9547,9897
1,2024-01-03,동막,10231,5477,4754
1,2024-01-03,캠퍼스타운,10760,5419,5341
1,2024-01-03,테크노파크,20860,10422,10438
1,2024-01-03,지식정보단지,9655,4711,4944
1,2024-01-03,인천대입구,13089,6516,6573
1,2024-01-03,센트럴파크(재외동포청),7068,3543,3525
1,2024-01-03,국제업무지구,3865,2012,1853
1,2024-01-03,송도달빛축제공원,9674,4845,4829
1,2024-01-04,계양,7362,3693,3669
1,2024-01-04,귤현,2236,883,1353
1,2024-01-04,박촌,7257,3793,3464
1,2024-01-04,임학,15549,7795,7754
1,2024-01-04,계산,18506,9271,9235
1,2024-01-04,경인교대입구,10275,5146,5129
1,2024-01-04,작전,26938,13634,13304
1,2024-01-04,갈산,18546,9378,9168
1,2024-01-04,부평구청,13014,6417,6597
1,2024-01-04,부평시장,26522,13225,13297
1,2024-01-04,부평,13118,6639,6479
1,2024-01-04,동수,7963,4025,3938
1,2024-01-04,부평삼거리,4769,2363,2406
1,2024-01-04,간석오거리,20823,10738,10085
1,2024-01-04,인천시청,10983,5512,5471
1,2024-01-04,예술회관,23140,11403,11737
1,2024-01-04,인천터미널,25541,12504,13037
1,2024-01-04,문학경기장,3666,1884,1782
1,2024-01-04,선학,11734,5848,5886
1,2024-01-04,신연수,10415,5270,5145
1,2024-01-04,원인재,5308,2875,2433
1,2024-01-04,동춘,19924,9774,10150
1,2024-01-04,동막,10209,5439,4770
1,2024-01-04,캠퍼스타운,11115,5636,5479
1,2024-01-04,테크노파크,20763,10387,10376
1,2024-01-04,지식정보단지,9659,4679,4980
1,2024-01-04,인천대입구,13153,6509,6644
1,2024-01-04,센트럴파크(재외동포청),7206,3614,3592
1,2024-01-04,국제업무지구,3965,2022,1943
1,2024-01-04,송도달빛축제공원,9811,4956,4855
1,2024-01-05,계양,7405,3732,3673
1,2024-01-05,귤현,2225,897,1328
1,2024-01-05,박촌,7314,3905,3409
1,2024-01-05,임학,16327,8195,8132
1,2024-01-05,계산,19325,9816,9509
1,2024-01-05,경인교대입구,10716,5400,5316
1,2024-01-05,작전,28394,14446,13948
1,2024-01-05,갈산,19175,9782,9393
1,2024-01-05,부평구청,13333,6529,6804
1,2024-01-05,부평시장,27278,13639,13639
1,2024-01-05,부평,14312,6984,7328
1,2024-01-05,동수,8280,4256,4024
1,2024-01-05,부평삼거리,4888,2468,2420
1,2024-01-05,간석오거리,21276,11053,10223
1,2024-01-05,인천시청,11137,5627,5510
1,2024-01-05,예술회관,24609,11701,12908
1,2024-01-05,인천터미널,29098,14126,14972
1,2024-01-05,문학경기장,3639,1830,1809
1,2024-01-05,선학,12507,6226,6281
1,2024-01-05,신연수,10671,5493,5178
1,2024-01-05,원인재,5535,2935,2600
1,2024-01-05,동춘,20912,10242,10670
1,2024-01-05,동막,10317,5432,4885
1,2024-01-05,캠퍼스타운,11331,5724,5607
1,2024-01-05,테크노파크,22608,11426,11182
1,2024-01-05,지식정보단지,9821,4828,4993
1,2024-01-05,인천대입구,13891,6901,6990
1,2024-01-05,센트럴파크(재외동포청),7623,3812,3811
1,2024-01-05,국제업무지구,3889,2030,1859
1,2024-01-05,송도달빛축제공원,10664,5433,5231
1,2024-01-06,계양,5649,2739,2910
1,2024-01-06,귤현,1482,689,793
1,2024-01-06,박촌,5383,2826,2557
1,2024-01-06,임학,11650,5876,5774
1,2024-01-06,계산,16925,8566,8359
1,2024-01-06,경인교대입구,8482,4270,4212
1,2024-01-06,작전,21293,10892,10401
1,2024-01-06,갈산,9370,4884,4486
1,2024-01-06,부평구청,9359,4562,4797
1,2024-01-06,부평시장,18413,9149,9264
1,2024-01-06,부평,12841,6516,6325
1,2024-01-06,동수,5325,2690,2635
1,2024-01-06,부평삼거리,4142,2094,2048
1,2024-01-06,간석오거리,15791,8180,7611
1,2024-01-06,인천시청,6992,3605,3387
1,2024-01-06,예술회관,17101,8069,9032
1,2024-01-06,인천터미널,27317,13259,14058
1,2024-01-06,문학경기장,2438,1212,1226
1,2024-01-06,선학,10127,5093,5034
1,2024-01-06,신연수,5941,3130,2811
1,2024-01-06,원인재,3266,1748,1518
1,2024-01-06,동춘,14448,7157,7291
1,2024-01-06,동막,6352,3391,2961
1,2024-01-06,캠퍼스타운,7736,4011,3725
1,2024-01-06,테크노파크,17598,8692,8906
1,2024-01-06,지식정보단지,4050,2041,2009
1,2024-01-06,인천대입구,10202,5048,5154
1,2024-01-06,센트럴파크(재외동포청),6607,3243,3364
1,2024-01-06,국제업무지구,1768,943,825
1,2024-01-06,송도달빛축제공원,7816,3889,3927
1,2024-01-07,계양,3746,1723,2023
1,2024-01-07,귤현,932,409,523
1,2024-01-07,박촌,3893,2008,1885
1,2024-01-07,임학,8241,4150,4091
1,2024-01-07,계산,11667,5777,5890
1,2024-01-07,경인교대입구,6674,3323,3351
1,2024-01-07,작전,13469,6839,6630
1,2024-01-07,갈산,6062,3086,2976
1,2024-01-07,부평구청,6490,3175,3315
1,2024-01-07,부평시장,13108,6575,6533
1,2024-01-07,부평,9028,4769,4259
1,2024-01-07,동수,3818,1961,1857
1,2024-01-07,부평삼거리,2797,1396,1401
1,2024-01-07,간석오거리,11409,5861,5548
1,2024-01-07,인천시청,4987,2534,2453
1,2024-01-07,예술회관,10767,5248,5519
1,2024-01-07,인천터미널,20917,10446,10471
1,2024-01-07,문학경기장,1313,667,646
1,2024-01-07,선학,7453,3670,3783
1,2024-01-07,신연수,4062,2057,2005
1,2024-01-07,원인재,1977,1061,916
1,2024-01-07,동춘,10343,5130,5213
1,2024-01-07,동막,4053,2072,1981
1,2024-01-07,캠퍼스타운,5199,2579,2620
1,2024-01-07,테크노파크,13475,6727,6748
1,2024-01-07,지식정보단지,2768,1342,1426
1,2024-01-07,인천대입구,6752,3267,3485
1,2024-01-07,센트럴파크(재외동포청),4529,2215,2314
1,2024-01-07,국제업무지구,705,363,342
1,2024-01-07,송도달빛축제공원,5528,2739,2789
1,2024-01-08,계양,6791,3365,3426
1,2024-01-08,귤현,2140,841,1299
1,2024-01-08,박촌,6896,3626,3270
1,2024-01-08,임학,14976,7525,7451
1,2024-01-08,계산,17321,8806,8515
1,2024-01-08,경인교대입구,9818,4955,4863
1,2024-01-08,작전,26086,13168,12918
1,2024-01-08,갈산,18411,9287,9124
1,2024-01-08,부평구청,12606,6219,6387
1,2024-01-08,부평시장,25167,12652,12515
1,2024-01-08,부평,12426,6274,6152
1,2024-01-08,동수,7921,4029,3892
1,2024-01-08,부평삼거리,4269,2140,2129
1,2024-01-08,간석오거리,19893,10376,9517
1,2024-01-08,인천시청,9955,5016,4939
1,2024-01-08,예술회관,22443,11104,11339
1,2024-01-08,인천터미널,24213,11853,12360
1,2024-01-08,문학경기장,3437,1756,1681
1,2024-01-08,선학,11051,5493,5558
1,2024-01-08,신연수,10147,5137,5010
1,2024-01-08,원인재,5091,2743,2348
1,2024-01-08,동춘,19005,9210,9795
1,2024-01-08,동막,9638,5047,4591
1,2024-01-08,캠퍼스타운,10365,5195,5170
1,2024-01-08,테크노파크,19849,9974,9875
1,2024-01-08,지식정보단지,9398,4542,4856
1,2024-01-08,인천대입구,12888,6496,6392
1,2024-01-08,센트럴파크(재외동포청),6784,3405,3379
1,2024-01-08,국제업무지구,3802,1940,1862
1,2024-01-08,송도달빛축제공원,9283,4642,4641
1,2024-01-09,계양,7266,3660,3606
1,2024-01-09,귤현,2272,891,1381
1,2024-01-09,박촌,7167,3742,3425
1,2024-01-09,임학,15859,7971,7888
1,2024-01-09,계산,17914,9011,8903
1,2024-01-09,경인교대입구,10357,5235,5122
1,2024-01-09,작전,27432,13847,13585
1,2024-01-09,갈산,19642,9907,9735
1,2024-01-09,부평구청,13774,6761,7013
1,2024-01-09,부평시장,25943,12973,12970
1,2024-01-09,부평,12782,6426,6356
1,2024-01-09,동수,8460,4314,4146
1,2024-01-09,부평삼거리,4377,2214,2163
1,2024-01-09,간석오거리,21132,10958,10174
1,2024-01-09,인천시청,11393,5716,5677
1,2024-01-09,예술회관,23688,11663,12025
1,2024-01-09,인천터미널,25139,12464,12675
1,2024-01-09,문학경기장,3683,1913,1770
1,2024-01-09,선학,12067,5986,6081
1,2024-01-09,신연수,10867,5549,5318
1,2024-01-09,원인재,5561,2969,2592
1,2024-01-09,동춘,20553,10078,10475
1,2024-01-09,동막,10396,5490,4906
1,2024-01-09,캠퍼스타운,11402,5702,5700
1,2024-01-09,테크노파크,22571,11273,11298
1,2024-01-09,지식정보단지,10681,5191,5490
1,2024-01-09,인천대입구,14069,6979,7090
1,2024-01-09,센트럴파크(재외동포청),7808,3931,3877
1,2024-01-09,국제업무지구,4307,2216,2091
1,2024-01-09,송도달빛축제공원,10375,5205,5170
1,2024-01-10,계양,7446,3723,3723
1,2024-01-10,귤현,2341,896,1445
1,2024-01-10,박촌,7353,3853,3500
1,2024-01-10,임학,15894,8039,7855
1,2024-01-10,계산,18654,9367,9287
1,2024-01-10,경인교대입구,10475,5284,5191
1,2024-01-10,작전,27742,14069,13673
1,2024-01-10,갈산,19313,9702,9611
1,2024-01-10,부평구청,13447,6642,6805
1,2024-01-10,부평시장,26864,13448,13416
1,2024-01-10,부평,13774,6979,6795
1,2024-01-10,동수,8273,4149,4124
1,2024-01-10,부평삼거리,4783,2406,2377
1,2024-01-10,간석오거리,21451,11054,10397
1,2024-01-10,인천시청,10674,5368,5306
1,2024-01-10,예술회관,24968,12302,12666
1,2024-01-10,인천터미널,25593,12522,13071
1,2024-01-10,문학경기장,3550,1810,1740
1,2024-01-10,선학,12299,6195,6104
1,2024-01-10,신연수,11024,5585,5439
1,2024-01-10,원인재,5510,2941,2569
1,2024-01-10,동춘,20381,10017,10364
1,2024-01-10,동막,10786,5710,5076
1,2024-01-10,캠퍼스타운,11189,5650,5539
1,2024-01-10,테크노파크,21967,10947,11020
1,2024-01-10,지식정보단지,9927,4827,5100
1,2024-01-10,인천대입구,13556,6755,6801
1,2024-01-10,센트럴파크(재외동포청),7567,3768,3799
1,2024-01-10,국제업무지구,4000,2046,1954
1,2024-01-10,송도달빛축제공원,10050,5051,4999
1,2024-01-11,계양,7178,3590,3588
1,2024-01-11,귤현,2270,881,1389
1,2024-01-11,박촌,7236,3780,3456
1,2024-01-11,임학,15901,8061,7840
1,2024-01-11,계산,18428,9312,9116
1,2024-01-11,경인교대입구,10552,5282,5270
1,2024-01-11,작전,27522,13836,13686
1,2024-01-11,갈산,19234,9777,9457
1,2024-01-11,부평구청,13526,6671,6855
1,2024-01-11,부평시장,26537,13201,13336
1,2024-01-11,부평,13463,6845,6618
1,2024-01-11,동수,7988,4101,3887
1,2024-01-11,부평삼거리,4823,2422,2401
1,2024-01-11,간석오거리,21338,11135,10203
1,2024-01-11,인천시청,10996,5536,5460
1,2024-01-11,예술회관,24306,11892,12414
1,2024-01-11,인천터미널,25560,12497,13063
1,2024-01-11,문학경기장,3466,1747,1719
1,2024-01-11,선학,12037,6021,6016
1,2024-01-11,신연수,10831,5455,5376
1,2024-01-11,원인재,5487,2973,2514
1,2024-01-11,동춘,20665,10130,10535
1,2024-01-11,동막,9993,5316,4677
1,2024-01-11,캠퍼스타운,11070,5556,5514
1,2024-01-11,테크노파크,21338,10676,10662
1,2024-01-11,지식정보단지,9892,4824,5068
1,2024-01-11,인천대입구,13552,6735,6817
1,2024-01-11,센트럴파크(재외동포청),7510,3717,3793
1,2024-01-11,국제업무지구,4008,2063,1945
1,2024-01-11,송도달빛축제공원,10045,5088,4957
1,2024-01-12,계양,7487,3785,3702
1,2024-01-12,귤현,2292,886,1406
1,2024-01-12,박촌,7316,3896,3420
1,2024-01-12,임학,16619,8337,8282
1,2024-01-12,계산,19495,9830,9665
1,2024-01-12,경인교대입구,10669,5349,5320
1,2024-01-12,작전,28506,14438,14068
1,2024-01-12,갈산,19131,9759,9372
1,2024-01-12,부평구청,13938,6904,7034
1,2024-01-12,부평시장,27464,13624,13840
1,2024-01-12,부평,15290,7544,7746
1,2024-01-12,동수,8241,4263,3978
1,2024-01-12,부평삼거리,4779,2388,2391
1,2024-01-12,간석오거리,21556,11296,10260
1,2024-01-12,인천시청,10912,5499,5413
1,2024-01-12,예술회관,25827,12365,13462
1,2024-01-12,인천터미널,29699,14437,15262
1,2024-01-12,문학경기장,3750,1934,1816
1,2024-01-12,선학,12767,6384,6383
1,2024-01-12,신연수,10866,5555,5311
1,2024-01-12,원인재,5741,3092,2649
1,2024-01-12,동춘,21471,10585,10886
1,2024-01-12,동막,10301,5464,4837
1,2024-01-12,캠퍼스타운,11447,5782,5665
1,2024-01-12,테크노파크,22245,11192,11053
1,2024-01-12,지식정보단지,9791,4794,4997
1,2024-01-12,인천대입구,14630,7277,7353
1,2024-01-12,센트럴파크(재외동포청),8017,3957,4060
1,2024-01-12,국제업무지구,4034,2014,2020
1,2024-01-12,송도달빛축제공원,10320,5292,5028
1,2024-01-13,계양,5823,2737,3086
1,2024-01-13,귤현,1515,694,821
1,2024-01-13,박촌,5534,2919,2615
1,2024-01-13,임학,12239,6185,6054
1,2024-01-13,계산,17284,8685,8599
1,2024-01-13,경인교대입구,8621,4383,4238
1,2024-01-13,작전,22357,11534,10823
1,2024-01-13,갈산,9822,5074,4748
1,2024-01-13,부평구청,9882,4897,4985
1,2024-01-13,부평시장,19114,9457,9657
1,2024-01-13,부평,13710,6728,6982
1,2024-01-13,동수,5367,2763,2604
1,2024-01-13,부평삼거리,4023,2033,1990
1,2024-01-13,간석오거리,16223,8481,7742
1,2024-01-13,인천시청,7084,3617,3467
1,2024-01-13,예술회관,17671,8321,9350
1,2024-01-13,인천터미널,28135,13799,14336
1,2024-01-13,문학경기장,2493,1233,1260
1,2024-01-13,선학,10478,5257,5221
1,2024-01-13,신연수,6525,3382,3143
1,2024-01-13,원인재,3455,1853,1602
1,2024-01-13,동춘,15001,7375,7626
1,2024-01-13,동막,6584,3526,3058
1,2024-01-13,캠퍼스타운,7844,4071,3773
1,2024-01-13,테크노파크,18207,9086,9121
1,2024-01-13,지식정보단지,4021,2089,1932
1,2024-01-13,인천대입구,10361,5085,5276
1,2024-01-13,센트럴파크(재외동포청),6632,3226,3406
1,2024-01-13,국제업무지구,1884,988,896
1,2024-01-13,송도달빛축제공원,8055,4161,3894
1,2024-01-14,계양,3825,1738,2087
1,2024-01-14,귤현,911,413,498
1,2024-01-14,박촌,3571,1843,1728
1,2024-01-14,임학,7981,4016,3965
1,2024-01-14,계산,11210,5600,5610
1,2024-01-14,경인교대입구,6518,3274,3244
1,2024-01-14,작전,13582,6894,6688
1,2024-01-14,갈산,5844,2984,2860
1,2024-01-14,부평구청,6779,3273,3506
1,2024-01-14,부평시장,12822,6366,6456
1,2024-01-14,부평,8676,4490,4186
1,2024-01-14,동수,3748,1859,1889
1,2024-01-14,부평삼거리,2703,1324,1379
1,2024-01-14,간석오거리,10901,5682,5219
1,2024-01-14,인천시청,4682,2439,2243
1,2024-01-14,예술회관,10752,5262,5490
1,2024-01-14,인천터미널,20421,10316,10105
1,2024-01-14,문학경기장,1120,543,577
1,2024-01-14,선학,7107,3506,3601
1,2024-01-14,신연수,3941,2040,1901
1,2024-01-14,원인재,2136,1141,995
1,2024-01-14,동춘,7928,3944,3984
1,2024-01-14,동막,3945,2029,1916
1,2024-01-14,캠퍼스타운,4883,2488,2395
1,2024-01-14,테크노파크,12280,6058,6222
1,2024-01-14,지식정보단지,2689,1273,1416
1,2024-01-14,인천대입구,6517,3178,3339
1,2024-01-14,센트럴파크(재외동포청),4164,2041,2123
1,2024-01-14,국제업무지구,691,363,328
1,2024-01-14,송도달빛축제공원,5294,2614,2680
1,2024-01-15,계양,6920,3494,3426
1,2024-01-15,귤현,2181,843,1338
1,2024-01-15,박촌,6948,3648,3300
1,2024-01-15,임학,15348,7686,7662
1,2024-01-15,계산,17991,9150,8841
1,2024-01-15,경인교대입구,9829,4962,4867
1,2024-01-15,작전,26853,13582,13271
1,2024-01-15,갈산,18623,9392,9231
1,2024-01-15,부평구청,12739,6220,6519
1,2024-01-15,부평시장,25567,12802,12765
1,2024-01-15,부평,13092,6549,6543
1,2024-01-15,동수,7829,3978,3851
1,2024-01-15,부평삼거리,4494,2272,2222
1,2024-01-15,간석오거리,20424,10637,9787
1,2024-01-15,인천시청,10092,5095,4997
1,2024-01-15,예술회관,23057,11408,11649
1,2024-01-15,인천터미널,24644,12154,12490
1,2024-01-15,문학경기장,2366,1194,1172
1,2024-01-15,선학,11385,5709,5676
1,2024-01-15,신연수,10366,5209,5157
1,2024-01-15,원인재,5075,2710,2365
1,2024-01-15,동춘,19425,9534,9891
1,2024-01-15,동막,9789,5186,4603
1,2024-01-15,캠퍼스타운,10557,5291,5266
1,2024-01-15,테크노파크,20040,10054,9986
1,2024-01-15,지식정보단지,9553,4635,4918
1,2024-01-15,인천대입구,12210,6086,6124
1,2024-01-15,센트럴파크(재외동포청),7081,3579,3502
1,2024-01-15,국제업무지구,4001,2049,1952
1,2024-01-15,송도달빛축제공원,9262,4608,4654
1,2024-01-16,계양,7357,3675,3682
1,2024-01-16,귤현,2284,930,1354
1,2024-01-16,박촌,7352,3900,3452
1,2024-01-16,임학,15848,7957,7891
1,2024-01-16,계산,18576,9379,9197
1,2024-01-16,경인교대입구,10054,5034,5020
1,2024-01-16,작전,29313,14770,14543
1,2024-01-16,갈산,18893,9610,9283
1,2024-01-16,부평구청,13144,6399,6745
1,2024-01-16,부평시장,26331,13116,13215
1,2024-01-16,부평,13234,6675,6559
1,2024-01-16,동수,7938,4040,3898
1,2024-01-16,부평삼거리,4524,2256,2268
1,2024-01-16,간석오거리,21119,10969,10150
1,2024-01-16,인천시청,10541,5327,5214
1,2024-01-16,예술회관,24118,11837,12281
1,2024-01-16,인천터미널,25391,12438,12953
1,2024-01-16,문학경기장,3689,1871,1818
1,2024-01-16,선학,11924,5877,6047
1,2024-01-16,신연수,10525,5383,5142
1,2024-01-16,원인재,5518,3007,2511
1,2024-01-16,동춘,20187,9863,10324
1,2024-01-16,동막,10087,5313,4774
1,2024-01-16,캠퍼스타운,11123,5616,5507
1,2024-01-16,테크노파크,20729,10366,10363
1,2024-01-16,지식정보단지,9878,4780,5098
1,2024-01-16,인천대입구,13776,6880,6896
1,2024-01-16,센트럴파크(재외동포청),7492,3783,3709
1,2024-01-16,국제업무지구,4113,2100,2013
1,2024-01-16,송도달빛축제공원,9724,4887,4837
1,2024-01-17,계양,7164,3609,3555
1,2024-01-17,귤현,2258,856,1402
1,2024-01-17,박촌,7303,3809,3494
1,2024-01-17,임학,15431,7819,7612
1,2024-01-17,계산,18258,9254,9004
1,2024-01-17,경인교대입구,10086,5014,5072
1,2024-01-17,작전,26922,13565,13357
1,2024-01-17,갈산,18906,9561,9345
1,2024-01-17,부평구청,12990,6362,6628
1,2024-01-17,부평시장,25691,12815,12876
1,2024-01-17,부평,13421,6812,6609
1,2024-01-17,동수,8106,4110,3996
1,2024-01-17,부평삼거리,4440,2223,2217
1,2024-01-17,간석오거리,20792,10759,10033
1,2024-01-17,인천시청,10389,5197,5192
1,2024-01-17,예술회관,23983,11844,12139
1,2024-01-17,인천터미널,24117,11827,12290
1,2024-01-17,문학경기장,3307,1672,1635
1,2024-01-17,선학,12018,6005,6013
1,2024-01-17,신연수,10363,5290,5073
1,2024-01-17,원인재,5365,2891,2474
1,2024-01-17,동춘,19317,9411,9906
1,2024-01-17,동막,10205,5428,4777
1,2024-01-17,캠퍼스타운,10868,5451,5417
1,2024-01-17,테크노파크,20757,10475,10282
1,2024-01-17,지식정보단지,9781,4712,5069
1,2024-01-17,인천대입구,12941,6403,6538
1,2024-01-17,센트럴파크(재외동포청),7179,3592,3587
1,2024-01-17,국제업무지구,4051,2083,1968
1,2024-01-17,송도달빛축제공원,9458,4782,4676
1,2024-01-18,계양,7469,3740,3729
1,2024-01-18,귤현,2271,863,1408
1,2024-01-18,박촌,7113,3726,3387
1,2024-01-18,임학,15762,7894,7868
1,2024-01-18,계산,18781,9543,9238
1,2024-01-18,경인교대입구,10420,5184,5236
1,2024-01-18,작전,27236,13920,13316
1,2024-01-18,갈산,19075,9628,9447
1,2024-01-18,부평구청,13465,6568,6897
1,2024-01-18,부평시장,26566,13272,13294
1,2024-01-18,부평,13625,6833,6792
1,2024-01-18,동수,8013,4091,3922
1,2024-01-18,부평삼거리,4701,2379,2322
1,2024-01-18,간석오거리,21229,11020,10209
1,2024-01-18,인천시청,10715,5401,5314
1,2024-01-18,예술회관,24271,11868,12403
1,2024-01-18,인천터미널,25771,12688,13083
1,2024-01-18,문학경기장,3534,1730,1804
1,2024-01-18,선학,12093,6035,6058
1,2024-01-18,신연수,10710,5445,5265
1,2024-01-18,원인재,5472,2928,2544
1,2024-01-18,동춘,20527,9984,10543
1,2024-01-18,동막,10085,5337,4748
1,2024-01-18,캠퍼스타운,11316,5643,5673
1,2024-01-18,테크노파크,21239,10628,10611
1,2024-01-18,지식정보단지,9733,4735,4998
1,2024-01-18,인천대입구,13341,6629,6712
1,2024-01-18,센트럴파크(재외동포청),7715,3882,3833
1,2024-01-18,국제업무지구,4167,2113,2054
1,2024-01-18,송도달빛축제공원,10192,5106,5086
1,2024-01-19,계양,7610,3860,3750
1,2024-01-19,귤현,2388,966,1422
1,2024-01-19,박촌,7397,3936,3461
1,2024-01-19,임학,16299,8180,8119
1,2024-01-19,계산,19328,9844,9484
1,2024-01-19,경인교대입구,10862,5435,5427
1,2024-01-19,작전,28722,14562,14160
1,2024-01-19,갈산,19156,9741,9415
1,2024-01-19,부평구청,13834,6762,7072
1,2024-01-19,부평시장,27336,13686,13650
1,2024-01-19,부평,15073,7373,7700
1,2024-01-19,동수,8091,4174,3917
1,2024-01-19,부평삼거리,4911,2495,2416
1,2024-01-19,간석오거리,21570,11244,10326
1,2024-01-19,인천시청,10822,5501,5321
1,2024-01-19,예술회관,25284,12190,13094
1,2024-01-19,인천터미널,29547,14292,15255
1,2024-01-19,문학경기장,3648,1883,1765
1,2024-01-19,선학,12657,6316,6341
1,2024-01-19,신연수,10848,5623,5225
1,2024-01-19,원인재,5751,3089,2662
1,2024-01-19,동춘,21250,10402,10848
1,2024-01-19,동막,10272,5489,4783
1,2024-01-19,캠퍼스타운,11426,5794,5632
1,2024-01-19,테크노파크,22399,11257,11142
1,2024-01-19,지식정보단지,9692,4750,4942
1,2024-01-19,인천대입구,13922,6911,7011
1,2024-01-19,센트럴파크(재외동포청),8429,4191,4238
1,2024-01-19,국제업무지구,4091,2086,2005
1,2024-01-19,송도달빛축제공원,10550,5281,5269
1,2024-01-20,계양,5653,2755,2898
1,2024-01-20,귤현,1541,697,844
1,2024-01-20,박촌,5277,2778,2499
1,2024-01-20,임학,11804,6051,5753
1,2024-01-20,계산,16665,8427,8238
1,2024-01-20,경인교대입구,8659,4323,4336
1,2024-01-20,작전,20921,10726,10195
1,2024-01-20,갈산,9833,5081,4752
1,2024-01-20,부평구청,9839,4824,5015
1,2024-01-20,부평시장,18293,9105,9188
1,2024-01-20,부평,13388,6678,6710
1,2024-01-20,동수,5241,2634,2607
1,2024-01-20,부평삼거리,4003,1977,2026
1,2024-01-20,간석오거리,15826,8219,7607
1,2024-01-20,인천시청,6841,3474,3367
1,2024-01-20,예술회관,17174,8141,9033
1,2024-01-20,인천터미널,26656,13018,13638
1,2024-01-20,문학경기장,2535,1241,1294
1,2024-01-20,선학,10295,5144,5151
1,2024-01-20,신연수,5924,3104,2820
1,2024-01-20,원인재,3354,1796,1558
1,2024-01-20,동춘,14452,7144,7308
1,2024-01-20,동막,6448,3408,3040
1,2024-01-20,캠퍼스타운,7798,4053,3745
1,2024-01-20,테크노파크,17861,8870,8991
1,2024-01-20,지식정보단지,4003,2092,1911
1,2024-01-20,인천대입구,10413,5079,5334
1,2024-01-20,센트럴파크(재외동포청),6158,3018,3140
1,2024-01-20,국제업무지구,1859,987,872
1,2024-01-20,송도달빛축제공원,7688,3926,3762
1,2024-01-21,계양,4081,1867,2214
1,2024-01-21,귤현,928,430,498
1,2024-01-21,박촌,4001,2091,1910
1,2024-01-21,임학,8597,4314,4283
1,2024-01-21,계산,12442,6181,6261
1,2024-01-21,경인교대입구,6770,3403,3367
1,2024-01-21,작전,14079,7249,6830
1,2024-01-21,갈산,6227,3210,3017
1,2024-01-21,부평구청,6892,3334,3558
1,2024-01-21,부평시장,14113,6978,7135
1,2024-01-21,부평,9512,4873,4639
1,2024-01-21,동수,4095,2123,1972
1,2024-01-21,부평삼거리,3055,1512,1543
1,2024-01-21,간석오거리,11585,6045,5540
1,2024-01-21,인천시청,4918,2521,2397
1,2024-01-21,예술회관,11069,5380,5689
1,2024-01-21,인천터미널,20954,10723,10231
1,2024-01-21,문학경기장,1399,737,662
1,2024-01-21,선학,7358,3638,3720
1,2024-01-21,신연수,4296,2195,2101
1,2024-01-21,원인재,2768,1437,1331
1,2024-01-21,동춘,10514,5152,5362
1,2024-01-21,동막,4306,2184,2122
1,2024-01-21,캠퍼스타운,5316,2677,2639
1,2024-01-21,테크노파크,13193,6606,6587
1,2024-01-21,지식정보단지,2673,1280,1393
1,2024-01-21,인천대입구,8482,4116,4366
1,2024-01-21,센트럴파크(재외동포청),4487,2204,2283
1,2024-01-21,국제업무지구,770,407,363
1,2024-01-21,송도달빛축제공원,5648,2743,2905
1,2024-01-22,계양,6573,3243,3330
1,2024-01-22,귤현,2139,867,1272
1,2024-01-22,박촌,6805,3532,3273
1,2024-01-22,임학,14844,7470,7374
1,2024-01-22,계산,17520,8914,8606
1,2024-01-22,경인교대입구,9512,4773,4739
1,2024-01-22,작전,25545,12939,12606
1,2024-01-22,갈산,18155,9199,8956
1,2024-01-22,부평구청,12551,6207,6344
1,2024-01-22,부평시장,24509,12238,12271
1,2024-01-22,부평,13015,6546,6469
1,2024-01-22,동수,7827,3945,3882
1,2024-01-22,부평삼거리,4211,2150,2061
1,2024-01-22,간석오거리,19557,10150,9407
1,2024-01-22,인천시청,9560,4856,4704
1,2024-01-22,예술회관,22373,11186,11187
1,2024-01-22,인천터미널,23172,11376,11796
1,2024-01-22,문학경기장,3323,1671,1652
1,2024-01-22,선학,10772,5391,5381
1,2024-01-22,신연수,9978,5066,4912
1,2024-01-22,원인재,4998,2695,2303
1,2024-01-22,동춘,18656,9102,9554
1,2024-01-22,동막,9528,5011,4517
1,2024-01-22,캠퍼스타운,9949,5088,4861
1,2024-01-22,테크노파크,19095,9590,9505
1,2024-01-22,지식정보단지,9327,4416,4911
1,2024-01-22,인천대입구,12020,5916,6104
1,2024-01-22,센트럴파크(재외동포청),6586,3274,3312
1,2024-01-22,국제업무지구,3898,2007,1891
1,2024-01-22,송도달빛축제공원,8842,4473,4369
1,2024-01-23,계양,6479,3235,3244
1,2024-01-23,귤현,2073,809,1264
1,2024-01-23,박촌,6581,3373,3208
1,2024-01-23,임학,14354,7257,7097
1,2024-01-23,계산,16417,8281,8136
1,2024-01-23,경인교대입구,9156,4597,4559
1,2024-01-23,작전,24504,12480,12024
1,2024-01-23,갈산,17816,8973,8843
1,2024-01-23,부평구청,12024,5873,6151
1,2024-01-23,부평시장,23235,11557,11678
1,2024-01-23,부평,12197,6249,5948
1,2024-01-23,동수,7517,3813,3704
1,2024-01-23,부평삼거리,3942,1991,1951
1,2024-01-23,간석오거리,18858,9820,9038
1,2024-01-23,인천시청,9741,4869,4872
1,2024-01-23,예술회관,21577,10785,10792
1,2024-01-23,인천터미널,21855,10750,11105
1,2024-01-23,문학경기장,2945,1522,1423
1,2024-01-23,선학,10564,5269,5295
1,2024-01-23,신연수,9645,4945,4700
1,2024-01-23,원인재,4857,2644,2213
1,2024-01-23,동춘,17715,8660,9055
1,2024-01-23,동막,9232,4869,4363
1,2024-01-23,캠퍼스타운,9423,4653,4770
1,2024-01-23,테크노파크,18426,9271,9155
1,2024-01-23,지식정보단지,8933,4312,4621
1,2024-01-23,인천대입구,11658,5750,5908
1,2024-01-23,센트럴파크(재외동포청),6411,3196,3215
1,2024-01-23,국제업무지구,3760,1926,1834
1,2024-01-23,송도달빛축제공원,8338,4193,4145
1,2024-01-24,계양,6785,3404,3381
1,2024-01-24,귤현,2128,812,1316
1,2024-01-24,박촌,6899,3607,3292
1,2024-01-24,임학,14788,7440,7348
1,2024-01-24,계산,17471,8848,8623
1,2024-01-24,경인교대입구,9488,4772,4716
1,2024-01-24,작전,25452,12832,12620
1,2024-01-24,갈산,18446,9290,9156
1,2024-01-24,부평구청,12498,6146,6352
1,2024-01-24,부평시장,24369,12170,12199
1,2024-01-24,부평,12461,6378,6083
1,2024-01-24,동수,7836,3920,3916
1,2024-01-24,부평삼거리,4058,2053,2005
1,2024-01-24,간석오거리,19975,10249,9726
1,2024-01-24,인천시청,10165,5112,5053
1,2024-01-24,예술회관,22932,11329,11603
1,2024-01-24,인천터미널,23278,11457,11821
1,2024-01-24,문학경기장,3331,1726,1605
1,2024-01-24,선학,11264,5640,5624
1,2024-01-24,신연수,10083,5166,4917
1,2024-01-24,원인재,5426,2908,2518
1,2024-01-24,동춘,18756,9177,9579
1,2024-01-24,동막,9779,5209,4570
1,2024-01-24,캠퍼스타운,9885,4968,4917
1,2024-01-24,테크노파크,19730,9859,9871
1,2024-01-24,지식정보단지,9308,4485,4823
1,2024-01-24,인천대입구,12236,6103,6133
1,2024-01-24,센트럴파크(재외동포청),6849,3450,3399
1,2024-01-24,국제업무지구,3788,1927,1861
1,2024-01-24,송도달빛축제공원,8930,4478,4452
1,2024-01-25,계양,7065,3484,3581
1,2024-01-25,귤현,2091,839,1252
1,2024-01-25,박촌,7083,3714,3369
1,2024-01-25,임학,15128,7637,7491
1,2024-01-25,계산,17874,9087,8787
1,2024-01-25,경인교대입구,10207,5076,5131
1,2024-01-25,작전,26292,13319,12973
1,2024-01-25,갈산,18673,9420,9253
1,2024-01-25,부평구청,12882,6346,6536
1,2024-01-25,부평시장,25494,12707,12787
1,2024-01-25,부평,12878,6558,6320
1,2024-01-25,동수,7968,4053,3915
1,2024-01-25,부평삼거리,4567,2305,2262
1,2024-01-25,간석오거리,20817,10761,10056
1,2024-01-25,인천시청,10246,5162,5084
1,2024-01-25,예술회관,23693,11634,12059
1,2024-01-25,인천터미널,24695,12223,12472
1,2024-01-25,문학경기장,3418,1752,1666
1,2024-01-25,선학,11867,5964,5903
1,2024-01-25,신연수,10361,5295,5066
1,2024-01-25,원인재,5445,2955,2490
1,2024-01-25,동춘,20018,9781,10237
1,2024-01-25,동막,9874,5268,4606
1,2024-01-25,캠퍼스타운,10799,5425,5374
1,2024-01-25,테크노파크,20502,10213,10289
1,2024-01-25,지식정보단지,9309,4458,4851
1,2024-01-25,인천대입구,13089,6516,6573
1,2024-01-25,센트럴파크(재외동포청),7250,3635,3615
1,2024-01-25,국제업무지구,3967,1990,1977
1,2024-01-25,송도달빛축제공원,9409,4672,4737
1,2024-01-26,계양,7320,3696,3624
1,2024-01-26,귤현,2323,917,1406
1,2024-01-26,박촌,7176,3803,3373
1,2024-01-26,임학,16336,8136,8200
1,2024-01-26,계산,18926,9624,9302
1,2024-01-26,경인교대입구,10412,5165,5247
1,2024-01-26,작전,28115,14310,13805
1,2024-01-26,갈산,18791,9599,9192
1,2024-01-26,부평구청,13673,6799,6874
1,2024-01-26,부평시장,27160,13489,13671
1,2024-01-26,부평,14208,7087,7121
1,2024-01-26,동수,8108,4124,3984
1,2024-01-26,부평삼거리,4613,2378,2235
1,2024-01-26,간석오거리,21437,11191,10246
1,2024-01-26,인천시청,10451,5290,5161
1,2024-01-26,예술회관,25266,12149,13117
1,2024-01-26,인천터미널,28859,14059,14800
1,2024-01-26,문학경기장,3652,1892,1760
1,2024-01-26,선학,12660,6336,6324
1,2024-01-26,신연수,10656,5556,5100
1,2024-01-26,원인재,5656,3016,2640
1,2024-01-26,동춘,20908,10240,10668
1,2024-01-26,동막,10357,5524,4833
1,2024-01-26,캠퍼스타운,11318,5686,5632
1,2024-01-26,테크노파크,21595,10800,10795
1,2024-01-26,지식정보단지,9755,4786,4969
1,2024-01-26,인천대입구,13539,6640,6899
1,2024-01-26,센트럴파크(재외동포청),7834,3900,3934
1,2024-01-26,국제업무지구,3963,2030,1933
1,2024-01-26,송도달빛축제공원,10062,5152,4910
1,2024-01-27,계양,5809,2812,2997
1,2024-01-27,귤현,1443,652,791
1,2024-01-27,박촌,5450,2908,2542
1,2024-01-27,임학,12097,6167,5930
1,2024-01-27,계산,17628,8868,8760
1,2024-01-27,경인교대입구,8546,4315,4231
1,2024-01-27,작전,21201,10913,10288
1,2024-01-27,갈산,9938,5081,4857
1,2024-01-27,부평구청,10074,4888,5186
1,2024-01-27,부평시장,19068,9489,9579
1,2024-01-27,부평,13125,6535,6590
1,2024-01-27,동수,5381,2771,2610
1,2024-01-27,부평삼거리,4309,2084,2225
1,2024-01-27,간석오거리,16413,8604,7809
1,2024-01-27,인천시청,6935,3589,3346
1,2024-01-27,예술회관,17352,8201,9151
1,2024-01-27,인천터미널,27070,13187,13883
1,2024-01-27,문학경기장,2598,1317,1281
1,2024-01-27,선학,10637,5317,5320
1,2024-01-27,신연수,6156,3238,2918
1,2024-01-27,원인재,3266,1785,1481
1,2024-01-27,동춘,15063,7411,7652
1,2024-01-27,동막,6532,3494,3038
1,2024-01-27,캠퍼스타운,7552,3980,3572
1,2024-01-27,테크노파크,17840,8856,8984
1,2024-01-27,지식정보단지,4054,2099,1955
1,2024-01-27,인천대입구,10244,5114,5130
1,2024-01-27,센트럴파크(재외동포청),6542,3215,3327
1,2024-01-27,국제업무지구,1863,979,884
1,2024-01-27,송도달빛축제공원,7881,3985,3896
1,2024-01-28,계양,3973,1833,2140
1,2024-01-28,귤현,907,418,489
1,2024-01-28,박촌,3982,2049,1933
1,2024-01-28,임학,8588,4363,4225
1,2024-01-28,계산,12920,6454,6466
1,2024-01-28,경인교대입구,6848,3413,3435
1,2024-01-28,작전,13936,7121,6815
1,2024-01-28,갈산,6286,3204,3082
1,2024-01-28,부평구청,6878,3372,3506
1,2024-01-28,부평시장,14233,7064,7169
1,2024-01-28,부평,9085,4799,4286
1,2024-01-28,동수,4104,2103,2001
1,2024-01-28,부평삼거리,3494,1718,1776
1,2024-01-28,간석오거리,11854,6195,5659
1,2024-01-28,인천시청,4693,2367,2326
1,2024-01-28,예술회관,11080,5390,5690
1,2024-01-28,인천터미널,21252,10769,10483
1,2024-01-28,문학경기장,1013,517,496
1,2024-01-28,선학,7340,3554,3786
1,2024-01-28,신연수,4153,2156,1997
1,2024-01-28,원인재,2261,1194,1067
1,2024-01-28,동춘,8814,4440,4374
1,2024-01-28,동막,4193,2154,2039
1,2024-01-28,캠퍼스타운,5314,2689,2625
1,2024-01-28,테크노파크,13519,6635,6884
1,2024-01-28,지식정보단지,2811,1333,1478
1,2024-01-28,인천대입구,7088,3449,3639
1,2024-01-28,센트럴파크(재외동포청),4163,2065,2098
1,2024-01-28,국제업무지구,750,379,371
1,2024-01-28,송도달빛축제공원,5912,2894,3018
1,2024-01-29,계양,7137,3523,3614
1,2024-01-29,귤현,2174,846,1328
1,2024-01-29,박촌,7045,3706,3339
1,2024-01-29,임학,15408,7822,7586
1,2024-01-29,계산,18331,9278,9053
1,2024-01-29,경인교대입구,10172,5124,5048
1,2024-01-29,작전,26631,13598,13033
1,2024-01-29,갈산,18830,9475,9355
1,2024-01-29,부평구청,12898,6340,6558
1,2024-01-29,부평시장,26088,13051,13037
1,2024-01-29,부평,12668,6444,6224
1,2024-01-29,동수,8122,4130,3992
1,2024-01-29,부평삼거리,4616,2324,2292
1,2024-01-29,간석오거리,20492,10671,9821
1,2024-01-29,인천시청,9994,4971,5023
1,2024-01-29,예술회관,23515,11636,11879
1,2024-01-29,인천터미널,24685,12125,12560
1,2024-01-29,문학경기장,3620,1775,1845
1,2024-01-29,선학,11560,5744,5816
1,2024-01-29,신연수,10605,5405,5200
1,2024-01-29,원인재,5325,2839,2486
1,2024-01-29,동춘,20125,9834,10291
1,2024-01-29,동막,10074,5271,4803
1,2024-01-29,캠퍼스타운,10968,5504,5464
1,2024-01-29,테크노파크,20048,10103,9945
1,2024-01-29,지식정보단지,9539,4619,4920
1,2024-01-29,인천대입구,12331,6144,6187
1,2024-01-29,센트럴파크(재외동포청),7249,3624,3625
1,2024-01-29,국제업무지구,4017,2069,1948
1,2024-01-29,송도달빛축제공원,9643,4830,4813
1,2024-01-30,계양,7310,3673,3637
1,2024-01-30,귤현,2157,843,1314
1,2024-01-30,박촌,7286,3789,3497
1,2024-01-30,임학,15836,8022,7814
1,2024-01-30,계산,18364,9293,9071
1,2024-01-30,경인교대입구,10234,5104,5130
1,2024-01-30,작전,27417,13929,13488
1,2024-01-30,갈산,19081,9610,9471
1,2024-01-30,부평구청,13281,6523,6758
1,2024-01-30,부평시장,26656,13229,13427
1,2024-01-30,부평,12761,6442,6319
1,2024-01-30,동수,8061,4080,3981
1,2024-01-30,부평삼거리,4846,2428,2418
1,2024-01-30,간석오거리,21375,11125,10250
1,2024-01-30,인천시청,10369,5207,5162
1,2024-01-30,예술회관,23811,11644,12167
1,2024-01-30,인천터미널,25089,12416,12673
1,2024-01-30,문학경기장,3597,1858,1739
1,2024-01-30,선학,11964,5957,6007
1,2024-01-30,신연수,10386,5305,5081
1,2024-01-30,원인재,5448,2925,2523
1,2024-01-30,동춘,20067,9864,10203
1,2024-01-30,동막,10029,5249,4780
1,2024-01-30,캠퍼스타운,10649,5371,5278
1,2024-01-30,테크노파크,20518,10294,10224
1,2024-01-30,지식정보단지,9579,4624,4955
1,2024-01-30,인천대입구,12924,6412,6512
1,2024-01-30,센트럴파크(재외동포청),7534,3802,3732
1,2024-01-30,국제업무지구,4121,2109,2012
1,2024-01-30,송도달빛축제공원,9896,4951,4945
1,2024-01-31,계양,7315,3645,3670
1,2024-01-31,귤현,2255,928,1327
1,2024-01-31,박촌,7310,3832,3478
1,2024-01-31,임학,15606,7881,7725
1,2024-01-31,계산,18690,9368,9322
1,2024-01-31,경인교대입구,10276,5140,5136
1,2024-01-31,작전,26620,13456,13164
1,2024-01-31,갈산,19214,9682,9532
1,2024-01-31,부평구청,13257,6568,6689
1,2024-01-31,부평시장,26905,13398,13507
1,2024-01-31,부평,12860,6494,6366
1,2024-01-31,동수,8197,4193,4004
1,2024-01-31,부평삼거리,4871,2422,2449
1,2024-01-31,간석오거리,21212,11019,10193
1,2024-01-31,인천시청,10618,5345,5273
1,2024-01-31,예술회관,24417,12007,12410
1,2024-01-31,인천터미널,25429,12485,12944
1,2024-01-31,문학경기장,3492,1744,1748
1,2024-01-31,선학,12074,6088,5986
1,2024-01-31,신연수,10524,5383,5141
1,2024-01-31,원인재,5477,2931,2546
1,2024-01-31,동춘,20077,9873,10204
1,2024-01-31,동막,10039,5346,4693
1,2024-01-31,캠퍼스타운,10931,5538,5393
1,2024-01-31,테크노파크,20898,10444,10454
1,2024-01-31,지식정보단지,9827,4763,5064
1,2024-01-31,인천대입구,12936,6473,6463
1,2024-01-31,센트럴파크(재외동포청),7705,3838,3867
1,2024-01-31,국제업무지구,4017,2071,1946
1,2024-01-31,송도달빛축제공원,9913,5036,4877
1,2024-02-01,계양,7400,3686,3714
1,2024-02-01,귤현,2274,905,1369
1,2024-02-01,박촌,7384,3882,3502
1,2024-02-01,임학,15775,7916,7859
1,2024-02-01,계산,18952,9593,9359
1,2024-02-01,경인교대입구,10201,5082,5119
1,2024-02-01,작전,28642,14475,14167
1,2024-02-01,갈산,19117,9653,9464
1,2024-02-01,부평구청,13140,6476,6664
1,2024-02-01,부평시장,26603,13290,13313
1,2024-02-01,부평,12688,6413,6275
1,2024-02-01,동수,8226,4181,4045
1,2024-02-01,부평삼거리,4855,2431,2424
1,2024-02-01,간석오거리,21064,10925,10139
1,2024-02-01,인천시청,10756,5379,5377
1,2024-02-01,예술회관,23834,11613,12221
1,2024-02-01,인천터미널,24777,12245,12532
1,2024-02-01,문학경기장,3593,1817,1776
1,2024-02-01,선학,12033,6002,6031
1,2024-02-01,신연수,10705,5478,5227
1,2024-02-01,원인재,5556,3017,2539
1,2024-02-01,동춘,20242,9882,10360
1,2024-02-01,동막,10019,5310,4709
1,2024-02-01,캠퍼스타운,11189,5590,5599
1,2024-02-01,테크노파크,20364,10162,10202
1,2024-02-01,지식정보단지,10029,4838,5191
1,2024-02-01,인천대입구,12694,6339,6355
1,2024-02-01,센트럴파크(재외동포청),7607,3863,3744
1,2024-02-01,국제업무지구,4117,2083,2034
1,2024-02-01,송도달빛축제공원,9805,4997,4808
1,2024-02-02,계양,7379,3732,3647
1,2024-02-02,귤현,2346,919,1427
1,2024-02-02,박촌,7550,3985,3565
1,2024-02-02,임학,16597,8400,8197
1,2024-02-02,계산,20129,10275,9854
1,2024-02-02,경인교대입구,10828,5441,5387
1,2024-02-02,작전,28017,14314,13703
1,2024-02-02,갈산,19243,9764,9479
1,2024-02-02,부평구청,13693,6696,6997
1,2024-02-02,부평시장,27242,13663,13579
1,2024-02-02,부평,13899,6944,6955
1,2024-02-02,동수,8382,4318,4064
1,2024-02-02,부평삼거리,5128,2588,2540
1,2024-02-02,간석오거리,21098,11069,10029
1,2024-02-02,인천시청,10497,5288,5209
1,2024-02-02,예술회관,25051,11906,13145
1,2024-02-02,인천터미널,27839,13500,14339
1,2024-02-02,문학경기장,3710,1890,1820
1,2024-02-02,선학,12313,6198,6115
1,2024-02-02,신연수,10785,5514,5271
1,2024-02-02,원인재,5852,3162,2690
1,2024-02-02,동춘,21194,10477,10717
1,2024-02-02,동막,10438,5556,4882
1,2024-02-02,캠퍼스타운,11560,5826,5734
1,2024-02-02,테크노파크,21454,10762,10692
1,2024-02-02,지식정보단지,10089,4946,5143
1,2024-02-02,인천대입구,13445,6633,6812
1,2024-02-02,센트럴파크(재외동포청),7982,3926,4056
1,2024-02-02,국제업무지구,4108,2098,2010
1,2024-02-02,송도달빛축제공원,10366,5242,5124
1,2024-02-03,계양,5588,2701,2887
1,2024-02-03,귤현,1379,624,755
1,2024-02-03,박촌,5381,2819,2562
1,2024-02-03,임학,11527,5803,5724
1,2024-02-03,계산,16148,8109,8039
1,2024-02-03,경인교대입구,8475,4237,4238
1,2024-02-03,작전,20875,10728,10147
1,2024-02-03,갈산,9637,5046,4591
1,2024-02-03,부평구청,9426,4632,4794
1,2024-02-03,부평시장,18665,9278,9387
1,2024-02-03,부평,12424,6253,6171
1,2024-02-03,동수,5318,2727,2591
1,2024-02-03,부평삼거리,5536,2724,2812
1,2024-02-03,간석오거리,15749,8251,7498
1,2024-02-03,인천시청,7213,3709,3504
1,2024-02-03,예술회관,16844,7888,8956
1,2024-02-03,인천터미널,25407,12554,12853
1,2024-02-03,문학경기장,2654,1322,1332
1,2024-02-03,선학,9715,4850,4865
1,2024-02-03,신연수,5875,3083,2792
1,2024-02-03,원인재,3233,1703,1530
1,2024-02-03,동춘,14467,7184,7283
1,2024-02-03,동막,6087,3212,2875
1,2024-02-03,캠퍼스타운,7305,3759,3546
1,2024-02-03,테크노파크,16660,8211,8449
1,2024-02-03,지식정보단지,4044,2034,2010
1,2024-02-03,인천대입구,9737,4794,4943
1,2024-02-03,센트럴파크(재외동포청),6145,3022,3123
1,2024-02-03,국제업무지구,1836,964,872
1,2024-02-03,송도달빛축제공원,7454,3791,3663
1,2024-02-04,계양,4172,1968,2204
1,2024-02-04,귤현,995,417,578
1,2024-02-04,박촌,4036,2118,1918
1,2024-02-04,임학,8732,4497,4235
1,2024-02-04,계산,12618,6305,6313
1,2024-02-04,경인교대입구,6945,3461,3484
1,2024-02-04,작전,14176,7291,6885
1,2024-02-04,갈산,6166,3150,3016
1,2024-02-04,부평구청,6876,3394,3482
1,2024-02-04,부평시장,14758,7271,7487
1,2024-02-04,부평,8790,4671,4119
1,2024-02-04,동수,4191,2141,2050
1,2024-02-04,부평삼거리,5329,2655,2674
1,2024-02-04,간석오거리,12105,6360,5745
1,2024-02-04,인천시청,5123,2622,2501
1,2024-02-04,예술회관,11989,5894,6095
1,2024-02-04,인천터미널,21177,10703,10474
1,2024-02-04,문학경기장,1357,676,681
1,2024-02-04,선학,7690,3798,3892
1,2024-02-04,신연수,4542,2279,2263
1,2024-02-04,원인재,2445,1283,1162
1,2024-02-04,동춘,11502,5620,5882
1,2024-02-04,동막,4203,2182,2021
1,2024-02-04,캠퍼스타운,5394,2685,2709
1,2024-02-04,테크노파크,13574,6703,6871
1,2024-02-04,지식정보단지,2759,1374,1385
1,2024-02-04,인천대입구,7358,3559,3799
1,2024-02-04,센트럴파크(재외동포청),4880,2388,2492
1,2024-02-04,국제업무지구,792,441,351
1,2024-02-04,송도달빛축제공원,6214,3042,3172
1,2024-02-05,계양,6881,3385,3496
1,2024-02-05,귤현,2165,852,1313
1,2024-02-05,박촌,7163,3731,3432
1,2024-02-05,임학,14946,7540,7406
1,2024-02-05,계산,17439,8836,8603
1,2024-02-05,경인교대입구,10006,5016,4990
1,2024-02-05,작전,25881,13036,12845
1,2024-02-05,갈산,18554,9469,9085
1,2024-02-05,부평구청,12606,6128,6478
1,2024-02-05,부평시장,25043,12535,12508
1,2024-02-05,부평,12313,6270,6043
1,2024-02-05,동수,8236,4239,3997
1,2024-02-05,부평삼거리,4444,2218,2226
1,2024-02-05,간석오거리,19717,10272,9445
1,2024-02-05,인천시청,10585,5336,5249
1,2024-02-05,예술회관,22575,11283,11292
1,2024-02-05,인천터미널,23538,11501,12037
1,2024-02-05,문학경기장,3395,1757,1638
1,2024-02-05,선학,10908,5444,5464
1,2024-02-05,신연수,10088,5160,4928
1,2024-02-05,원인재,5099,2724,2375
1,2024-02-05,동춘,19089,9262,9827
1,2024-02-05,동막,9678,5141,4537
1,2024-02-05,캠퍼스타운,10298,5165,5133
1,2024-02-05,테크노파크,19291,9676,9615
1,2024-02-05,지식정보단지,9628,4669,4959
1,2024-02-05,인천대입구,12027,5927,6100
1,2024-02-05,센트럴파크(재외동포청),6946,3498,3448
1,2024-02-05,국제업무지구,4072,2123,1949
1,2024-02-05,송도달빛축제공원,9224,4616,4608
1,2024-02-06,계양,7142,3570,3572
1,2024-02-06,귤현,2288,907,1381
1,2024-02-06,박촌,7726,4023,3703
1,2024-02-06,임학,15669,7917,7752
1,2024-02-06,계산,18539,9439,9100
1,2024-02-06,경인교대입구,10192,5127,5065
1,2024-02-06,작전,27515,13959,13556
1,2024-02-06,갈산,18925,9622,9303
1,2024-02-06,부평구청,13401,6604,6797
1,2024-02-06,부평시장,27432,13669,13763
1,2024-02-06,부평,13235,6673,6562
1,2024-02-06,동수,8260,4252,4008
1,2024-02-06,부평삼거리,5341,2692,2649
1,2024-02-06,간석오거리,21078,10937,10141
1,2024-02-06,인천시청,11237,5656,5581
1,2024-02-06,예술회관,23824,11656,12168
1,2024-02-06,인천터미널,25283,12352,12931
1,2024-02-06,문학경기장,3544,1798,1746
1,2024-02-06,선학,11893,5945,5948
1,2024-02-06,신연수,10982,5623,5359
1,2024-02-06,원인재,5531,2984,2547
1,2024-02-06,동춘,20639,10199,10440
1,2024-02-06,동막,10081,5297,4784
1,2024-02-06,캠퍼스타운,11177,5579,5598
1,2024-02-06,테크노파크,21052,10596,10456
1,2024-02-06,지식정보단지,10155,4952,5203
1,2024-02-06,인천대입구,12930,6397,6533
1,2024-02-06,센트럴파크(재외동포청),7784,3912,3872
1,2024-02-06,국제업무지구,4085,2088,1997
1,2024-02-06,송도달빛축제공원,10064,5064,5000
1,2024-02-07,계양,7324,3665,3659
1,2024-02-07,귤현,2214,872,1342
1,2024-02-07,박촌,7674,3980,3694
1,2024-02-07,임학,16010,7967,8043
1,2024-02-07,계산,18917,9619,9298
1,2024-02-07,경인교대입구,10512,5236,5276
1,2024-02-07,작전,27723,14030,13693
1,2024-02-07,갈산,18973,9613,9360
1,2024-02-07,부평구청,13313,6557,6756
1,2024-02-07,부평시장,27459,13679,13780
1,2024-02-07,부평,13518,6892,6626
1,2024-02-07,동수,8372,4265,4107
1,2024-02-07,부평삼거리,6216,3121,3095
1,2024-02-07,간석오거리,21178,10995,10183
1,2024-02-07,인천시청,10823,5415,5408
1,2024-02-07,예술회관,23903,11751,12152
1,2024-02-07,인천터미널,26594,12769,13825
1,2024-02-07,문학경기장,3549,1771,1778
1,2024-02-07,선학,12134,6082,6052
1,2024-02-07,신연수,10998,5669,5329
1,2024-02-07,원인재,5601,2971,2630
1,2024-02-07,동춘,21006,10217,10789
1,2024-02-07,동막,10231,5482,4749
1,2024-02-07,캠퍼스타운,11200,5590,5610
1,2024-02-07,테크노파크,20871,10486,10385
1,2024-02-07,지식정보단지,9884,4803,5081
1,2024-02-07,인천대입구,13188,6640,6548
1,2024-02-07,센트럴파크(재외동포청),7768,3882,3886
1,2024-02-07,국제업무지구,4027,2051,1976
1,2024-02-07,송도달빛축제공원,10015,5100,4915
1,2024-02-08,계양,7121,3603,3518
1,2024-02-08,귤현,2208,921,1287
1,2024-02-08,박촌,7171,3872,3299
1,2024-02-08,임학,15963,8017,7946
1,2024-02-08,계산,18743,9527,9216
1,2024-02-08,경인교대입구,10669,5341,5328
1,2024-02-08,작전,27047,13663,13384
1,2024-02-08,갈산,17833,9127,8706
1,2024-02-08,부평구청,13387,6687,6700
1,2024-02-08,부평시장,26860,13355,13505
1,2024-02-08,부평,14639,7255,7384
1,2024-02-08,동수,7925,4134,3791
1,2024-02-08,부평삼거리,6399,3219,3180
1,2024-02-08,간석오거리,20674,10845,9829
1,2024-02-08,인천시청,10149,5204,4945
1,2024-02-08,예술회관,23901,11471,12430
1,2024-02-08,인천터미널,32394,14518,17876
1,2024-02-08,문학경기장,3258,1631,1627
1,2024-02-08,선학,12232,6205,6027
1,2024-02-08,신연수,9917,5122,4795
1,2024-02-08,원인재,5062,2674,2388
1,2024-02-08,동춘,21248,10142,11106
1,2024-02-08,동막,9792,5269,4523
1,2024-02-08,캠퍼스타운,10828,5579,5249
1,2024-02-08,테크노파크,20465,10363,10102
1,2024-02-08,지식정보단지,8802,4334,4468
1,2024-02-08,인천대입구,12260,6225,6035
1,2024-02-08,센트럴파크(재외동포청),7597,3801,3796
1,2024-02-08,국제업무지구,3570,1842,1728
1,2024-02-08,송도달빛축제공원,9645,4933,4712
1,2024-02-09,계양,3652,1689,1963
1,2024-02-09,귤현,822,383,439
1,2024-02-09,박촌,3347,1733,1614
1,2024-02-09,임학,7565,3717,3848
1,2024-02-09,계산,10293,5241,5052
1,2024-02-09,경인교대입구,5441,2740,2701
1,2024-02-09,작전,12153,6141,6012
1,2024-02-09,갈산,5439,2837,2602
1,2024-02-09,부평구청,5798,2829,2969
1,2024-02-09,부평시장,12258,6047,6211
1,2024-02-09,부평,8054,4004,4050
1,2024-02-09,동수,3419,1707,1712
1,2024-02-09,부평삼거리,8450,4203,4247
1,2024-02-09,간석오거리,9847,5133,4714
1,2024-02-09,인천시청,3969,2039,1930
1,2024-02-09,예술회관,10164,5011,5153
1,2024-02-09,인천터미널,19691,8421,11270
1,2024-02-09,문학경기장,812,406,406
1,2024-02-09,선학,6524,3235,3289
1,2024-02-09,신연수,4118,2144,1974
1,2024-02-09,원인재,2072,1115,957
1,2024-02-09,동춘,11041,5377,5664
1,2024-02-09,동막,3819,2019,1800
1,2024-02-09,캠퍼스타운,4217,2202,2015
1,2024-02-09,테크노파크,12258,6238,6020
1,2024-02-09,지식정보단지,2198,1171,1027
1,2024-02-09,인천대입구,5349,2751,2598
1,2024-02-09,센트럴파크(재외동포청),4022,2080,1942
1,2024-02-09,국제업무지구,441,243,198
1,2024-02-09,송도달빛축제공원,4816,2451,2365
1,2024-02-10,계양,3052,1434,1618
1,2024-02-10,귤현,772,391,381
1,2024-02-10,박촌,3164,1608,1556
1,2024-02-10,임학,6629,3347,3282
1,2024-02-10,계산,8878,4482,4396
1,2024-02-10,경인교대입구,5234,2579,2655
1,2024-02-10,작전,10977,5499,5478
1,2024-02-10,갈산,4895,2588,2307
1,2024-02-10,부평구청,5354,2672,2682
1,2024-02-10,부평시장,9577,4772,4805
1,2024-02-10,부평,6021,2865,3156
1,2024-02-10,동수,3177,1621,1556
1,2024-02-10,부평삼거리,20808,10424,10384
1,2024-02-10,간석오거리,9309,4974,4335
1,2024-02-10,인천시청,3815,2001,1814
1,2024-02-10,예술회관,7948,3754,4194
1,2024-02-10,인천터미널,14050,7095,6955
1,2024-02-10,문학경기장,729,357,372
1,2024-02-10,선학,5813,2892,2921
1,2024-02-10,신연수,3609,1890,1719
1,2024-02-10,원인재,1929,1019,910
1,2024-02-10,동춘,9037,4479,4558
1,2024-02-10,동막,2975,1601,1374
1,2024-02-10,캠퍼스타운,3183,1598,1585
1,2024-02-10,테크노파크,6222,3067,3155
1,2024-02-10,지식정보단지,1567,782,785
1,2024-02-10,인천대입구,3802,1887,1915
1,2024-02-10,센트럴파크(재외동포청),3006,1458,1548
1,2024-02-10,국제업무지구,322,174,148
1,2024-02-10,송도달빛축제공원,3451,1720,1731
1,2024-02-11,계양,3759,1772,1987
1,2024-02-11,귤현,839,405,434
1,2024-02-11,박촌,3740,1971,1769
1,2024-02-11,임학,7911,3923,3988
1,2024-02-11,계산,11488,5747,5741
1,2024-02-11,경인교대입구,6244,3091,3153
1,2024-02-11,작전,12428,6410,6018
1,2024-02-11,갈산,5615,2890,2725
1,2024-02-11,부평구청,6214,3071,3143
1,2024-02-11,부평시장,11993,6062,5931
1,2024-02-11,부평,8909,4391,4518
1,2024-02-11,동수,3619,1809,1810
1,2024-02-11,부평삼거리,6876,3489,3387
1,2024-02-11,간석오거리,11435,5933,5502
1,2024-02-11,인천시청,4402,2266,2136
1,2024-02-11,예술회관,11114,5106,6008
1,2024-02-11,인천터미널,23838,12751,11087
1,2024-02-11,문학경기장,829,437,392
1,2024-02-11,선학,6982,3415,3567
1,2024-02-11,신연수,3842,2004,1838
1,2024-02-11,원인재,2124,1097,1027
1,2024-02-11,동춘,9210,4753,4457
1,2024-02-11,동막,3895,2060,1835
1,2024-02-11,캠퍼스타운,4548,2338,2210
1,2024-02-11,테크노파크,15132,7582,7550
1,2024-02-11,지식정보단지,2266,1136,1130
1,2024-02-11,인천대입구,5827,2750,3077
1,2024-02-11,센트럴파크(재외동포청),4161,2009,2152
1,2024-02-11,국제업무지구,563,298,265
1,2024-02-11,송도달빛축제공원,5456,2738,2718
1,2024-02-12,계양,4278,1999,2279
1,2024-02-12,귤현,942,451,491
1,2024-02-12,박촌,3850,2038,1812
1,2024-02-12,임학,8321,4230,4091
1,2024-02-12,계산,12707,6260,6447
1,2024-02-12,경인교대입구,6002,3033,2969
1,2024-02-12,작전,13405,6854,6551
1,2024-02-12,갈산,5988,3046,2942
1,2024-02-12,부평구청,6724,3320,3404
1,2024-02-12,부평시장,12745,6324,6421
1,2024-02-12,부평,9631,4908,4723
1,2024-02-12,동수,3670,1864,1806
1,2024-02-12,부평삼거리,5313,2637,2676
1,2024-02-12,간석오거리,12245,6283,5962
1,2024-02-12,인천시청,4716,2374,2342
1,2024-02-12,예술회관,12315,5915,6400
1,2024-02-12,인천터미널,24937,13220,11717
1,2024-02-12,문학경기장,1057,547,510
1,2024-02-12,선학,7110,3454,3656
1,2024-02-12,신연수,4269,2177,2092
1,2024-02-12,원인재,2306,1221,1085
1,2024-02-12,동춘,12043,5988,6055
1,2024-02-12,동막,4202,2188,2014
1,2024-02-12,캠퍼스타운,5242,2651,2591
1,2024-02-12,테크노파크,15175,7463,7712
1,2024-02-12,지식정보단지,2694,1262,1432
1,2024-02-12,인천대입구,6686,3181,3505
1,2024-02-12,센트럴파크(재외동포청),4811,2392,2419
1,2024-02-12,국제업무지구,658,368,290
1,2024-02-12,송도달빛축제공원,6018,2963,3055
1,2024-02-13,계양,7161,3555,3606
1,2024-02-13,귤현,2109,834,1275
1,2024-02-13,박촌,7296,3861,3435
1,2024-02-13,임학,15517,7873,7644
1,2024-02-13,계산,18194,9161,9033
1,2024-02-13,경인교대입구,10081,5031,5050
1,2024-02-13,작전,26353,13363,12990
1,2024-02-13,갈산,17953,9061,8892
1,2024-02-13,부평구청,12680,6173,6507
1,2024-02-13,부평시장,24881,12427,12454
1,2024-02-13,부평,13287,6678,6609
1,2024-02-13,동수,8066,4090,3976
1,2024-02-13,부평삼거리,5005,2510,2495
1,2024-02-13,간석오거리,20184,10533,9651
1,2024-02-13,인천시청,10231,5161,5070
1,2024-02-13,예술회관,23062,11368,11694
1,2024-02-13,인천터미널,26838,13586,13252
1,2024-02-13,문학경기장,3582,1797,1785
1,2024-02-13,선학,11508,5666,5842
1,2024-02-13,신연수,9835,5022,4813
1,2024-02-13,원인재,5200,2781,2419
1,2024-02-13,동춘,19174,9446,9728
1,2024-02-13,동막,9563,5038,4525
1,2024-02-13,캠퍼스타운,10424,5243,5181
1,2024-02-13,테크노파크,20122,10051,10071
1,2024-02-13,지식정보단지,8585,4120,4465
1,2024-02-13,인천대입구,13105,6465,6640
1,2024-02-13,센트럴파크(재외동포청),7126,3604,3522
1,2024-02-13,국제업무지구,3911,2016,1895
1,2024-02-13,송도달빛축제공원,9674,4824,4850
1,2024-02-14,계양,7663,3790,3873
1,2024-02-14,귤현,2251,868,1383
1,2024-02-14,박촌,7514,3949,3565
1,2024-02-14,임학,16257,8328,7929
1,2024-02-14,계산,19289,9806,9483
1,2024-02-14,경인교대입구,10684,5301,5383
1,2024-02-14,작전,28026,14246,13780
1,2024-02-14,갈산,20192,10250,9942
1,2024-02-14,부평구청,12982,6328,6654
1,2024-02-14,부평시장,26605,13290,13315
1,2024-02-14,부평,14133,6963,7170
1,2024-02-14,동수,8613,4367,4246
1,2024-02-14,부평삼거리,5001,2459,2542
1,2024-02-14,간석오거리,21773,11297,10476
1,2024-02-14,인천시청,11116,5623,5493
1,2024-02-14,예술회관,25403,12446,12957
1,2024-02-14,인천터미널,27063,13432,13631
1,2024-02-14,문학경기장,3659,1786,1873
1,2024-02-14,선학,12495,6173,6322
1,2024-02-14,신연수,10639,5447,5192
1,2024-02-14,원인재,5610,2985,2625
1,2024-02-14,동춘,20692,10202,10490
1,2024-02-14,동막,10596,5679,4917
1,2024-02-14,캠퍼스타운,11378,5700,5678
1,2024-02-14,테크노파크,22132,11087,11045
1,2024-02-14,지식정보단지,10178,4969,5209
1,2024-02-14,인천대입구,14065,7010,7055
1,2024-02-14,센트럴파크(재외동포청),7848,3938,3910
1,2024-02-14,국제업무지구,4077,2094,1983
1,2024-02-14,송도달빛축제공원,10495,5269,5226
1,2024-02-15,계양,7226,3580,3646
1,2024-02-15,귤현,2174,858,1316
1,2024-02-15,박촌,7247,3757,3490
1,2024-02-15,임학,15422,7731,7691
1,2024-02-15,계산,17881,9087,8794
1,2024-02-15,경인교대입구,10281,5127,5154
1,2024-02-15,작전,25985,13193,12792
1,2024-02-15,갈산,18452,9347,9105
1,2024-02-15,부평구청,12809,6296,6513
1,2024-02-15,부평시장,24609,12389,12220
1,2024-02-15,부평,13402,6760,6642
1,2024-02-15,동수,8016,4036,3980
1,2024-02-15,부평삼거리,4180,2104,2076
1,2024-02-15,간석오거리,20633,10706,9927
1,2024-02-15,인천시청,10467,5232,5235
1,2024-02-15,예술회관,23087,11376,11711
1,2024-02-15,인천터미널,24711,12153,12558
1,2024-02-15,문학경기장,3299,1666,1633
1,2024-02-15,선학,11346,5672,5674
1,2024-02-15,신연수,10155,5228,4927
1,2024-02-15,원인재,5500,2899,2601
1,2024-02-15,동춘,19898,9748,10150
1,2024-02-15,동막,10143,5364,4779
1,2024-02-15,캠퍼스타운,10995,5454,5541
1,2024-02-15,테크노파크,20737,10385,10352
1,2024-02-15,지식정보단지,9692,4693,4999
1,2024-02-15,인천대입구,13484,6791,6693
1,2024-02-15,센트럴파크(재외동포청),7290,3637,3653
1,2024-02-15,국제업무지구,4079,2059,2020
1,2024-02-15,송도달빛축제공원,9621,4822,4799
1,2024-02-16,계양,7886,3935,3951
1,2024-02-16,귤현,2380,962,1418
1,2024-02-16,박촌,7659,4052,3607
1,2024-02-16,임학,16765,8517,8248
1,2024-02-16,계산,19709,10046,9663
1,2024-02-16,경인교대입구,11155,5562,5593
1,2024-02-16,작전,28654,14576,14078
1,2024-02-16,갈산,19471,9953,9518
1,2024-02-16,부평구청,13855,6774,7081
1,2024-02-16,부평시장,27471,13758,13713
1,2024-02-16,부평,15242,7443,7799
1,2024-02-16,동수,8277,4246,4031
1,2024-02-16,부평삼거리,4911,2484,2427
1,2024-02-16,간석오거리,22189,11621,10568
1,2024-02-16,인천시청,11333,5767,5566
1,2024-02-16,예술회관,26093,12525,13568
1,2024-02-16,인천터미널,30715,14886,15829
1,2024-02-16,문학경기장,3549,1813,1736
1,2024-02-16,선학,12717,6350,6367
1,2024-02-16,신연수,10905,5614,5291
1,2024-02-16,원인재,6001,3228,2773
1,2024-02-16,동춘,21846,10784,11062
1,2024-02-16,동막,10691,5722,4969
1,2024-02-16,캠퍼스타운,11932,6011,5921
1,2024-02-16,테크노파크,23626,11985,11641
1,2024-02-16,지식정보단지,10283,5072,5211
1,2024-02-16,인천대입구,15611,7612,7999
1,2024-02-16,센트럴파크(재외동포청),8473,4237,4236
1,2024-02-16,국제업무지구,4031,2056,1975
1,2024-02-16,송도달빛축제공원,10915,5618,5297
1,2024-02-17,계양,6275,3007,3268
1,2024-02-17,귤현,1554,741,813
1,2024-02-17,박촌,5623,2970,2653
1,2024-02-17,임학,12468,6349,6119
1,2024-02-17,계산,18309,9102,9207
1,2024-02-17,경인교대입구,9131,4536,4595
1,2024-02-17,작전,22527,11605,10922
1,2024-02-17,갈산,10884,5590,5294
1,2024-02-17,부평구청,10307,5024,5283
1,2024-02-17,부평시장,19611,9845,9766
1,2024-02-17,부평,13971,6949,7022
1,2024-02-17,동수,5611,2848,2763
1,2024-02-17,부평삼거리,4485,2185,2300
1,2024-02-17,간석오거리,17079,8842,8237
1,2024-02-17,인천시청,7170,3697,3473
1,2024-02-17,예술회관,18176,8583,9593
1,2024-02-17,인천터미널,28663,14093,14570
1,2024-02-17,문학경기장,2887,1385,1502
1,2024-02-17,선학,10989,5560,5429
1,2024-02-17,신연수,6577,3520,3057
1,2024-02-17,원인재,4113,2190,1923
1,2024-02-17,동춘,15846,7867,7979
1,2024-02-17,동막,6884,3724,3160
1,2024-02-17,캠퍼스타운,7886,4163,3723
1,2024-02-17,테크노파크,18981,9391,9590
1,2024-02-17,지식정보단지,4337,2215,2122
1,2024-02-17,인천대입구,10645,5353,5292
1,2024-02-17,센트럴파크(재외동포청),6918,3388,3530
1,2024-02-17,국제업무지구,2021,1052,969
1,2024-02-17,송도달빛축제공원,8691,4430,4261
1,2024-02-18,계양,4333,1937,2396
1,2024-02-18,귤현,1006,453,553
1,2024-02-18,박촌,3997,2109,1888
1,2024-02-18,임학,8672,4335,4337
1,2024-02-18,계산,12696,6356,6340
1,2024-02-18,경인교대입구,6946,3463,3483
1,2024-02-18,작전,14214,7222,6992
1,2024-02-18,갈산,6504,3281,3223
1,2024-02-18,부평구청,7326,3586,3740
1,2024-02-18,부평시장,13844,6876,6968
1,2024-02-18,부평,9480,4962,4518
1,2024-02-18,동수,4123,2058,2065
1,2024-02-18,부평삼거리,3114,1525,1589
1,2024-02-18,간석오거리,11882,6152,5730
1,2024-02-18,인천시청,5028,2597,2431
1,2024-02-18,예술회관,11496,5593,5903
1,2024-02-18,인천터미널,21295,10801,10494
1,2024-02-18,문학경기장,1916,928,988
1,2024-02-18,선학,7330,3646,3684
1,2024-02-18,신연수,4145,2090,2055
1,2024-02-18,원인재,2319,1233,1086
1,2024-02-18,동춘,10790,5292,5498
1,2024-02-18,동막,4391,2279,2112
1,2024-02-18,캠퍼스타운,5561,2813,2748
1,2024-02-18,테크노파크,14654,7273,7381
1,2024-02-18,지식정보단지,2900,1389,1511
1,2024-02-18,인천대입구,7130,3409,3721
1,2024-02-18,센트럴파크(재외동포청),4216,2124,2092
1,2024-02-18,국제업무지구,891,480,411
1,2024-02-18,송도달빛축제공원,5926,2943,2983
1,2024-02-19,계양,6884,3427,3457
1,2024-02-19,귤현,2207,851,1356
1,2024-02-19,박촌,7038,3708,3330
1,2024-02-19,임학,15332,7733,7599
1,2024-02-19,계산,17757,8970,8787
1,2024-02-19,경인교대입구,10145,5073,5072
1,2024-02-19,작전,25919,13136,12783
1,2024-02-19,갈산,18789,9533,9256
1,2024-02-19,부평구청,12751,6215,6536
1,2024-02-19,부평시장,25095,12560,12535
1,2024-02-19,부평,12953,6409,6544
1,2024-02-19,동수,8045,4090,3955
1,2024-02-19,부평삼거리,4332,2175,2157
1,2024-02-19,간석오거리,20463,10702,9761
1,2024-02-19,인천시청,10277,5182,5095
1,2024-02-19,예술회관,23210,11455,11755
1,2024-02-19,인천터미널,24546,12040,12506
1,2024-02-19,문학경기장,3303,1608,1695
1,2024-02-19,선학,11083,5533,5550
1,2024-02-19,신연수,10354,5263,5091
1,2024-02-19,원인재,5509,2896,2613
1,2024-02-19,동춘,19184,9402,9782
1,2024-02-19,동막,9634,5020,4614
1,2024-02-19,캠퍼스타운,10691,5379,5312
1,2024-02-19,테크노파크,19784,9964,9820
1,2024-02-19,지식정보단지,9593,4645,4948
1,2024-02-19,인천대입구,12178,6134,6044
1,2024-02-19,센트럴파크(재외동포청),6857,3457,3400
1,2024-02-19,국제업무지구,3936,2027,1909
1,2024-02-19,송도달빛축제공원,9642,4893,4749
1,2024-02-20,계양,7408,3677,3731
1,2024-02-20,귤현,2226,880,1346
1,2024-02-20,박촌,7472,3906,3566
1,2024-02-20,임학,16212,8148,8064
1,2024-02-20,계산,18276,9219,9057
1,2024-02-20,경인교대입구,10480,5217,5263
1,2024-02-20,작전,27657,14002,13655
1,2024-02-20,갈산,19458,9850,9608
1,2024-02-20,부평구청,13292,6516,6776
1,2024-02-20,부평시장,26347,13170,13177
1,2024-02-20,부평,13485,6868,6617
1,2024-02-20,동수,8446,4220,4226
1,2024-02-20,부평삼거리,4552,2294,2258
1,2024-02-20,간석오거리,21259,10975,10284
1,2024-02-20,인천시청,11189,5714,5475
1,2024-02-20,예술회관,24165,11883,12282
1,2024-02-20,인천터미널,25176,12394,12782
1,2024-02-20,문학경기장,3787,1936,1851
1,2024-02-20,선학,12114,6116,5998
1,2024-02-20,신연수,11090,5599,5491
1,2024-02-20,원인재,5823,3098,2725
1,2024-02-20,동춘,20316,9871,10445
1,2024-02-20,동막,10004,5344,4660
1,2024-02-20,캠퍼스타운,11125,5565,5560
1,2024-02-20,테크노파크,21151,10597,10554
1,2024-02-20,지식정보단지,9973,4749,5224
1,2024-02-20,인천대입구,12985,6459,6526
1,2024-02-20,센트럴파크(재외동포청),7489,3757,3732
1,2024-02-20,국제업무지구,4155,2156,1999
1,2024-02-20,송도달빛축제공원,10006,5046,4960
1,2024-02-21,계양,7021,3500,3521
1,2024-02-21,귤현,2164,869,1295
1,2024-02-21,박촌,7180,3726,3454
1,2024-02-21,임학,15273,7643,7630
1,2024-02-21,계산,17747,9004,8743
1,2024-02-21,경인교대입구,10036,4977,5059
1,2024-02-21,작전,26110,13155,12955
1,2024-02-21,갈산,19201,9753,9448
1,2024-02-21,부평구청,13146,6495,6651
1,2024-02-21,부평시장,25194,12691,12503
1,2024-02-21,부평,13375,6773,6602
1,2024-02-21,동수,8165,4145,4020
1,2024-02-21,부평삼거리,4269,2133,2136
1,2024-02-21,간석오거리,20522,10674,9848
1,2024-02-21,인천시청,10846,5493,5353
1,2024-02-21,예술회관,23668,11617,12051
1,2024-02-21,인천터미널,24252,11941,12311
1,2024-02-21,문학경기장,3265,1656,1609
1,2024-02-21,선학,11485,5686,5799
1,2024-02-21,신연수,10346,5233,5113
1,2024-02-21,원인재,5717,3037,2680
1,2024-02-21,동춘,19672,9592,10080
1,2024-02-21,동막,10367,5546,4821
1,2024-02-21,캠퍼스타운,10676,5356,5320
1,2024-02-21,테크노파크,20529,10319,10210
1,2024-02-21,지식정보단지,9805,4725,5080
1,2024-02-21,인천대입구,13650,6135,7515
1,2024-02-21,센트럴파크(재외동포청),7189,3576,3613
1,2024-02-21,국제업무지구,3933,2027,1906
1,2024-02-21,송도달빛축제공원,9459,4812,4647
1,2024-02-22,계양,7835,3897,3938
1,2024-02-22,귤현,2263,886,1377
1,2024-02-22,박촌,7758,4034,3724
1,2024-02-22,임학,16819,8569,8250
1,2024-02-22,계산,19581,9939,9642
1,2024-02-22,경인교대입구,10904,5504,5400
1,2024-02-22,작전,28536,14512,14024
1,2024-02-22,갈산,20270,10207,10063
1,2024-02-22,부평구청,14474,7138,7336
1,2024-02-22,부평시장,26852,13497,13355
1,2024-02-22,부평,14134,7130,7004
1,2024-02-22,동수,8696,4410,4286
1,2024-02-22,부평삼거리,4762,2447,2315
1,2024-02-22,간석오거리,21939,11533,10406
1,2024-02-22,인천시청,11679,5882,5797
1,2024-02-22,예술회관,25321,12425,12896
1,2024-02-22,인천터미널,26900,13343,13557
1,2024-02-22,문학경기장,3681,1894,1787
1,2024-02-22,선학,12493,6325,6168
1,2024-02-22,신연수,11581,5781,5800
1,2024-02-22,원인재,6038,3220,2818
1,2024-02-22,동춘,21969,10668,11301
1,2024-02-22,동막,11272,5875,5397
1,2024-02-22,캠퍼스타운,11856,5944,5912
1,2024-02-22,테크노파크,22947,11474,11473
1,2024-02-22,지식정보단지,10586,5136,5450
1,2024-02-22,인천대입구,15220,7654,7566
1,2024-02-22,센트럴파크(재외동포청),8137,4050,4087
1,2024-02-22,국제업무지구,4361,2215,2146
1,2024-02-22,송도달빛축제공원,10472,5299,5173
1,2024-02-23,계양,7897,3868,4029
1,2024-02-23,귤현,2278,929,1349
1,2024-02-23,박촌,8170,4214,3956
1,2024-02-23,임학,17404,8769,8635
1,2024-02-23,계산,20420,10501,9919
1,2024-02-23,경인교대입구,11222,5572,5650
1,2024-02-23,작전,29141,14779,14362
1,2024-02-23,갈산,19598,9989,9609
1,2024-02-23,부평구청,13700,6705,6995
1,2024-02-23,부평시장,27675,13749,13926
1,2024-02-23,부평,15103,7461,7642
1,2024-02-23,동수,8207,4182,4025
1,2024-02-23,부평삼거리,4731,2406,2325
1,2024-02-23,간석오거리,21789,11271,10518
1,2024-02-23,인천시청,11413,5826,5587
1,2024-02-23,예술회관,26180,12476,13704
1,2024-02-23,인천터미널,29934,14442,15492
1,2024-02-23,문학경기장,3755,1910,1845
1,2024-02-23,선학,12909,6432,6477
1,2024-02-23,신연수,10817,5558,5259
1,2024-02-23,원인재,6246,3310,2936
1,2024-02-23,동춘,22186,10881,11305
1,2024-02-23,동막,10556,5591,4965
1,2024-02-23,캠퍼스타운,11912,6139,5773
1,2024-02-23,테크노파크,23205,11789,11416
1,2024-02-23,지식정보단지,10190,5099,5091
1,2024-02-23,인천대입구,15134,8084,7050
1,2024-02-23,센트럴파크(재외동포청),8467,4245,4222
1,2024-02-23,국제업무지구,4108,2125,1983
1,2024-02-23,송도달빛축제공원,10963,5659,5304
1,2024-02-24,계양,6035,2897,3138
1,2024-02-24,귤현,1547,725,822
1,2024-02-24,박촌,5702,3046,2656
1,2024-02-24,임학,12429,6287,6142
1,2024-02-24,계산,18897,9500,9397
1,2024-02-24,경인교대입구,9504,4747,4757
1,2024-02-24,작전,22123,11453,10670
1,2024-02-24,갈산,11262,5708,5554
1,2024-02-24,부평구청,10143,5021,5122
1,2024-02-24,부평시장,19424,9681,9743
1,2024-02-24,부평,14742,7371,7371
1,2024-02-24,동수,5494,2836,2658
1,2024-02-24,부평삼거리,4342,2156,2186
1,2024-02-24,간석오거리,16652,8626,8026
1,2024-02-24,인천시청,7288,3815,3473
1,2024-02-24,예술회관,18989,8998,9991
1,2024-02-24,인천터미널,28365,13798,14567
1,2024-02-24,문학경기장,3058,1478,1580
1,2024-02-24,선학,10570,5223,5347
1,2024-02-24,신연수,6280,3348,2932
1,2024-02-24,원인재,3522,1928,1594
1,2024-02-24,동춘,15427,7698,7729
1,2024-02-24,동막,6856,3587,3269
1,2024-02-24,캠퍼스타운,7988,4151,3837
1,2024-02-24,테크노파크,19064,9558,9506
1,2024-02-24,지식정보단지,4240,2192,2048
1,2024-02-24,인천대입구,11588,5666,5922
1,2024-02-24,센트럴파크(재외동포청),7134,3561,3573
1,2024-02-24,국제업무지구,1891,999,892
1,2024-02-24,송도달빛축제공원,8358,4248,4110
1,2024-02-25,계양,4260,1969,2291
1,2024-02-25,귤현,1102,490,612
1,2024-02-25,박촌,4222,2231,1991
1,2024-02-25,임학,9139,4617,4522
1,2024-02-25,계산,12707,6291,6416
1,2024-02-25,경인교대입구,7283,3623,3660
1,2024-02-25,작전,14642,7402,7240
1,2024-02-25,갈산,7222,3709,3513
1,2024-02-25,부평구청,7440,3681,3759
1,2024-02-25,부평시장,14665,7374,7291
1,2024-02-25,부평,10137,5338,4799
1,2024-02-25,동수,4089,2075,2014
1,2024-02-25,부평삼거리,3035,1526,1509
1,2024-02-25,간석오거리,12248,6362,5886
1,2024-02-25,인천시청,5357,2655,2702
1,2024-02-25,예술회관,12886,6173,6713
1,2024-02-25,인천터미널,23112,11663,11449
1,2024-02-25,문학경기장,1505,746,759
1,2024-02-25,선학,7645,3753,3892
1,2024-02-25,신연수,4412,2248,2164
1,2024-02-25,원인재,2981,1554,1427
1,2024-02-25,동춘,9640,4775,4865
1,2024-02-25,동막,4625,2396,2229
1,2024-02-25,캠퍼스타운,5927,2957,2970
1,2024-02-25,테크노파크,15600,7779,7821
1,2024-02-25,지식정보단지,2972,1464,1508
1,2024-02-25,인천대입구,7778,3824,3954
1,2024-02-25,센트럴파크(재외동포청),4527,2212,2315
1,2024-02-25,국제업무지구,827,431,396
1,2024-02-25,송도달빛축제공원,6489,3217,3272
1,2024-02-26,계양,7422,3638,3784
1,2024-02-26,귤현,2258,896,1362
1,2024-02-26,박촌,7286,3804,3482
1,2024-02-26,임학,15901,8047,7854
1,2024-02-26,계산,18948,9558,9390
1,2024-02-26,경인교대입구,10770,5406,5364
1,2024-02-26,작전,27563,14016,13547
1,2024-02-26,갈산,19238,9726,9512
1,2024-02-26,부평구청,13795,6830,6965
1,2024-02-26,부평시장,26357,13253,13104
1,2024-02-26,부평,13706,6895,6811
1,2024-02-26,동수,8226,4168,4058
1,2024-02-26,부평삼거리,4742,2383,2359
1,2024-02-26,간석오거리,21330,11095,10235
1,2024-02-26,인천시청,10692,5358,5334
1,2024-02-26,예술회관,24047,11872,12175
1,2024-02-26,인천터미널,26316,12938,13378
1,2024-02-26,문학경기장,3656,1822,1834
1,2024-02-26,선학,11815,5953,5862
1,2024-02-26,신연수,10813,5495,5318
1,2024-02-26,원인재,5729,3045,2684
1,2024-02-26,동춘,20688,10102,10586
1,2024-02-26,동막,10119,5311,4808
1,2024-02-26,캠퍼스타운,11224,5679,5545
1,2024-02-26,테크노파크,21476,10789,10687
1,2024-02-26,지식정보단지,9937,4818,5119
1,2024-02-26,인천대입구,13072,6510,6562
1,2024-02-26,센트럴파크(재외동포청),7500,3732,3768
1,2024-02-26,국제업무지구,4000,2069,1931
1,2024-02-26,송도달빛축제공원,10326,5080,5246
1,2024-02-27,계양,7806,3844,3962
1,2024-02-27,귤현,2320,914,1406
1,2024-02-27,박촌,7293,3791,3502
1,2024-02-27,임학,16220,8163,8057
1,2024-02-27,계산,19449,9772,9677
1,2024-02-27,경인교대입구,10831,5285,5546
1,2024-02-27,작전,28001,14222,13779
1,2024-02-27,갈산,19439,9917,9522
1,2024-02-27,부평구청,14031,6920,7111
1,2024-02-27,부평시장,26976,13492,13484
1,2024-02-27,부평,13405,6691,6714
1,2024-02-27,동수,8311,4186,4125
1,2024-02-27,부평삼거리,4825,2408,2417
1,2024-02-27,간석오거리,21631,11240,10391
1,2024-02-27,인천시청,11159,5627,5532
1,2024-02-27,예술회관,24516,11953,12563
1,2024-02-27,인천터미널,26633,13078,13555
1,2024-02-27,문학경기장,3614,1823,1791
1,2024-02-27,선학,12053,6051,6002
1,2024-02-27,신연수,10976,5559,5417
1,2024-02-27,원인재,5909,3142,2767
1,2024-02-27,동춘,20787,10177,10610
1,2024-02-27,동막,10504,5574,4930
1,2024-02-27,캠퍼스타운,11447,5714,5733
1,2024-02-27,테크노파크,22394,11187,11207
1,2024-02-27,지식정보단지,9929,4827,5102
1,2024-02-27,인천대입구,13073,6496,6577
1,2024-02-27,센트럴파크(재외동포청),8017,4050,3967
1,2024-02-27,국제업무지구,4139,2118,2021
1,2024-02-27,송도달빛축제공원,10611,5398,5213
1,2024-02-28,계양,7691,3852,3839
1,2024-02-28,귤현,2295,902,1393
1,2024-02-28,박촌,7497,3930,3567
1,2024-02-28,임학,16393,8237,8156
1,2024-02-28,계산,19606,9923,9683
1,2024-02-28,경인교대입구,10639,5296,5343
1,2024-02-28,작전,28049,14160,13889
1,2024-02-28,갈산,19271,9735,9536
1,2024-02-28,부평구청,13648,6727,6921
1,2024-02-28,부평시장,27196,13608,13588
1,2024-02-28,부평,14031,6956,7075
1,2024-02-28,동수,8365,4272,4093
1,2024-02-28,부평삼거리,4928,2479,2449
1,2024-02-28,간석오거리,21936,11361,10575
1,2024-02-28,인천시청,10892,5476,5416
1,2024-02-28,예술회관,25563,12505,13058
1,2024-02-28,인천터미널,27092,13285,13807
1,2024-02-28,문학경기장,3651,1856,1795
1,2024-02-28,선학,12578,6273,6305
1,2024-02-28,신연수,10628,5452,5176
1,2024-02-28,원인재,6081,3286,2795
1,2024-02-28,동춘,20985,10265,10720
1,2024-02-28,동막,10415,5547,4868
1,2024-02-28,캠퍼스타운,11504,5804,5700
1,2024-02-28,테크노파크,22438,11246,11192
1,2024-02-28,지식정보단지,10121,4875,5246
1,2024-02-28,인천대입구,13450,6732,6718
1,2024-02-28,센트럴파크(재외동포청),8031,4000,4031
1,2024-02-28,국제업무지구,4082,2094,1988
1,2024-02-28,송도달빛축제공원,10640,5339,5301
1,2024-02-29,계양,7867,3902,3965
1,2024-02-29,귤현,2193,875,1318
1,2024-02-29,박촌,7415,3942,3473
1,2024-02-29,임학,16566,8340,8226
1,2024-02-29,계산,20268,10375,9893
1,2024-02-29,경인교대입구,11375,5882,5493
1,2024-02-29,작전,28505,14597,13908
1,2024-02-29,갈산,19215,9800,9415
1,2024-02-29,부평구청,13658,6786,6872
1,2024-02-29,부평시장,27323,13675,13648
1,2024-02-29,부평,14815,7243,7572
1,2024-02-29,동수,8326,4226,4100
1,2024-02-29,부평삼거리,5014,2552,2462
1,2024-02-29,간석오거리,21971,11548,10423
1,2024-02-29,인천시청,11600,5838,5762
1,2024-02-29,예술회관,25901,12396,13505
1,2024-02-29,인천터미널,30054,14411,15643
1,2024-02-29,문학경기장,3586,1790,1796
1,2024-02-29,선학,12688,6312,6376
1,2024-02-29,신연수,10589,5412,5177
1,2024-02-29,원인재,6095,3148,2947
1,2024-02-29,동춘,21643,10663,10980
1,2024-02-29,동막,10521,5627,4894
1,2024-02-29,캠퍼스타운,11932,6119,5813
1,2024-02-29,테크노파크,23152,11603,11549
1,2024-02-29,지식정보단지,9925,4855,5070
1,2024-02-29,인천대입구,13968,6896,7072
1,2024-02-29,센트럴파크(재외동포청),8120,3993,4127
1,2024-02-29,국제업무지구,4127,2132,1995
1,2024-02-29,송도달빛축제공원,10935,5539,5396
1,2024-03-01,계양,4994,2304,2690
1,2024-03-01,귤현,1176,548,628
1,2024-03-01,박촌,4682,2437,2245
1,2024-03-01,임학,10546,5379,5167
1,2024-03-01,계산,14324,7343,6981
1,2024-03-01,경인교대입구,7735,3864,3871
1,2024-03-01,작전,16667,8622,8045
1,2024-03-01,갈산,8222,4219,4003
1,2024-03-01,부평구청,7964,3907,4057
1,2024-03-01,부평시장,15900,7921,7979
1,2024-03-01,부평,11936,6151,5785
1,2024-03-01,동수,4578,2341,2237
1,2024-03-01,부평삼거리,3583,1792,1791
1,2024-03-01,간석오거리,14169,7373,6796
1,2024-03-01,인천시청,5911,3054,2857
1,2024-03-01,예술회관,15844,7513,8331
1,2024-03-01,인천터미널,26048,12424,13624
1,2024-03-01,문학경기장,2189,1081,1108
1,2024-03-01,선학,9153,4543,4610
1,2024-03-01,신연수,5284,2794,2490
1,2024-03-01,원인재,3458,1844,1614
1,2024-03-01,동춘,14111,6988,7123
1,2024-03-01,동막,5312,2765,2547
1,2024-03-01,캠퍼스타운,7393,3808,3585
1,2024-03-01,테크노파크,19322,9740,9582
1,2024-03-01,지식정보단지,3889,2024,1865
1,2024-03-01,인천대입구,10616,5170,5446
1,2024-03-01,센트럴파크(재외동포청),5798,2776,3022
1,2024-03-01,국제업무지구,1585,846,739
1,2024-03-01,송도달빛축제공원,7378,3770,3608
1,2024-03-02,계양,5059,2472,2587
1,2024-03-02,귤현,1289,587,702
1,2024-03-02,박촌,4728,2476,2252
1,2024-03-02,임학,10923,5565,5358
1,2024-03-02,계산,14421,7235,7186
1,2024-03-02,경인교대입구,7738,3859,3879
1,2024-03-02,작전,18848,9567,9281
1,2024-03-02,갈산,8652,4486,4166
1,2024-03-02,부평구청,8510,4163,4347
1,2024-03-02,부평시장,16620,8255,8365
1,2024-03-02,부평,12493,6367,6126
1,2024-03-02,동수,4825,2475,2350
1,2024-03-02,부평삼거리,3533,1760,1773
1,2024-03-02,간석오거리,14772,7644,7128
1,2024-03-02,인천시청,5978,3114,2864
1,2024-03-02,예술회관,16122,7593,8529
1,2024-03-02,인천터미널,25361,12623,12738
1,2024-03-02,문학경기장,2410,1203,1207
1,2024-03-02,선학,8916,4473,4443
1,2024-03-02,신연수,5428,2794,2634
1,2024-03-02,원인재,2901,1561,1340
1,2024-03-02,동춘,14609,7178,7431
1,2024-03-02,동막,5435,2880,2555
1,2024-03-02,캠퍼스타운,8041,4187,3854
1,2024-03-02,테크노파크,18882,9402,9480
1,2024-03-02,지식정보단지,3615,1849,1766
1,2024-03-02,인천대입구,10149,4934,5215
1,2024-03-02,센트럴파크(재외동포청),5782,2837,2945
1,2024-03-02,국제업무지구,1664,892,772
1,2024-03-02,송도달빛축제공원,7429,3826,3603
1,2024-03-03,계양,4098,1925,2173
1,2024-03-03,귤현,963,464,499
1,2024-03-03,박촌,3971,2076,1895
1,2024-03-03,임학,8579,4355,4224
1,2024-03-03,계산,12319,6123,6196
1,2024-03-03,경인교대입구,7085,3456,3629
1,2024-03-03,작전,14194,7211,6983
1,2024-03-03,갈산,6367,3228,3139
1,2024-03-03,부평구청,6719,3288,3431
1,2024-03-03,부평시장,13968,7002,6966
1,2024-03-03,부평,9245,4869,4376
1,2024-03-03,동수,4109,2082,2027
1,2024-03-03,부평삼거리,3215,1637,1578
1,2024-03-03,간석오거리,12146,6328,5818
1,2024-03-03,인천시청,4909,2539,2370
1,2024-03-03,예술회관,11608,5682,5926
1,2024-03-03,인천터미널,22681,11549,11132
1,2024-03-03,문학경기장,1571,769,802
1,2024-03-03,선학,7711,3783,3928
1,2024-03-03,신연수,4463,2277,2186
1,2024-03-03,원인재,2741,1433,1308
1,2024-03-03,동춘,11453,5655,5798
1,2024-03-03,동막,4027,2065,1962
1,2024-03-03,캠퍼스타운,6284,3087,3197
1,2024-03-03,테크노파크,15381,7540,7841
1,2024-03-03,지식정보단지,2688,1267,1421
1,2024-03-03,인천대입구,8192,3955,4237
1,2024-03-03,센트럴파크(재외동포청),4226,2077,2149
1,2024-03-03,국제업무지구,803,414,389
1,2024-03-03,송도달빛축제공원,6156,3044,3112
1,2024-03-04,계양,7718,3836,3882
1,2024-03-04,귤현,2418,972,1446
1,2024-03-04,박촌,8085,4216,3869
1,2024-03-04,임학,16704,8400,8304
1,2024-03-04,계산,21881,11197,10684
1,2024-03-04,경인교대입구,11818,5901,5917
1,2024-03-04,작전,28500,14367,14133
1,2024-03-04,갈산,19235,9781,9454
1,2024-03-04,부평구청,13529,6630,6899
1,2024-03-04,부평시장,26917,13470,13447
1,2024-03-04,부평,12857,6310,6547
1,2024-03-04,동수,8135,4193,3942
1,2024-03-04,부평삼거리,5150,2613,2537
1,2024-03-04,간석오거리,21738,11358,10380
1,2024-03-04,인천시청,10984,5623,5361
1,2024-03-04,예술회관,24284,12033,12251
1,2024-03-04,인천터미널,23339,11315,12024
1,2024-03-04,문학경기장,3620,1768,1852
1,2024-03-04,선학,11977,6038,5939
1,2024-03-04,신연수,11809,5997,5812
1,2024-03-04,원인재,5874,3110,2764
1,2024-03-04,동춘,20178,9901,10277
1,2024-03-04,동막,10460,5564,4896
1,2024-03-04,캠퍼스타운,12317,6149,6168
1,2024-03-04,테크노파크,21892,10929,10963
1,2024-03-04,지식정보단지,10906,5326,5580
1,2024-03-04,인천대입구,19501,9671,9830
1,2024-03-04,센트럴파크(재외동포청),7291,3656,3635
1,2024-03-04,국제업무지구,4118,2116,2002
1,2024-03-04,송도달빛축제공원,10654,5335,5319
1,2024-03-05,계양,8045,3991,4054
1,2024-03-05,귤현,2420,966,1454
1,2024-03-05,박촌,8275,4334,3941
1,2024-03-05,임학,16872,8526,8346
1,2024-03-05,계산,21339,10875,10464
1,2024-03-05,경인교대입구,11767,5851,5916
1,2024-03-05,작전,29289,14776,14513
1,2024-03-05,갈산,19788,10049,9739
1,2024-03-05,부평구청,13809,6723,7086
1,2024-03-05,부평시장,27326,13668,13658
1,2024-03-05,부평,12770,6458,6312
1,2024-03-05,동수,8474,4324,4150
1,2024-03-05,부평삼거리,5353,2679,2674
1,2024-03-05,간석오거리,21955,11432,10523
1,2024-03-05,인천시청,11456,5803,5653
1,2024-03-05,예술회관,24193,11918,12275
1,2024-03-05,인천터미널,25910,12710,13200
1,2024-03-05,문학경기장,3771,1841,1930
1,2024-03-05,선학,12381,6190,6191
1,2024-03-05,신연수,11914,6055,5859
1,2024-03-05,원인재,6063,3243,2820
1,2024-03-05,동춘,20146,9870,10276
1,2024-03-05,동막,10545,5573,4972
1,2024-03-05,캠퍼스타운,12564,6410,6154
1,2024-03-05,테크노파크,21706,10959,10747
1,2024-03-05,지식정보단지,11077,5409,5668
1,2024-03-05,인천대입구,20063,10009,10054
1,2024-03-05,센트럴파크(재외동포청),7440,3723,3717
1,2024-03-05,국제업무지구,4139,2088,2051
1,2024-03-05,송도달빛축제공원,10923,5469,5454
1,2024-03-06,계양,8373,4164,4209
1,2024-03-06,귤현,2546,1001,1545
1,2024-03-06,박촌,8359,4367,3992
1,2024-03-06,임학,17141,8612,8529
1,2024-03-06,계산,22158,11182,10976
1,2024-03-06,경인교대입구,11770,5895,5875
1,2024-03-06,작전,29640,14926,14714
1,2024-03-06,갈산,19939,10100,9839
1,2024-03-06,부평구청,14180,7015,7165
1,2024-03-06,부평시장,27743,13857,13886
1,2024-03-06,부평,13481,6659,6822
1,2024-03-06,동수,8547,4321,4226
1,2024-03-06,부평삼거리,5464,2740,2724
1,2024-03-06,간석오거리,22814,11777,11037
1,2024-03-06,인천시청,11704,5905,5799
1,2024-03-06,예술회관,25241,12406,12835
1,2024-03-06,인천터미널,26899,13265,13634
1,2024-03-06,문학경기장,3838,1917,1921
1,2024-03-06,선학,12767,6394,6373
1,2024-03-06,신연수,12331,6257,6074
1,2024-03-06,원인재,6282,3372,2910
1,2024-03-06,동춘,21013,10357,10656
1,2024-03-06,동막,11161,5931,5230
1,2024-03-06,캠퍼스타운,13068,6551,6517
1,2024-03-06,테크노파크,22922,11559,11363
1,2024-03-06,지식정보단지,11516,5572,5944
1,2024-03-06,인천대입구,20159,10089,10070
1,2024-03-06,센트럴파크(재외동포청),7901,3979,3922
1,2024-03-06,국제업무지구,4141,2133,2008
1,2024-03-06,송도달빛축제공원,11310,5618,5692
1,2024-03-07,계양,8364,4127,4237
1,2024-03-07,귤현,2530,951,1579
1,2024-03-07,박촌,8399,4368,4031
1,2024-03-07,임학,17041,8573,8468
1,2024-03-07,계산,21687,10981,10706
1,2024-03-07,경인교대입구,11931,6013,5918
1,2024-03-07,작전,29031,14666,14365
1,2024-03-07,갈산,19803,10072,9731
1,2024-03-07,부평구청,14213,6937,7276
1,2024-03-07,부평시장,27719,13901,13818
1,2024-03-07,부평,13089,6612,6477
1,2024-03-07,동수,8606,4385,4221
1,2024-03-07,부평삼거리,5460,2765,2695
1,2024-03-07,간석오거리,22306,11635,10671
1,2024-03-07,인천시청,11370,5753,5617
1,2024-03-07,예술회관,24938,12209,12729
1,2024-03-07,인천터미널,27358,13523,13835
1,2024-03-07,문학경기장,3640,1867,1773
1,2024-03-07,선학,12770,6380,6390
1,2024-03-07,신연수,11952,6057,5895
1,2024-03-07,원인재,6249,3313,2936
1,2024-03-07,동춘,20846,10195,10651
1,2024-03-07,동막,10608,5612,4996
1,2024-03-07,캠퍼스타운,13403,7091,6312
1,2024-03-07,테크노파크,22473,11311,11162
1,2024-03-07,지식정보단지,11341,5539,5802
1,2024-03-07,인천대입구,20425,10202,10223
1,2024-03-07,센트럴파크(재외동포청),7746,3866,3880
1,2024-03-07,국제업무지구,4169,2125,2044
1,2024-03-07,송도달빛축제공원,10849,5351,5498
1,2024-03-08,계양,8270,4117,4153
1,2024-03-08,귤현,2469,981,1488
1,2024-03-08,박촌,8485,4404,4081
1,2024-03-08,임학,17124,8635,8489
1,2024-03-08,계산,21903,11190,10713
1,2024-03-08,경인교대입구,12145,6070,6075
1,2024-03-08,작전,29379,14866,14513
1,2024-03-08,갈산,20051,10180,9871
1,2024-03-08,부평구청,14593,7131,7462
1,2024-03-08,부평시장,28234,14045,14189
1,2024-03-08,부평,14581,7194,7387
1,2024-03-08,동수,8590,4394,4196
1,2024-03-08,부평삼거리,5474,2795,2679
1,2024-03-08,간석오거리,22263,11695,10568
1,2024-03-08,인천시청,11871,5924,5947
1,2024-03-08,예술회관,26466,12839,13627
1,2024-03-08,인천터미널,31024,15234,15790
1,2024-03-08,문학경기장,3879,1969,1910
1,2024-03-08,선학,13410,6691,6719
1,2024-03-08,신연수,11674,6019,5655
1,2024-03-08,원인재,6215,3284,2931
1,2024-03-08,동춘,21971,10688,11283
1,2024-03-08,동막,11230,5963,5267
1,2024-03-08,캠퍼스타운,13866,7428,6438
1,2024-03-08,테크노파크,23873,12059,11814
1,2024-03-08,지식정보단지,11138,5452,5686
1,2024-03-08,인천대입구,19308,9742,9566
1,2024-03-08,센트럴파크(재외동포청),8006,3983,4023
1,2024-03-08,국제업무지구,4216,2176,2040
1,2024-03-08,송도달빛축제공원,11127,5605,5522
1,2024-03-09,계양,6192,2983,3209
1,2024-03-09,귤현,1520,737,783
1,2024-03-09,박촌,5876,3070,2806
1,2024-03-09,임학,12758,6477,6281
1,2024-03-09,계산,18524,9257,9267
1,2024-03-09,경인교대입구,9483,4768,4715
1,2024-03-09,작전,22908,11709,11199
1,2024-03-09,갈산,10293,5324,4969
1,2024-03-09,부평구청,10335,5048,5287
1,2024-03-09,부평시장,19382,9678,9704
1,2024-03-09,부평,14147,7039,7108
1,2024-03-09,동수,5632,2894,2738
1,2024-03-09,부평삼거리,4212,2102,2110
1,2024-03-09,간석오거리,16534,8620,7914
1,2024-03-09,인천시청,7633,3940,3693
1,2024-03-09,예술회관,18828,8834,9994
1,2024-03-09,인천터미널,28826,14167,14659
1,2024-03-09,문학경기장,2912,1422,1490
1,2024-03-09,선학,10777,5451,5326
1,2024-03-09,신연수,6348,3349,2999
1,2024-03-09,원인재,3740,1992,1748
1,2024-03-09,동춘,15644,7718,7926
1,2024-03-09,동막,6629,3585,3044
1,2024-03-09,캠퍼스타운,8822,4660,4162
1,2024-03-09,테크노파크,19409,9618,9791
1,2024-03-09,지식정보단지,4236,2178,2058
1,2024-03-09,인천대입구,11195,5677,5518
1,2024-03-09,센트럴파크(재외동포청),6928,3398,3530
1,2024-03-09,국제업무지구,1964,1030,934
1,2024-03-09,송도달빛축제공원,8426,4289,4137
1,2024-03-10,계양,4645,2161,2484
1,2024-03-10,귤현,1052,482,570
1,2024-03-10,박촌,4325,2280,2045
1,2024-03-10,임학,9380,4713,4667
1,2024-03-10,계산,13503,6702,6801
1,2024-03-10,경인교대입구,7595,3747,3848
1,2024-03-10,작전,15206,7803,7403
1,2024-03-10,갈산,6583,3375,3208
1,2024-03-10,부평구청,7245,3636,3609
1,2024-03-10,부평시장,15147,7531,7616
1,2024-03-10,부평,10041,5313,4728
1,2024-03-10,동수,4101,2044,2057
1,2024-03-10,부평삼거리,3457,1691,1766
1,2024-03-10,간석오거리,12522,6489,6033
1,2024-03-10,인천시청,5422,2751,2671
1,2024-03-10,예술회관,12579,6123,6456
1,2024-03-10,인천터미널,23185,11580,11605
1,2024-03-10,문학경기장,1343,677,666
1,2024-03-10,선학,8162,4041,4121
1,2024-03-10,신연수,4687,2397,2290
1,2024-03-10,원인재,2612,1385,1227
1,2024-03-10,동춘,9605,4766,4839
1,2024-03-10,동막,4452,2307,2145
1,2024-03-10,캠퍼스타운,6784,3229,3555
1,2024-03-10,테크노파크,15887,7918,7969
1,2024-03-10,지식정보단지,3026,1466,1560
1,2024-03-10,인천대입구,8331,3929,4402
1,2024-03-10,센트럴파크(재외동포청),4598,2275,2323
1,2024-03-10,국제업무지구,871,452,419
1,2024-03-10,송도달빛축제공원,6460,3187,3273
1,2024-03-11,계양,8046,4011,4035
1,2024-03-11,귤현,2432,952,1480
1,2024-03-11,박촌,8129,4232,3897
1,2024-03-11,임학,16695,8415,8280
1,2024-03-11,계산,21670,11072,10598
1,2024-03-11,경인교대입구,11777,5903,5874
1,2024-03-11,작전,28720,14510,14210
1,2024-03-11,갈산,19462,9897,9565
1,2024-03-11,부평구청,13749,6715,7034
1,2024-03-11,부평시장,26865,13463,13402
1,2024-03-11,부평,12744,6298,6446
1,2024-03-11,동수,8375,4242,4133
1,2024-03-11,부평삼거리,5272,2668,2604
1,2024-03-11,간석오거리,21566,11263,10303
1,2024-03-11,인천시청,11342,5725,5617
1,2024-03-11,예술회관,24301,12001,12300
1,2024-03-11,인천터미널,26169,12674,13495
1,2024-03-11,문학경기장,3915,1928,1987
1,2024-03-11,선학,12057,6089,5968
1,2024-03-11,신연수,11840,5958,5882
1,2024-03-11,원인재,5725,3018,2707
1,2024-03-11,동춘,20436,9988,10448
1,2024-03-11,동막,10782,5712,5070
1,2024-03-11,캠퍼스타운,12900,6433,6467
1,2024-03-11,테크노파크,21361,10726,10635
1,2024-03-11,지식정보단지,11199,5431,5768
1,2024-03-11,인천대입구,19633,9799,9834
1,2024-03-11,센트럴파크(재외동포청),7367,3705,3662
1,2024-03-11,국제업무지구,4193,2145,2048
1,2024-03-11,송도달빛축제공원,10735,5409,5326
1,2024-03-12,계양,8114,4049,4065
1,2024-03-12,귤현,2460,982,1478
1,2024-03-12,박촌,8143,4263,3880
1,2024-03-12,임학,16783,8457,8326
1,2024-03-12,계산,20732,10589,10143
1,2024-03-12,경인교대입구,11484,5764,5720
1,2024-03-12,작전,29050,14662,14388
1,2024-03-12,갈산,19447,9837,9610
1,2024-03-12,부평구청,13956,6841,7115
1,2024-03-12,부평시장,26846,13491,13355
1,2024-03-12,부평,12746,6402,6344
1,2024-03-12,동수,8531,4304,4227
1,2024-03-12,부평삼거리,5174,2578,2596
1,2024-03-12,간석오거리,21981,11444,10537
1,2024-03-12,인천시청,11277,5709,5568
1,2024-03-12,예술회관,24368,12094,12274
1,2024-03-12,인천터미널,25779,12609,13170
1,2024-03-12,문학경기장,3731,1845,1886
1,2024-03-12,선학,12110,6032,6078
1,2024-03-12,신연수,11958,6047,5911
1,2024-03-12,원인재,5819,3096,2723
1,2024-03-12,동춘,20290,9938,10352
1,2024-03-12,동막,10637,5620,5017
1,2024-03-12,캠퍼스타운,12569,6390,6179
1,2024-03-12,테크노파크,21375,10707,10668
1,2024-03-12,지식정보단지,10829,5233,5596
1,2024-03-12,인천대입구,17269,8673,8596
1,2024-03-12,센트럴파크(재외동포청),7637,3830,3807
1,2024-03-12,국제업무지구,4205,2148,2057
1,2024-03-12,송도달빛축제공원,10558,5286,5272
1,2024-03-13,계양,8408,4219,4189
1,2024-03-13,귤현,2539,1004,1535
1,2024-03-13,박촌,8415,4393,4022
1,2024-03-13,임학,17271,8709,8562
1,2024-03-13,계산,22424,11475,10949
1,2024-03-13,경인교대입구,12030,5967,6063
1,2024-03-13,작전,29824,15011,14813
1,2024-03-13,갈산,19974,10166,9808
1,2024-03-13,부평구청,14195,6972,7223
1,2024-03-13,부평시장,28064,14063,14001
1,2024-03-13,부평,13589,6869,6720
1,2024-03-13,동수,8461,4297,4164
1,2024-03-13,부평삼거리,5410,2718,2692
1,2024-03-13,간석오거리,22581,11778,10803
1,2024-03-13,인천시청,11679,5904,5775
1,2024-03-13,예술회관,25485,12432,13053
1,2024-03-13,인천터미널,26787,13079,13708
1,2024-03-13,문학경기장,3680,1837,1843
1,2024-03-13,선학,12982,6546,6436
1,2024-03-13,신연수,12325,6250,6075
1,2024-03-13,원인재,5983,3200,2783
1,2024-03-13,동춘,20938,10341,10597
1,2024-03-13,동막,11217,5986,5231
1,2024-03-13,캠퍼스타운,13095,6684,6411
1,2024-03-13,테크노파크,22631,11360,11271
1,2024-03-13,지식정보단지,11372,5526,5846
1,2024-03-13,인천대입구,20170,10013,10157
1,2024-03-13,센트럴파크(재외동포청),7973,3963,4010
1,2024-03-13,국제업무지구,4302,2187,2115
1,2024-03-13,송도달빛축제공원,11000,5542,5458
1,2024-03-14,계양,8505,4205,4300
1,2024-03-14,귤현,2592,1009,1583
1,2024-03-14,박촌,8338,4342,3996
1,2024-03-14,임학,17387,8704,8683
1,2024-03-14,계산,22106,11248,10858
1,2024-03-14,경인교대입구,12131,6105,6026
1,2024-03-14,작전,29549,14896,14653
1,2024-03-14,갈산,19951,10102,9849
1,2024-03-14,부평구청,14230,6989,7241
1,2024-03-14,부평시장,27681,13922,13759
1,2024-03-14,부평,13840,6931,6909
1,2024-03-14,동수,8574,4337,4237
1,2024-03-14,부평삼거리,5750,2869,2881
1,2024-03-14,간석오거리,22400,11685,10715
1,2024-03-14,인천시청,11838,5886,5952
1,2024-03-14,예술회관,24943,12133,12810
1,2024-03-14,인천터미널,27805,13862,13943
1,2024-03-14,문학경기장,6734,3371,3363
1,2024-03-14,선학,13017,6500,6517
1,2024-03-14,신연수,12250,6215,6035
1,2024-03-14,원인재,6089,3242,2847
1,2024-03-14,동춘,20876,10260,10616
1,2024-03-14,동막,10822,5702,5120
1,2024-03-14,캠퍼스타운,13939,7402,6537
1,2024-03-14,테크노파크,22907,11464,11443
1,2024-03-14,지식정보단지,11369,5606,5763
1,2024-03-14,인천대입구,20023,10049,9974
1,2024-03-14,센트럴파크(재외동포청),8495,4159,4336
1,2024-03-14,국제업무지구,4229,2143,2086
1,2024-03-14,송도달빛축제공원,11158,5610,5548
1,2024-03-15,계양,8518,4232,4286
1,2024-03-15,귤현,2589,1007,1582
1,2024-03-15,박촌,8456,4456,4000
1,2024-03-15,임학,17615,8792,8823
1,2024-03-15,계산,22156,11189,10967
1,2024-03-15,경인교대입구,11938,6062,5876
1,2024-03-15,작전,30232,15315,14917
1,2024-03-15,갈산,20027,10240,9787
1,2024-03-15,부평구청,14614,7189,7425
1,2024-03-15,부평시장,28721,14287,14434
1,2024-03-15,부평,15279,7485,7794
1,2024-03-15,동수,8534,4350,4184
1,2024-03-15,부평삼거리,5723,2922,2801
1,2024-03-15,간석오거리,22360,11737,10623
1,2024-03-15,인천시청,11844,5967,5877
1,2024-03-15,예술회관,25992,12501,13491
1,2024-03-15,인천터미널,32250,15772,16478
1,2024-03-15,문학경기장,6038,3089,2949
1,2024-03-15,선학,13672,6892,6780
1,2024-03-15,신연수,11963,6162,5801
1,2024-03-15,원인재,6197,3308,2889
1,2024-03-15,동춘,21771,10551,11220
1,2024-03-15,동막,11218,5975,5243
1,2024-03-15,캠퍼스타운,13629,7085,6544
1,2024-03-15,테크노파크,23785,11984,11801
1,2024-03-15,지식정보단지,11220,5499,5721
1,2024-03-15,인천대입구,19106,9756,9350
1,2024-03-15,센트럴파크(재외동포청),8558,4210,4348
1,2024-03-15,국제업무지구,4220,2152,2068
1,2024-03-15,송도달빛축제공원,11574,5798,5776
1,2024-03-16,계양,6843,3272,3571
1,2024-03-16,귤현,1604,747,857
1,2024-03-16,박촌,6050,3182,2868
1,2024-03-16,임학,13342,6819,6523
1,2024-03-16,계산,19441,9602,9839
1,2024-03-16,경인교대입구,9426,4773,4653
1,2024-03-16,작전,23607,12113,11494
1,2024-03-16,갈산,10606,5504,5102
1,2024-03-16,부평구청,10669,5266,5403
1,2024-03-16,부평시장,20459,10383,10076
1,2024-03-16,부평,14317,6994,7323
1,2024-03-16,동수,5437,2777,2660
1,2024-03-16,부평삼거리,4299,2139,2160
1,2024-03-16,간석오거리,16962,8787,8175
1,2024-03-16,인천시청,7903,4129,3774
1,2024-03-16,예술회관,18665,8791,9874
1,2024-03-16,인천터미널,30076,14750,15326
1,2024-03-16,문학경기장,7962,3854,4108
1,2024-03-16,선학,11071,5564,5507
1,2024-03-16,신연수,6679,3510,3169
1,2024-03-16,원인재,3971,2113,1858
1,2024-03-16,동춘,16240,8053,8187
1,2024-03-16,동막,6895,3638,3257
1,2024-03-16,캠퍼스타운,9230,4704,4526
1,2024-03-16,테크노파크,20364,10084,10280
1,2024-03-16,지식정보단지,4422,2259,2163
1,2024-03-16,인천대입구,11956,6118,5838
1,2024-03-16,센트럴파크(재외동포청),8406,4085,4321
1,2024-03-16,국제업무지구,2061,1084,977
1,2024-03-16,송도달빛축제공원,9176,4704,4472
1,2024-03-17,계양,4793,2267,2526
1,2024-03-17,귤현,1170,571,599
1,2024-03-17,박촌,4321,2289,2032
1,2024-03-17,임학,9324,4817,4507
1,2024-03-17,계산,14234,7122,7112
1,2024-03-17,경인교대입구,7521,3763,3758
1,2024-03-17,작전,15338,7862,7476
1,2024-03-17,갈산,7020,3570,3450
1,2024-03-17,부평구청,7458,3661,3797
1,2024-03-17,부평시장,14941,7477,7464
1,2024-03-17,부평,9770,5129,4641
1,2024-03-17,동수,4208,2159,2049
1,2024-03-17,부평삼거리,3526,1762,1764
1,2024-03-17,간석오거리,12732,6574,6158
1,2024-03-17,인천시청,5821,2949,2872
1,2024-03-17,예술회관,12287,5969,6318
1,2024-03-17,인천터미널,24226,12323,11903
1,2024-03-17,문학경기장,6653,3316,3337
1,2024-03-17,선학,8355,4128,4227
1,2024-03-17,신연수,4841,2415,2426
1,2024-03-17,원인재,2503,1297,1206
1,2024-03-17,동춘,11621,5749,5872
1,2024-03-17,동막,4391,2333,2058
1,2024-03-17,캠퍼스타운,6891,3210,3681
1,2024-03-17,테크노파크,15503,7613,7890
1,2024-03-17,지식정보단지,2957,1462,1495
1,2024-03-17,인천대입구,8397,3966,4431
1,2024-03-17,센트럴파크(재외동포청),5018,2451,2567
1,2024-03-17,국제업무지구,841,438,403
1,2024-03-17,송도달빛축제공원,6422,3163,3259
1,2024-03-18,계양,8044,3992,4052
1,2024-03-18,귤현,2538,1023,1515
1,2024-03-18,박촌,8259,4277,3982
1,2024-03-18,임학,16614,8365,8249
1,2024-03-18,계산,21949,11221,10728
1,2024-03-18,경인교대입구,11852,5924,5928
1,2024-03-18,작전,29145,14730,14415
1,2024-03-18,갈산,19417,9887,9530
1,2024-03-18,부평구청,13687,6687,7000
1,2024-03-18,부평시장,27456,13836,13620
1,2024-03-18,부평,12987,6478,6509
1,2024-03-18,동수,8361,4212,4149
1,2024-03-18,부평삼거리,5436,2788,2648
1,2024-03-18,간석오거리,22125,11514,10611
1,2024-03-18,인천시청,11154,5593,5561
1,2024-03-18,예술회관,23806,11814,11992
1,2024-03-18,인천터미널,26925,13077,13848
1,2024-03-18,문학경기장,5961,2921,3040
1,2024-03-18,선학,12157,6089,6068
1,2024-03-18,신연수,12039,6049,5990
1,2024-03-18,원인재,5670,3008,2662
1,2024-03-18,동춘,20225,9901,10324
1,2024-03-18,동막,11111,5918,5193
1,2024-03-18,캠퍼스타운,13107,6525,6582
1,2024-03-18,테크노파크,21822,10954,10868
1,2024-03-18,지식정보단지,11146,5412,5734
1,2024-03-18,인천대입구,19636,9739,9897
1,2024-03-18,센트럴파크(재외동포청),7580,3835,3745
1,2024-03-18,국제업무지구,4018,2036,1982
1,2024-03-18,송도달빛축제공원,10889,5500,5389
1,2024-03-19,계양,8183,4100,4083
1,2024-03-19,귤현,2506,981,1525
1,2024-03-19,박촌,8311,4339,3972
1,2024-03-19,임학,16464,8268,8196
1,2024-03-19,계산,21000,10641,10359
1,2024-03-19,경인교대입구,11579,5785,5794
1,2024-03-19,작전,28736,14544,14192
1,2024-03-19,갈산,19990,10113,9877
1,2024-03-19,부평구청,13925,6785,7140
1,2024-03-19,부평시장,27390,13721,13669
1,2024-03-19,부평,12762,6335,6427
1,2024-03-19,동수,8458,4300,4158
1,2024-03-19,부평삼거리,5255,2630,2625
1,2024-03-19,간석오거리,22228,11522,10706
1,2024-03-19,인천시청,11324,5687,5637
1,2024-03-19,예술회관,24319,12063,12256
1,2024-03-19,인천터미널,25830,12710,13120
1,2024-03-19,문학경기장,4710,2288,2422
1,2024-03-19,선학,12380,6172,6208
1,2024-03-19,신연수,12070,6159,5911
1,2024-03-19,원인재,5836,3170,2666
1,2024-03-19,동춘,20261,9937,10324
1,2024-03-19,동막,10999,5763,5236
1,2024-03-19,캠퍼스타운,12572,6378,6194
1,2024-03-19,테크노파크,21893,10972,10921
1,2024-03-19,지식정보단지,11174,5410,5764
1,2024-03-19,인천대입구,20056,10045,10011
1,2024-03-19,센트럴파크(재외동포청),7603,3779,3824
1,2024-03-19,국제업무지구,4279,2179,2100
1,2024-03-19,송도달빛축제공원,10713,5342,5371
1,2024-03-20,계양,8175,4097,4078
1,2024-03-20,귤현,2579,1009,1570
1,2024-03-20,박촌,8586,4485,4101
1,2024-03-20,임학,17155,8645,8510
1,2024-03-20,계산,22120,11182,10938
1,2024-03-20,경인교대입구,11956,5974,5982
1,2024-03-20,작전,29463,14922,14541
1,2024-03-20,갈산,20088,10276,9812
1,2024-03-20,부평구청,13933,6871,7062
1,2024-03-20,부평시장,27249,13694,13555
1,2024-03-20,부평,13510,6738,6772
1,2024-03-20,동수,8611,4354,4257
1,2024-03-20,부평삼거리,5204,2616,2588
1,2024-03-20,간석오거리,22488,11697,10791
1,2024-03-20,인천시청,11644,5871,5773
1,2024-03-20,예술회관,24778,12194,12584
1,2024-03-20,인천터미널,26366,12985,13381
1,2024-03-20,문학경기장,3649,1850,1799
1,2024-03-20,선학,12859,6438,6421
1,2024-03-20,신연수,12316,6316,6000
1,2024-03-20,원인재,6079,3289,2790
1,2024-03-20,동춘,20658,10056,10602
1,2024-03-20,동막,11205,5923,5282
1,2024-03-20,캠퍼스타운,12971,6630,6341
1,2024-03-20,테크노파크,22635,11412,11223
1,2024-03-20,지식정보단지,11438,5534,5904
1,2024-03-20,인천대입구,20221,10084,10137
1,2024-03-20,센트럴파크(재외동포청),7836,3932,3904
1,2024-03-20,국제업무지구,4241,2148,2093
1,2024-03-20,송도달빛축제공원,10991,5448,5543
1,2024-03-21,계양,8367,4129,4238
1,2024-03-21,귤현,2632,1035,1597
1,2024-03-21,박촌,8650,4518,4132
1,2024-03-21,임학,17107,8634,8473
1,2024-03-21,계산,22325,11250,11075
1,2024-03-21,경인교대입구,11992,6094,5898
1,2024-03-21,작전,29755,15069,14686
1,2024-03-21,갈산,20009,10154,9855
1,2024-03-21,부평구청,14354,6963,7391
1,2024-03-21,부평시장,28431,14161,14270
1,2024-03-21,부평,13775,6888,6887
1,2024-03-21,동수,8608,4315,4293
1,2024-03-21,부평삼거리,5460,2753,2707
1,2024-03-21,간석오거리,22349,11661,10688
1,2024-03-21,인천시청,11791,5978,5813
1,2024-03-21,예술회관,25223,12442,12781
1,2024-03-21,인천터미널,27592,13708,13884
1,2024-03-21,문학경기장,4008,2113,1895
1,2024-03-21,선학,12570,6266,6304
1,2024-03-21,신연수,12153,6110,6043
1,2024-03-21,원인재,6267,3312,2955
1,2024-03-21,동춘,20921,10277,10644
1,2024-03-21,동막,10924,5800,5124
1,2024-03-21,캠퍼스타운,13568,7178,6390
1,2024-03-21,테크노파크,22763,11529,11234
1,2024-03-21,지식정보단지,11556,5572,5984
1,2024-03-21,인천대입구,20653,10510,10143
1,2024-03-21,센트럴파크(재외동포청),8035,3960,4075
1,2024-03-21,국제업무지구,4215,2168,2047
1,2024-03-21,송도달빛축제공원,11178,5568,5610
1,2024-03-22,계양,8140,4065,4075
1,2024-03-22,귤현,2531,988,1543
1,2024-03-22,박촌,8494,4409,4085
1,2024-03-22,임학,17133,8587,8546
1,2024-03-22,계산,21278,10811,10467
1,2024-03-22,경인교대입구,11494,5786,5708
1,2024-03-22,작전,29397,14929,14468
1,2024-03-22,갈산,19879,10144,9735
1,2024-03-22,부평구청,14098,6891,7207
1,2024-03-22,부평시장,27742,13742,14000
1,2024-03-22,부평,14738,7180,7558
1,2024-03-22,동수,8341,4290,4051
1,2024-03-22,부평삼거리,4977,2521,2456
1,2024-03-22,간석오거리,22148,11575,10573
1,2024-03-22,인천시청,11701,5966,5735
1,2024-03-22,예술회관,25769,12506,13263
1,2024-03-22,인천터미널,30605,15061,15544
1,2024-03-22,문학경기장,3922,2008,1914
1,2024-03-22,선학,13104,6561,6543
1,2024-03-22,신연수,11496,5866,5630
1,2024-03-22,원인재,6211,3266,2945
1,2024-03-22,동춘,21461,10443,11018
1,2024-03-22,동막,11190,5962,5228
1,2024-03-22,캠퍼스타운,13608,7187,6421
1,2024-03-22,테크노파크,22987,11559,11428
1,2024-03-22,지식정보단지,10855,5301,5554
1,2024-03-22,인천대입구,18662,9475,9187
1,2024-03-22,센트럴파크(재외동포청),8726,4321,4405
1,2024-03-22,국제업무지구,4116,2101,2015
1,2024-03-22,송도달빛축제공원,11098,5563,5535
1,2024-03-23,계양,6732,3244,3488
1,2024-03-23,귤현,1574,749,825
1,2024-03-23,박촌,6067,3200,2867
1,2024-03-23,임학,13944,7137,6807
1,2024-03-23,계산,19217,9529,9688
1,2024-03-23,경인교대입구,9579,4824,4755
1,2024-03-23,작전,23675,12131,11544
1,2024-03-23,갈산,10820,5657,5163
1,2024-03-23,부평구청,10812,5287,5525
1,2024-03-23,부평시장,20100,10065,10035
1,2024-03-23,부평,14771,7082,7689
1,2024-03-23,동수,5711,2947,2764
1,2024-03-23,부평삼거리,4478,2233,2245
1,2024-03-23,간석오거리,17733,9241,8492
1,2024-03-23,인천시청,8175,4247,3928
1,2024-03-23,예술회관,19477,9284,10193
1,2024-03-23,인천터미널,31805,15836,15969
1,2024-03-23,문학경기장,19948,8998,10950
1,2024-03-23,선학,11597,6007,5590
1,2024-03-23,신연수,6959,3635,3324
1,2024-03-23,원인재,3988,2096,1892
1,2024-03-23,동춘,16383,8144,8239
1,2024-03-23,동막,6784,3619,3165
1,2024-03-23,캠퍼스타운,9223,4822,4401
1,2024-03-23,테크노파크,20282,9949,10333
1,2024-03-23,지식정보단지,4510,2330,2180
1,2024-03-23,인천대입구,12049,6095,5954
1,2024-03-23,센트럴파크(재외동포청),8106,3938,4168
1,2024-03-23,국제업무지구,1903,1000,903
1,2024-03-23,송도달빛축제공원,9233,4687,4546
1,2024-03-24,계양,5572,2683,2889
1,2024-03-24,귤현,1223,586,637
1,2024-03-24,박촌,4529,2342,2187
1,2024-03-24,임학,9510,4892,4618
1,2024-03-24,계산,15252,7485,7767
1,2024-03-24,경인교대입구,7756,3858,3898
1,2024-03-24,작전,16057,8208,7849
1,2024-03-24,갈산,7430,3846,3584
1,2024-03-24,부평구청,7986,3964,4022
1,2024-03-24,부평시장,15688,7848,7840
1,2024-03-24,부평,10663,5463,5200
1,2024-03-24,동수,4297,2167,2130
1,2024-03-24,부평삼거리,4088,2055,2033
1,2024-03-24,간석오거리,13025,6849,6176
1,2024-03-24,인천시청,5871,3041,2830
1,2024-03-24,예술회관,13029,6308,6721
1,2024-03-24,인천터미널,25887,13235,12652
1,2024-03-24,문학경기장,17154,8454,8700
1,2024-03-24,선학,8863,4412,4451
1,2024-03-24,신연수,4858,2452,2406
1,2024-03-24,원인재,2806,1470,1336
1,2024-03-24,동춘,10037,5043,4994
1,2024-03-24,동막,4610,2343,2267
1,2024-03-24,캠퍼스타운,7318,3486,3832
1,2024-03-24,테크노파크,16235,7972,8263
1,2024-03-24,지식정보단지,3048,1500,1548
1,2024-03-24,인천대입구,8730,4125,4605
1,2024-03-24,센트럴파크(재외동포청),6074,2997,3077
1,2024-03-24,국제업무지구,916,481,435
1,2024-03-24,송도달빛축제공원,7234,3637,3597
1,2024-03-25,계양,7722,3822,3900
1,2024-03-25,귤현,2461,978,1483
1,2024-03-25,박촌,7986,4173,3813
1,2024-03-25,임학,16397,8222,8175
1,2024-03-25,계산,21136,10792,10344
1,2024-03-25,경인교대입구,11700,5828,5872
1,2024-03-25,작전,28527,14459,14068
1,2024-03-25,갈산,19309,9788,9521
1,2024-03-25,부평구청,13331,6485,6846
1,2024-03-25,부평시장,26668,13336,13332
1,2024-03-25,부평,12638,6418,6220
1,2024-03-25,동수,8274,4180,4094
1,2024-03-25,부평삼거리,5038,2553,2485
1,2024-03-25,간석오거리,21431,11109,10322
1,2024-03-25,인천시청,11131,5590,5541
1,2024-03-25,예술회관,23779,11836,11943
1,2024-03-25,인천터미널,25172,12323,12849
1,2024-03-25,문학경기장,3569,1764,1805
1,2024-03-25,선학,12024,5970,6054
1,2024-03-25,신연수,11887,5989,5898
1,2024-03-25,원인재,5688,3031,2657
1,2024-03-25,동춘,19983,9739,10244
1,2024-03-25,동막,10599,5577,5022
1,2024-03-25,캠퍼스타운,12780,6403,6377
1,2024-03-25,테크노파크,21413,10716,10697
1,2024-03-25,지식정보단지,10888,5256,5632
1,2024-03-25,인천대입구,19117,9480,9637
1,2024-03-25,센트럴파크(재외동포청),7373,3671,3702
1,2024-03-25,국제업무지구,3974,2043,1931
1,2024-03-25,송도달빛축제공원,10273,5206,5067
1,2024-03-26,계양,8189,4078,4111
1,2024-03-26,귤현,2597,1021,1576
1,2024-03-26,박촌,8228,4258,3970
1,2024-03-26,임학,16783,8477,8306
1,2024-03-26,계산,20749,10547,10202
1,2024-03-26,경인교대입구,11852,5967,5885
1,2024-03-26,작전,29528,14956,14572
1,2024-03-26,갈산,19904,10153,9751
1,2024-03-26,부평구청,14210,6945,7265
1,2024-03-26,부평시장,27353,13666,13687
1,2024-03-26,부평,12819,6419,6400
1,2024-03-26,동수,8618,4353,4265
1,2024-03-26,부평삼거리,5432,2724,2708
1,2024-03-26,간석오거리,21995,11449,10546
1,2024-03-26,인천시청,12331,6157,6174
1,2024-03-26,예술회관,24517,12092,12425
1,2024-03-26,인천터미널,26236,12857,13379
1,2024-03-26,문학경기장,11072,5371,5701
1,2024-03-26,선학,12428,6205,6223
1,2024-03-26,신연수,12058,6097,5961
1,2024-03-26,원인재,5834,3152,2682
1,2024-03-26,동춘,20899,10236,10663
1,2024-03-26,동막,10717,5675,5042
1,2024-03-26,캠퍼스타운,12848,6563,6285
1,2024-03-26,테크노파크,22058,11104,10954
1,2024-03-26,지식정보단지,11065,5365,5700
1,2024-03-26,인천대입구,19961,10064,9897
1,2024-03-26,센트럴파크(재외동포청),7900,3919,3981
1,2024-03-26,국제업무지구,3960,2019,1941
1,2024-03-26,송도달빛축제공원,10875,5402,5473
1,2024-03-27,계양,8680,4346,4334
1,2024-03-27,귤현,2623,1010,1613
1,2024-03-27,박촌,8567,4488,4079
1,2024-03-27,임학,17239,8729,8510
1,2024-03-27,계산,22582,11548,11034
1,2024-03-27,경인교대입구,12086,6024,6062
1,2024-03-27,작전,30810,15619,15191
1,2024-03-27,갈산,20675,10504,10171
1,2024-03-27,부평구청,14642,7153,7489
1,2024-03-27,부평시장,28476,14264,14212
1,2024-03-27,부평,13673,6813,6860
1,2024-03-27,동수,8703,4390,4313
1,2024-03-27,부평삼거리,5814,2945,2869
1,2024-03-27,간석오거리,23035,11972,11063
1,2024-03-27,인천시청,11964,6021,5943
1,2024-03-27,예술회관,25660,12642,13018
1,2024-03-27,인천터미널,27373,13406,13967
1,2024-03-27,문학경기장,11299,5513,5786
1,2024-03-27,선학,13090,6567,6523
1,2024-03-27,신연수,12667,6438,6229
1,2024-03-27,원인재,6074,3241,2833
1,2024-03-27,동춘,21367,10453,10914
1,2024-03-27,동막,11295,6006,5289
1,2024-03-27,캠퍼스타운,13340,6771,6569
1,2024-03-27,테크노파크,22653,11402,11251
1,2024-03-27,지식정보단지,11466,5515,5951
1,2024-03-27,인천대입구,20234,10112,10122
1,2024-03-27,센트럴파크(재외동포청),8456,4311,4145
1,2024-03-27,국제업무지구,4153,2099,2054
1,2024-03-27,송도달빛축제공원,11204,5549,5655
1,2024-03-28,계양,8250,4110,4140
1,2024-03-28,귤현,2541,982,1559
1,2024-03-28,박촌,8161,4254,3907
1,2024-03-28,임학,16820,8468,8352
1,2024-03-28,계산,21189,10732,10457
1,2024-03-28,경인교대입구,12029,6098,5931
1,2024-03-28,작전,29123,14761,14362
1,2024-03-28,갈산,19872,10059,9813
1,2024-03-28,부평구청,14056,6910,7146
1,2024-03-28,부평시장,26884,13464,13420
1,2024-03-28,부평,13315,6730,6585
1,2024-03-28,동수,8514,4320,4194
1,2024-03-28,부평삼거리,5190,2635,2555
1,2024-03-28,간석오거리,21878,11449,10429
1,2024-03-28,인천시청,11531,5834,5697
1,2024-03-28,예술회관,24518,12085,12433
1,2024-03-28,인천터미널,26541,13188,13353
1,2024-03-28,문학경기장,12022,5815,6207
1,2024-03-28,선학,12948,6471,6477
1,2024-03-28,신연수,12014,6106,5908
1,2024-03-28,원인재,5904,3176,2728
1,2024-03-28,동춘,20805,10127,10678
1,2024-03-28,동막,10867,5793,5074
1,2024-03-28,캠퍼스타운,13570,7153,6417
1,2024-03-28,테크노파크,21326,10609,10717
1,2024-03-28,지식정보단지,11177,5393,5784
1,2024-03-28,인천대입구,19443,9713,9730
1,2024-03-28,센트럴파크(재외동포청),7982,3996,3986
1,2024-03-28,국제업무지구,4155,2103,2052
1,2024-03-28,송도달빛축제공원,10746,5393,5353
1,2024-03-29,계양,8285,4085,4200
1,2024-03-29,귤현,2396,976,1420
1,2024-03-29,박촌,7942,4171,3771
1,2024-03-29,임학,16722,8414,8308
1,2024-03-29,계산,21051,10745,10306
1,2024-03-29,경인교대입구,11308,5607,5701
1,2024-03-29,작전,29558,14838,14720
1,2024-03-29,갈산,19610,10023,9587
1,2024-03-29,부평구청,13874,6742,7132
1,2024-03-29,부평시장,26894,13449,13445
1,2024-03-29,부평,14611,7165,7446
1,2024-03-29,동수,8161,4151,4010
1,2024-03-29,부평삼거리,5322,2724,2598
1,2024-03-29,간석오거리,22078,11489,10589
1,2024-03-29,인천시청,11670,5946,5724
1,2024-03-29,예술회관,24751,11905,12846
1,2024-03-29,인천터미널,30415,14903,15512
1,2024-03-29,문학경기장,3679,1866,1813
1,2024-03-29,선학,13321,6680,6641
1,2024-03-29,신연수,11515,5889,5626
1,2024-03-29,원인재,6037,3232,2805
1,2024-03-29,동춘,21124,10275,10849
1,2024-03-29,동막,10839,5774,5065
1,2024-03-29,캠퍼스타운,13037,6858,6179
1,2024-03-29,테크노파크,21942,10966,10976
1,2024-03-29,지식정보단지,10737,5264,5473
1,2024-03-29,인천대입구,17872,9170,8702
1,2024-03-29,센트럴파크(재외동포청),8493,4200,4293
1,2024-03-29,국제업무지구,4135,2123,2012
1,2024-03-29,송도달빛축제공원,10922,5451,5471
1,2024-03-30,계양,6740,3223,3517
1,2024-03-30,귤현,1657,767,890
1,2024-03-30,박촌,5963,3141,2822
1,2024-03-30,임학,13168,6680,6488
1,2024-03-30,계산,19516,9850,9666
1,2024-03-30,경인교대입구,10319,5274,5045
1,2024-03-30,작전,22839,11760,11079
1,2024-03-30,갈산,10260,5305,4955
1,2024-03-30,부평구청,10081,4978,5103
1,2024-03-30,부평시장,20101,9970,10131
1,2024-03-30,부평,14262,7181,7081
1,2024-03-30,동수,5462,2815,2647
1,2024-03-30,부평삼거리,4363,2143,2220
1,2024-03-30,간석오거리,17028,8878,8150
1,2024-03-30,인천시청,8236,4185,4051
1,2024-03-30,예술회관,17975,8497,9478
1,2024-03-30,인천터미널,29411,14381,15030
1,2024-03-30,문학경기장,2967,1440,1527
1,2024-03-30,선학,11219,5696,5523
1,2024-03-30,신연수,6388,3334,3054
1,2024-03-30,원인재,3932,1990,1942
1,2024-03-30,동춘,16007,7957,8050
1,2024-03-30,동막,6960,3685,3275
1,2024-03-30,캠퍼스타운,9221,4854,4367
1,2024-03-30,테크노파크,19912,9920,9992
1,2024-03-30,지식정보단지,4470,2301,2169
1,2024-03-30,인천대입구,13051,6544,6507
1,2024-03-30,센트럴파크(재외동포청),9889,4850,5039
1,2024-03-30,국제업무지구,2194,1152,1042
1,2024-03-30,송도달빛축제공원,9022,4628,4394
1,2024-03-31,계양,5154,2397,2757
1,2024-03-31,귤현,1165,553,612
1,2024-03-31,박촌,4514,2371,2143
1,2024-03-31,임학,9623,4899,4724
1,2024-03-31,계산,15268,7574,7694
1,2024-03-31,경인교대입구,7875,3912,3963
1,2024-03-31,작전,16219,8297,7922
1,2024-03-31,갈산,7094,3629,3465
1,2024-03-31,부평구청,7567,3674,3893
1,2024-03-31,부평시장,15998,7945,8053
1,2024-03-31,부평,10092,5292,4800
1,2024-03-31,동수,4328,2181,2147
1,2024-03-31,부평삼거리,3631,1831,1800
1,2024-03-31,간석오거리,12966,6779,6187
1,2024-03-31,인천시청,5908,2978,2930
1,2024-03-31,예술회관,12890,6258,6632
1,2024-03-31,인천터미널,24349,12444,11905
1,2024-03-31,문학경기장,1609,851,758
1,2024-03-31,선학,8679,4268,4411
1,2024-03-31,신연수,5057,2597,2460
1,2024-03-31,원인재,3615,1867,1748
1,2024-03-31,동춘,11429,5647,5782
1,2024-03-31,동막,4747,2503,2244
1,2024-03-31,캠퍼스타운,7110,3339,3771
1,2024-03-31,테크노파크,15725,7796,7929
1,2024-03-31,지식정보단지,3029,1482,1547
1,2024-03-31,인천대입구,9013,4298,4715
1,2024-03-31,센트럴파크(재외동포청),6839,3336,3503
1,2024-03-31,국제업무지구,862,451,411
1,2024-03-31,송도달빛축제공원,7009,3410,3599
1,2024-04-01,계양,8269,4173,4096
1,2024-04-01,귤현,2597,1014,1583
1,2024-04-01,박촌,8181,4291,3890
1,2024-04-01,임학,16942,8540,8402
1,2024-04-01,계산,22030,11174,10856
1,2024-04-01,경인교대입구,12097,6052,6045
1,2024-04-01,작전,29980,15290,14690
1,2024-04-01,갈산,19474,9930,9544
1,2024-04-01,부평구청,13796,6767,7029
1,2024-04-01,부평시장,27242,13711,13531
1,2024-04-01,부평,13213,6653,6560
1,2024-04-01,동수,8255,4215,4040
1,2024-04-01,부평삼거리,5455,2756,2699
1,2024-04-01,간석오거리,21833,11482,10351
1,2024-04-01,인천시청,11182,5688,5494
1,2024-04-01,예술회관,23846,11888,11958
1,2024-04-01,인천터미널,26624,12896,13728
1,2024-04-01,문학경기장,3750,1846,1904
1,2024-04-01,선학,12543,6298,6245
1,2024-04-01,신연수,12070,6139,5931
1,2024-04-01,원인재,5994,3166,2828
1,2024-04-01,동춘,20421,9955,10466
1,2024-04-01,동막,10790,5697,5093
1,2024-04-01,캠퍼스타운,12889,6387,6502
1,2024-04-01,테크노파크,22072,11020,11052
1,2024-04-01,지식정보단지,11190,5410,5780
1,2024-04-01,인천대입구,18875,9392,9483
1,2024-04-01,센트럴파크(재외동포청),7583,3865,3718
1,2024-04-01,국제업무지구,4161,2109,2052
1,2024-04-01,송도달빛축제공원,10891,5448,5443
1,2024-04-02,계양,8521,4230,4291
1,2024-04-02,귤현,2757,1111,1646
1,2024-04-02,박촌,8568,4450,4118
1,2024-04-02,임학,17418,8797,8621
1,2024-04-02,계산,21924,11158,10766
1,2024-04-02,경인교대입구,11954,6010,5944
1,2024-04-02,작전,30042,15179,14863
1,2024-04-02,갈산,20067,10213,9854
1,2024-04-02,부평구청,14280,6983,7297
1,2024-04-02,부평시장,28186,14100,14086
1,2024-04-02,부평,13032,6487,6545
1,2024-04-02,동수,8705,4392,4313
1,2024-04-02,부평삼거리,5618,2818,2800
1,2024-04-02,간석오거리,22895,11906,10989
1,2024-04-02,인천시청,12382,6257,6125
1,2024-04-02,예술회관,24676,12189,12487
1,2024-04-02,인천터미널,26551,12976,13575
1,2024-04-02,문학경기장,11658,5761,5897
1,2024-04-02,선학,13810,6850,6960
1,2024-04-02,신연수,12295,6204,6091
1,2024-04-02,원인재,6246,3313,2933
1,2024-04-02,동춘,21003,10329,10674
1,2024-04-02,동막,10933,5799,5134
1,2024-04-02,캠퍼스타운,13071,6619,6452
1,2024-04-02,테크노파크,22431,11255,11176
1,2024-04-02,지식정보단지,11659,5724,5935
1,2024-04-02,인천대입구,20116,10096,10020
1,2024-04-02,센트럴파크(재외동포청),8244,4105,4139
1,2024-04-02,국제업무지구,4200,2134,2066
1,2024-04-02,송도달빛축제공원,11435,5710,5725
1,2024-04-03,계양,8433,4255,4178
1,2024-04-03,귤현,2598,1001,1597
1,2024-04-03,박촌,8446,4353,4093
1,2024-04-03,임학,17147,8573,8574
1,2024-04-03,계산,21626,11019,10607
1,2024-04-03,경인교대입구,11827,5967,5860
1,2024-04-03,작전,30666,15480,15186
1,2024-04-03,갈산,20028,10178,9850
1,2024-04-03,부평구청,13987,6883,7104
1,2024-04-03,부평시장,27467,13830,13637
1,2024-04-03,부평,13223,6503,6720
1,2024-04-03,동수,8453,4230,4223
1,2024-04-03,부평삼거리,5456,2740,2716
1,2024-04-03,간석오거리,22378,11711,10667
1,2024-04-03,인천시청,11558,5837,5721
1,2024-04-03,예술회관,24701,12089,12612
1,2024-04-03,인천터미널,25863,12689,13174
1,2024-04-03,문학경기장,11494,5631,5863
1,2024-04-03,선학,13227,6622,6605
1,2024-04-03,신연수,12083,6116,5967
1,2024-04-03,원인재,6088,3254,2834
1,2024-04-03,동춘,20773,10223,10550
1,2024-04-03,동막,10878,5736,5142
1,2024-04-03,캠퍼스타운,13410,6769,6641
1,2024-04-03,테크노파크,22860,11454,11406
1,2024-04-03,지식정보단지,11432,5479,5953
1,2024-04-03,인천대입구,19512,9806,9706
1,2024-04-03,센트럴파크(재외동포청),8092,4030,4062
1,2024-04-03,국제업무지구,4296,2198,2098
1,2024-04-03,송도달빛축제공원,11081,5509,5572
1,2024-04-04,계양,8719,4353,4366
1,2024-04-04,귤현,2635,1005,1630
1,2024-04-04,박촌,8404,4373,4031
1,2024-04-04,임학,17515,8819,8696
1,2024-04-04,계산,22617,11471,11146
1,2024-04-04,경인교대입구,12281,6196,6085
1,2024-04-04,작전,30528,15406,15122
1,2024-04-04,갈산,20035,10218,9817
1,2024-04-04,부평구청,14512,7136,7376
1,2024-04-04,부평시장,27771,13923,13848
1,2024-04-04,부평,13493,6767,6726
1,2024-04-04,동수,8499,4298,4201
1,2024-04-04,부평삼거리,5835,2951,2884
1,2024-04-04,간석오거리,22769,11861,10908
1,2024-04-04,인천시청,12002,6055,5947
1,2024-04-04,예술회관,24671,12140,12531
1,2024-04-04,인천터미널,27616,13668,13948
1,2024-04-04,문학경기장,13023,6344,6679
1,2024-04-04,선학,13780,6932,6848
1,2024-04-04,신연수,12234,6241,5993
1,2024-04-04,원인재,6456,3399,3057
1,2024-04-04,동춘,21397,10446,10951
1,2024-04-04,동막,10746,5723,5023
1,2024-04-04,캠퍼스타운,14113,7404,6709
1,2024-04-04,테크노파크,22611,11326,11285
1,2024-04-04,지식정보단지,11371,5499,5872
1,2024-04-04,인천대입구,18991,9558,9433
1,2024-04-04,센트럴파크(재외동포청),8566,4246,4320
1,2024-04-04,국제업무지구,4222,2128,2094
1,2024-04-04,송도달빛축제공원,11322,5700,5622
1,2024-04-05,계양,8693,4319,4374
1,2024-04-05,귤현,2665,1046,1619
1,2024-04-05,박촌,8562,4493,4069
1,2024-04-05,임학,17811,8954,8857
1,2024-04-05,계산,22500,11472,11028
1,2024-04-05,경인교대입구,11863,6026,5837
1,2024-04-05,작전,30815,15620,15195
1,2024-04-05,갈산,19887,10148,9739
1,2024-04-05,부평구청,14614,7071,7543
1,2024-04-05,부평시장,28210,13979,14231
1,2024-04-05,부평,14637,7205,7432
1,2024-04-05,동수,8422,4302,4120
1,2024-04-05,부평삼거리,6193,3104,3089
1,2024-04-05,간석오거리,22566,11764,10802
1,2024-04-05,인천시청,11515,5907,5608
1,2024-04-05,예술회관,25369,12191,13178
1,2024-04-05,인천터미널,31899,15569,16330
1,2024-04-05,문학경기장,3914,1989,1925
1,2024-04-05,선학,14026,7033,6993
1,2024-04-05,신연수,12177,6240,5937
1,2024-04-05,원인재,6094,3191,2903
1,2024-04-05,동춘,22462,10929,11533
1,2024-04-05,동막,11255,6058,5197
1,2024-04-05,캠퍼스타운,14188,7506,6682
1,2024-04-05,테크노파크,23771,11996,11775
1,2024-04-05,지식정보단지,11000,5423,5577
1,2024-04-05,인천대입구,18275,9374,8901
1,2024-04-05,센트럴파크(재외동포청),9005,4431,4574
1,2024-04-05,국제업무지구,4211,2167,2044
1,2024-04-05,송도달빛축제공원,11628,5860,5768
1,2024-04-06,계양,6873,3279,3594
1,2024-04-06,귤현,1577,708,869
1,2024-04-06,박촌,5981,3217,2764
1,2024-04-06,임학,13469,6893,6576
1,2024-04-06,계산,19433,9725,9708
1,2024-04-06,경인교대입구,9545,4798,4747
1,2024-04-06,작전,23711,12201,11510
1,2024-04-06,갈산,10969,5657,5312
1,2024-04-06,부평구청,11065,5431,5634
1,2024-04-06,부평시장,20226,10208,10018
1,2024-04-06,부평,13492,6780,6712
1,2024-04-06,동수,5610,2828,2782
1,2024-04-06,부평삼거리,5024,2478,2546
1,2024-04-06,간석오거리,17302,9075,8227
1,2024-04-06,인천시청,8551,4434,4117
1,2024-04-06,예술회관,18008,8531,9477
1,2024-04-06,인천터미널,29739,14396,15343
1,2024-04-06,문학경기장,3259,1601,1658
1,2024-04-06,선학,11673,5927,5746
1,2024-04-06,신연수,6896,3581,3315
1,2024-04-06,원인재,4303,2181,2122
1,2024-04-06,동춘,16658,8265,8393
1,2024-04-06,동막,6903,3693,3210
1,2024-04-06,캠퍼스타운,9612,5054,4558
1,2024-04-06,테크노파크,19282,9618,9664
1,2024-04-06,지식정보단지,4533,2371,2162
1,2024-04-06,인천대입구,11823,6124,5699
1,2024-04-06,센트럴파크(재외동포청),9663,4612,5051
1,2024-04-06,국제업무지구,2039,1068,971
1,2024-04-06,송도달빛축제공원,9207,4667,4540
1,2024-04-07,계양,5349,2525,2824
1,2024-04-07,귤현,1197,582,615
1,2024-04-07,박촌,4423,2318,2105
1,2024-04-07,임학,10040,5119,4921
1,2024-04-07,계산,14562,7174,7388
1,2024-04-07,경인교대입구,7660,3829,3831
1,2024-04-07,작전,16934,8627,8307
1,2024-04-07,갈산,7327,3779,3548
1,2024-04-07,부평구청,8316,3994,4322
1,2024-04-07,부평시장,15650,7830,7820
1,2024-04-07,부평,9662,4995,4667
1,2024-04-07,동수,4459,2257,2202
1,2024-04-07,부평삼거리,3901,1952,1949
1,2024-04-07,간석오거리,13161,6937,6224
1,2024-04-07,인천시청,6324,3257,3067
1,2024-04-07,예술회관,12745,6242,6503
1,2024-04-07,인천터미널,24593,12656,11937
1,2024-04-07,문학경기장,1803,892,911
1,2024-04-07,선학,8941,4407,4534
1,2024-04-07,신연수,5145,2650,2495
1,2024-04-07,원인재,3193,1626,1567
1,2024-04-07,동춘,12760,6388,6372
1,2024-04-07,동막,4967,2559,2408
1,2024-04-07,캠퍼스타운,7774,3769,4005
1,2024-04-07,테크노파크,15496,7658,7838
1,2024-04-07,지식정보단지,3247,1605,1642
1,2024-04-07,인천대입구,8796,4244,4552
1,2024-04-07,센트럴파크(재외동포청),7167,3340,3827
1,2024-04-07,국제업무지구,875,475,400
1,2024-04-07,송도달빛축제공원,7358,3620,3738
1,2024-04-08,계양,8229,4050,4179
1,2024-04-08,귤현,2589,1006,1583
1,2024-04-08,박촌,8239,4328,3911
1,2024-04-08,임학,17125,8633,8492
1,2024-04-08,계산,22161,11353,10808
1,2024-04-08,경인교대입구,11954,6008,5946
1,2024-04-08,작전,29900,15184,14716
1,2024-04-08,갈산,19413,9898,9515
1,2024-04-08,부평구청,13861,6733,7128
1,2024-04-08,부평시장,27198,13607,13591
1,2024-04-08,부평,12904,6550,6354
1,2024-04-08,동수,8311,4204,4107
1,2024-04-08,부평삼거리,5672,2881,2791
1,2024-04-08,간석오거리,21988,11480,10508
1,2024-04-08,인천시청,11424,5746,5678
1,2024-04-08,예술회관,23744,11705,12039
1,2024-04-08,인천터미널,26594,12962,13632
1,2024-04-08,문학경기장,3697,1880,1817
1,2024-04-08,선학,12584,6326,6258
1,2024-04-08,신연수,11970,6039,5931
1,2024-04-08,원인재,5936,3111,2825
1,2024-04-08,동춘,20183,9835,10348
1,2024-04-08,동막,10609,5639,4970
1,2024-04-08,캠퍼스타운,13099,6519,6580
1,2024-04-08,테크노파크,21769,10921,10848
1,2024-04-08,지식정보단지,11424,5558,5866
1,2024-04-08,인천대입구,19342,9663,9679
1,2024-04-08,센트럴파크(재외동포청),8417,4207,4210
1,2024-04-08,국제업무지구,4301,2196,2105
1,2024-04-08,송도달빛축제공원,10809,5410,5399
1,2024-04-09,계양,8953,4352,4601
1,2024-04-09,귤현,2768,1122,1646
1,2024-04-09,박촌,8662,4567,4095
1,2024-04-09,임학,18000,9065,8935
1,2024-04-09,계산,22534,11406,11128
1,2024-04-09,경인교대입구,12109,6027,6082
1,2024-04-09,작전,31357,16052,15305
1,2024-04-09,갈산,19788,10066,9722
1,2024-04-09,부평구청,14651,7198,7453
1,2024-04-09,부평시장,28966,14560,14406
1,2024-04-09,부평,14151,7045,7106
1,2024-04-09,동수,8788,4461,4327
1,2024-04-09,부평삼거리,5733,2908,2825
1,2024-04-09,간석오거리,23215,12199,11016
1,2024-04-09,인천시청,12267,6157,6110
1,2024-04-09,예술회관,26370,12671,13699
1,2024-04-09,인천터미널,28892,14170,14722
1,2024-04-09,문학경기장,10398,4955,5443
1,2024-04-09,선학,14226,7158,7068
1,2024-04-09,신연수,12616,6424,6192
1,2024-04-09,원인재,6351,3372,2979
1,2024-04-09,동춘,21577,10565,11012
1,2024-04-09,동막,11157,5913,5244
1,2024-04-09,캠퍼스타운,13798,7209,6589
1,2024-04-09,테크노파크,22995,11489,11506
1,2024-04-09,지식정보단지,11758,5724,6034
1,2024-04-09,인천대입구,20865,10548,10317
1,2024-04-09,센트럴파크(재외동포청),8811,4375,4436
1,2024-04-09,국제업무지구,4372,2186,2186
1,2024-04-09,송도달빛축제공원,11675,5847,5828
1,2024-04-10,계양,5727,2695,3032
1,2024-04-10,귤현,1374,655,719
1,2024-04-10,박촌,5111,2654,2457
1,2024-04-10,임학,10976,5583,5393
1,2024-04-10,계산,15597,7781,7816
1,2024-04-10,경인교대입구,8422,4214,4208
1,2024-04-10,작전,18320,9386,8934
1,2024-04-10,갈산,8459,4332,4127
1,2024-04-10,부평구청,8849,4229,4620
1,2024-04-10,부평시장,17064,8552,8512
1,2024-04-10,부평,11125,5782,5343
1,2024-04-10,동수,4967,2542,2425
1,2024-04-10,부평삼거리,4473,2269,2204
1,2024-04-10,간석오거리,15019,7854,7165
1,2024-04-10,인천시청,6450,3325,3125
1,2024-04-10,예술회관,16070,7861,8209
1,2024-04-10,인천터미널,24443,12250,12193
1,2024-04-10,문학경기장,15231,7375,7856
1,2024-04-10,선학,9901,4932,4969
1,2024-04-10,신연수,5958,3015,2943
1,2024-04-10,원인재,3399,1753,1646
1,2024-04-10,동춘,13686,6787,6899
1,2024-04-10,동막,5473,2825,2648
1,2024-04-10,캠퍼스타운,8243,4255,3988
1,2024-04-10,테크노파크,17346,8626,8720
1,2024-04-10,지식정보단지,3974,2065,1909
1,2024-04-10,인천대입구,10410,5332,5078
1,2024-04-10,센트럴파크(재외동포청),7700,3688,4012
1,2024-04-10,국제업무지구,1774,922,852
1,2024-04-10,송도달빛축제공원,7861,3940,3921
1,2024-04-11,계양,8365,4186,4179
1,2024-04-11,귤현,2583,1010,1573
1,2024-04-11,박촌,8373,4356,4017
1,2024-04-11,임학,16979,8579,8400
1,2024-04-11,계산,21630,10956,10674
1,2024-04-11,경인교대입구,11928,6063,5865
1,2024-04-11,작전,29838,15159,14679
1,2024-04-11,갈산,19399,9852,9547
1,2024-04-11,부평구청,14063,6838,7225
1,2024-04-11,부평시장,27195,13619,13576
1,2024-04-11,부평,13215,6662,6553
1,2024-04-11,동수,8358,4233,4125
1,2024-04-11,부평삼거리,5359,2703,2656
1,2024-04-11,간석오거리,22401,11717,10684
1,2024-04-11,인천시청,11402,5760,5642
1,2024-04-11,예술회관,24760,12184,12576
1,2024-04-11,인천터미널,26976,13359,13617
1,2024-04-11,문학경기장,8676,4160,4516
1,2024-04-11,선학,13327,6698,6629
1,2024-04-11,신연수,12277,6207,6070
1,2024-04-11,원인재,5916,3162,2754
1,2024-04-11,동춘,20638,10051,10587
1,2024-04-11,동막,10756,5705,5051
1,2024-04-11,캠퍼스타운,13593,7055,6538
1,2024-04-11,테크노파크,22001,10990,11011
1,2024-04-11,지식정보단지,11232,5409,5823
1,2024-04-11,인천대입구,19458,9772,9686
1,2024-04-11,센트럴파크(재외동포청),8276,4143,4133
1,2024-04-11,국제업무지구,4345,2216,2129
1,2024-04-11,송도달빛축제공원,10809,5369,5440
1,2024-04-12,계양,8796,4418,4378
1,2024-04-12,귤현,2552,1005,1547
1,2024-04-12,박촌,8369,4363,4006
1,2024-04-12,임학,17434,8774,8660
1,2024-04-12,계산,22600,11494,11106
1,2024-04-12,경인교대입구,12040,6098,5942
1,2024-04-12,작전,30888,15686,15202
1,2024-04-12,갈산,19712,10085,9627
1,2024-04-12,부평구청,14575,7172,7403
1,2024-04-12,부평시장,28246,14177,14069
1,2024-04-12,부평,14877,7246,7631
1,2024-04-12,동수,8544,4313,4231
1,2024-04-12,부평삼거리,5636,2897,2739
1,2024-04-12,간석오거리,22490,11872,10618
1,2024-04-12,인천시청,12100,6161,5939
1,2024-04-12,예술회관,26093,12585,13508
1,2024-04-12,인천터미널,31249,15164,16085
1,2024-04-12,문학경기장,3999,2002,1997
1,2024-04-12,선학,13814,6905,6909
1,2024-04-12,신연수,11954,6161,5793
1,2024-04-12,원인재,6080,3252,2828
1,2024-04-12,동춘,22137,10833,11304
1,2024-04-12,동막,11342,5993,5349
1,2024-04-12,캠퍼스타운,13988,7389,6599
1,2024-04-12,테크노파크,23781,12064,11717
1,2024-04-12,지식정보단지,11201,5481,5720
1,2024-04-12,인천대입구,19002,9673,9329
1,2024-04-12,센트럴파크(재외동포청),9593,4721,4872
1,2024-04-12,국제업무지구,4168,2107,2061
1,2024-04-12,송도달빛축제공원,11544,5747,5797
1,2024-04-13,계양,6869,3264,3605
1,2024-04-13,귤현,1681,746,935
1,2024-04-13,박촌,5884,3160,2724
1,2024-04-13,임학,12678,6484,6194
1,2024-04-13,계산,19582,9738,9844
1,2024-04-13,경인교대입구,9892,5051,4841
1,2024-04-13,작전,23113,11941,11172
1,2024-04-13,갈산,10845,5637,5208
1,2024-04-13,부평구청,10697,5236,5461
1,2024-04-13,부평시장,20196,10160,10036
1,2024-04-13,부평,13613,6722,6891
1,2024-04-13,동수,5565,2802,2763
1,2024-04-13,부평삼거리,4528,2275,2253
1,2024-04-13,간석오거리,16960,8871,8089
1,2024-04-13,인천시청,8143,4238,3905
1,2024-04-13,예술회관,17398,8253,9145
1,2024-04-13,인천터미널,29516,14303,15213
1,2024-04-13,문학경기장,3132,1550,1582
1,2024-04-13,선학,11399,5720,5679
1,2024-04-13,신연수,6537,3435,3102
1,2024-04-13,원인재,4463,2309,2154
1,2024-04-13,동춘,16121,8059,8062
1,2024-04-13,동막,7180,3793,3387
1,2024-04-13,캠퍼스타운,9155,4916,4239
1,2024-04-13,테크노파크,19705,9783,9922
1,2024-04-13,지식정보단지,4390,2265,2125
1,2024-04-13,인천대입구,12530,6230,6300
1,2024-04-13,센트럴파크(재외동포청),9344,4574,4770
1,2024-04-13,국제업무지구,2087,1088,999
1,2024-04-13,송도달빛축제공원,9062,4624,4438
1,2024-04-14,계양,5285,2434,2851
1,2024-04-14,귤현,1127,541,586
1,2024-04-14,박촌,4418,2293,2125
1,2024-04-14,임학,9337,4791,4546
1,2024-04-14,계산,14958,7340,7618
1,2024-04-14,경인교대입구,7815,3834,3981
1,2024-04-14,작전,15579,7904,7675
1,2024-04-14,갈산,6850,3559,3291
1,2024-04-14,부평구청,7540,3700,3840
1,2024-04-14,부평시장,15103,7531,7572
1,2024-04-14,부평,9680,5001,4679
1,2024-04-14,동수,4210,2105,2105
1,2024-04-14,부평삼거리,3848,1937,1911
1,2024-04-14,간석오거리,12218,6374,5844
1,2024-04-14,인천시청,5732,2904,2828
1,2024-04-14,예술회관,11489,5557,5932
1,2024-04-14,인천터미널,24233,12232,12001
1,2024-04-14,문학경기장,1827,935,892
1,2024-04-14,선학,8327,4111,4216
1,2024-04-14,신연수,5014,2589,2425
1,2024-04-14,원인재,2862,1498,1364
1,2024-04-14,동춘,9925,4964,4961
1,2024-04-14,동막,4697,2403,2294
1,2024-04-14,캠퍼스타운,6744,3218,3526
1,2024-04-14,테크노파크,15357,7510,7847
1,2024-04-14,지식정보단지,3070,1496,1574
1,2024-04-14,인천대입구,8975,4308,4667
1,2024-04-14,센트럴파크(재외동포청),5691,2775,2916
1,2024-04-14,국제업무지구,949,526,423
1,2024-04-14,송도달빛축제공원,6774,3331,3443
1,2024-04-15,계양,7690,3889,3801
1,2024-04-15,귤현,2430,958,1472
1,2024-04-15,박촌,7705,3987,3718
1,2024-04-15,임학,15708,7913,7795
1,2024-04-15,계산,20110,10266,9844
1,2024-04-15,경인교대입구,11076,5574,5502
1,2024-04-15,작전,27959,14168,13791
1,2024-04-15,갈산,18865,9565,9300
1,2024-04-15,부평구청,12911,6297,6614
1,2024-04-15,부평시장,25418,12815,12603
1,2024-04-15,부평,12346,6172,6174
1,2024-04-15,동수,7906,4011,3895
1,2024-04-15,부평삼거리,4946,2485,2461
1,2024-04-15,간석오거리,20641,10748,9893
1,2024-04-15,인천시청,10667,5387,5280
1,2024-04-15,예술회관,22982,11370,11612
1,2024-04-15,인천터미널,22288,10759,11529
1,2024-04-15,문학경기장,3416,1697,1719
1,2024-04-15,선학,11719,5831,5888
1,2024-04-15,신연수,11203,5655,5548
1,2024-04-15,원인재,5356,2855,2501
1,2024-04-15,동춘,19145,9297,9848
1,2024-04-15,동막,10347,5467,4880
1,2024-04-15,캠퍼스타운,11835,5875,5960
1,2024-04-15,테크노파크,20485,10245,10240
1,2024-04-15,지식정보단지,10695,5152,5543
1,2024-04-15,인천대입구,18328,9166,9162
1,2024-04-15,센트럴파크(재외동포청),7111,3566,3545
1,2024-04-15,국제업무지구,4131,2142,1989
1,2024-04-15,송도달빛축제공원,9719,4880,4839
1,2024-04-16,계양,8569,4356,4213
1,2024-04-16,귤현,2691,1083,1608
1,2024-04-16,박촌,8507,4468,4039
1,2024-04-16,임학,17070,8632,8438
1,2024-04-16,계산,21854,11099,10755
1,2024-04-16,경인교대입구,11738,5889,5849
1,2024-04-16,작전,30305,15442,14863
1,2024-04-16,갈산,20128,10231,9897
1,2024-04-16,부평구청,14276,6951,7325
1,2024-04-16,부평시장,28492,14164,14328
1,2024-04-16,부평,13013,6550,6463
1,2024-04-16,동수,8610,4389,4221
1,2024-04-16,부평삼거리,5666,2829,2837
1,2024-04-16,간석오거리,22622,11827,10795
1,2024-04-16,인천시청,11837,5996,5841
1,2024-04-16,예술회관,24610,12173,12437
1,2024-04-16,인천터미널,26218,12758,13460
1,2024-04-16,문학경기장,12464,5970,6494
1,2024-04-16,선학,12957,6514,6443
1,2024-04-16,신연수,12337,6225,6112
1,2024-04-16,원인재,6111,3240,2871
1,2024-04-16,동춘,21073,10285,10788
1,2024-04-16,동막,11013,5867,5146
1,2024-04-16,캠퍼스타운,12786,6476,6310
1,2024-04-16,테크노파크,21992,11010,10982
1,2024-04-16,지식정보단지,11286,5410,5876
1,2024-04-16,인천대입구,19956,10114,9842
1,2024-04-16,센트럴파크(재외동포청),7903,3877,4026
1,2024-04-16,국제업무지구,4278,2206,2072
1,2024-04-16,송도달빛축제공원,10934,5428,5506
1,2024-04-17,계양,8750,4430,4320
1,2024-04-17,귤현,2747,1073,1674
1,2024-04-17,박촌,8734,4550,4184
1,2024-04-17,임학,17346,8785,8561
1,2024-04-17,계산,22844,11573,11271
1,2024-04-17,경인교대입구,12031,6006,6025
1,2024-04-17,작전,30980,15789,15191
1,2024-04-17,갈산,20116,10162,9954
1,2024-04-17,부평구청,14896,7243,7653
1,2024-04-17,부평시장,28388,14259,14129
1,2024-04-17,부평,13433,6769,6664
1,2024-04-17,동수,8740,4393,4347
1,2024-04-17,부평삼거리,5594,2785,2809
1,2024-04-17,간석오거리,23340,12202,11138
1,2024-04-17,인천시청,12567,6325,6242
1,2024-04-17,예술회관,24616,12163,12453
1,2024-04-17,인천터미널,27877,13700,14177
1,2024-04-17,문학경기장,15003,7072,7931
1,2024-04-17,선학,13470,6768,6702
1,2024-04-17,신연수,12485,6341,6144
1,2024-04-17,원인재,6183,3304,2879
1,2024-04-17,동춘,21044,10341,10703
1,2024-04-17,동막,11281,6036,5245
1,2024-04-17,캠퍼스타운,13099,6632,6467
1,2024-04-17,테크노파크,22572,11212,11360
1,2024-04-17,지식정보단지,11377,5553,5824
1,2024-04-17,인천대입구,19911,9952,9959
1,2024-04-17,센트럴파크(재외동포청),8757,4411,4346
1,2024-04-17,국제업무지구,4234,2165,2069
1,2024-04-17,송도달빛축제공원,11157,5555,5602
1,2024-04-18,계양,8798,4352,4446
1,2024-04-18,귤현,2766,1095,1671
1,2024-04-18,박촌,8544,4454,4090
1,2024-04-18,임학,17250,8695,8555
1,2024-04-18,계산,22837,11590,11247
1,2024-04-18,경인교대입구,12234,6181,6053
1,2024-04-18,작전,31059,15654,15405
1,2024-04-18,갈산,20054,10198,9856
1,2024-04-18,부평구청,14833,7212,7621
1,2024-04-18,부평시장,28663,14341,14322
1,2024-04-18,부평,13484,6743,6741
1,2024-04-18,동수,8512,4297,4215
1,2024-04-18,부평삼거리,5694,2869,2825
1,2024-04-18,간석오거리,22907,11905,11002
1,2024-04-18,인천시청,12246,6155,6091
1,2024-04-18,예술회관,24823,12198,12625
1,2024-04-18,인천터미널,27551,13710,13841
1,2024-04-18,문학경기장,13600,6601,6999
1,2024-04-18,선학,13587,6836,6751
1,2024-04-18,신연수,12711,6455,6256
1,2024-04-18,원인재,6243,3295,2948
1,2024-04-18,동춘,21663,10640,11023
1,2024-04-18,동막,11474,6037,5437
1,2024-04-18,캠퍼스타운,13389,6912,6477
1,2024-04-18,테크노파크,24786,12340,12446
1,2024-04-18,지식정보단지,11633,5657,5976
1,2024-04-18,인천대입구,19215,9721,9494
1,2024-04-18,센트럴파크(재외동포청),8481,4229,4252
1,2024-04-18,국제업무지구,4459,2261,2198
1,2024-04-18,송도달빛축제공원,11484,5759,5725
1,2024-04-19,계양,8784,4373,4411
1,2024-04-19,귤현,2701,1091,1610
1,2024-04-19,박촌,8618,4506,4112
1,2024-04-19,임학,17691,8973,8718
1,2024-04-19,계산,22707,11570,11137
1,2024-04-19,경인교대입구,12230,6150,6080
1,2024-04-19,작전,31133,15923,15210
1,2024-04-19,갈산,20206,10337,9869
1,2024-04-19,부평구청,14946,7241,7705
1,2024-04-19,부평시장,29113,14618,14495
1,2024-04-19,부평,14851,7311,7540
1,2024-04-19,동수,8512,4328,4184
1,2024-04-19,부평삼거리,5654,2900,2754
1,2024-04-19,간석오거리,22955,12046,10909
1,2024-04-19,인천시청,12380,6342,6038
1,2024-04-19,예술회관,25827,12378,13449
1,2024-04-19,인천터미널,31672,15306,16366
1,2024-04-19,문학경기장,12673,6085,6588
1,2024-04-19,선학,14208,7089,7119
1,2024-04-19,신연수,12462,6403,6059
1,2024-04-19,원인재,6361,3365,2996
1,2024-04-19,동춘,21963,10735,11228
1,2024-04-19,동막,11631,6175,5456
1,2024-04-19,캠퍼스타운,13493,6901,6592
1,2024-04-19,테크노파크,25811,13107,12704
1,2024-04-19,지식정보단지,11167,5484,5683
1,2024-04-19,인천대입구,18279,9226,9053
1,2024-04-19,센트럴파크(재외동포청),9000,4463,4537
1,2024-04-19,국제업무지구,4432,2267,2165
1,2024-04-19,송도달빛축제공원,11774,5890,5884
1,2024-04-20,계양,6029,2905,3124
1,2024-04-20,귤현,1560,697,863
1,2024-04-20,박촌,5712,3044,2668
1,2024-04-20,임학,11763,5949,5814
1,2024-04-20,계산,16959,8527,8432
1,2024-04-20,경인교대입구,8866,4420,4446
1,2024-04-20,작전,21914,11245,10669
1,2024-04-20,갈산,10310,5358,4952
1,2024-04-20,부평구청,9946,4902,5044
1,2024-04-20,부평시장,18026,9031,8995
1,2024-04-20,부평,12526,6283,6243
1,2024-04-20,동수,5219,2623,2596
1,2024-04-20,부평삼거리,3664,1797,1867
1,2024-04-20,간석오거리,15793,8234,7559
1,2024-04-20,인천시청,7684,3876,3808
1,2024-04-20,예술회관,16716,7910,8806
1,2024-04-20,인천터미널,27722,13346,14376
1,2024-04-20,문학경기장,5298,2560,2738
1,2024-04-20,선학,10241,5163,5078
1,2024-04-20,신연수,6093,3176,2917
1,2024-04-20,원인재,3525,1848,1677
1,2024-04-20,동춘,14244,7101,7143
1,2024-04-20,동막,6687,3521,3166
1,2024-04-20,캠퍼스타운,7926,4188,3738
1,2024-04-20,테크노파크,17010,8445,8565
1,2024-04-20,지식정보단지,4195,2163,2032
1,2024-04-20,인천대입구,10368,5161,5207
1,2024-04-20,센트럴파크(재외동포청),6782,3315,3467
1,2024-04-20,국제업무지구,2117,1076,1041
1,2024-04-20,송도달빛축제공원,7839,4015,3824
1,2024-04-21,계양,5234,2466,2768
1,2024-04-21,귤현,1196,575,621
1,2024-04-21,박촌,4517,2325,2192
1,2024-04-21,임학,9046,4601,4445
1,2024-04-21,계산,13716,6790,6926
1,2024-04-21,경인교대입구,7414,3767,3647
1,2024-04-21,작전,15477,7842,7635
1,2024-04-21,갈산,6885,3527,3358
1,2024-04-21,부평구청,7864,3866,3998
1,2024-04-21,부평시장,15777,7834,7943
1,2024-04-21,부평,9236,4831,4405
1,2024-04-21,동수,4231,2142,2089
1,2024-04-21,부평삼거리,3474,1738,1736
1,2024-04-21,간석오거리,12495,6566,5929
1,2024-04-21,인천시청,5906,3017,2889
1,2024-04-21,예술회관,11870,5764,6106
1,2024-04-21,인천터미널,23043,11824,11219
1,2024-04-21,문학경기장,14828,7253,7575
1,2024-04-21,선학,7931,3922,4009
1,2024-04-21,신연수,4825,2462,2363
1,2024-04-21,원인재,3004,1511,1493
1,2024-04-21,동춘,11424,5724,5700
1,2024-04-21,동막,4525,2340,2185
1,2024-04-21,캠퍼스타운,7844,3717,4127
1,2024-04-21,테크노파크,14945,7423,7522
1,2024-04-21,지식정보단지,3077,1513,1564
1,2024-04-21,인천대입구,7868,3788,4080
1,2024-04-21,센트럴파크(재외동포청),5610,2797,2813
1,2024-04-21,국제업무지구,1178,599,579
1,2024-04-21,송도달빛축제공원,6852,3320,3532
1,2024-04-22,계양,8382,4230,4152
1,2024-04-22,귤현,2650,1077,1573
1,2024-04-22,박촌,8246,4307,3939
1,2024-04-22,임학,17003,8653,8350
1,2024-04-22,계산,22194,11311,10883
1,2024-04-22,경인교대입구,11139,5588,5551
1,2024-04-22,작전,30191,15267,14924
1,2024-04-22,갈산,19554,9886,9668
1,2024-04-22,부평구청,13835,6801,7034
1,2024-04-22,부평시장,27454,13727,13727
1,2024-04-22,부평,12656,6300,6356
1,2024-04-22,동수,8329,4219,4110
1,2024-04-22,부평삼거리,5422,2730,2692
1,2024-04-22,간석오거리,21920,11374,10546
1,2024-04-22,인천시청,11611,5861,5750
1,2024-04-22,예술회관,24184,11917,12267
1,2024-04-22,인천터미널,25999,12730,13269
1,2024-04-22,문학경기장,4397,2119,2278
1,2024-04-22,선학,12401,6195,6206
1,2024-04-22,신연수,12129,6130,5999
1,2024-04-22,원인재,5879,3112,2767
1,2024-04-22,동춘,20393,9952,10441
1,2024-04-22,동막,10850,5769,5081
1,2024-04-22,캠퍼스타운,12584,6317,6267
1,2024-04-22,테크노파크,21649,10864,10785
1,2024-04-22,지식정보단지,11094,5377,5717
1,2024-04-22,인천대입구,18316,9156,9160
1,2024-04-22,센트럴파크(재외동포청),7889,3917,3972
1,2024-04-22,국제업무지구,4082,2067,2015
1,2024-04-22,송도달빛축제공원,10886,5401,5485
1,2024-04-23,계양,8525,4279,4246
1,2024-04-23,귤현,2572,973,1599
1,2024-04-23,박촌,8446,4377,4069
1,2024-04-23,임학,16906,8522,8384
1,2024-04-23,계산,21569,11028,10541
1,2024-04-23,경인교대입구,10993,5590,5403
1,2024-04-23,작전,30286,15304,14982
1,2024-04-23,갈산,19816,10109,9707
1,2024-04-23,부평구청,14327,7007,7320
1,2024-04-23,부평시장,28109,14079,14030
1,2024-04-23,부평,12496,6258,6238
1,2024-04-23,동수,8471,4228,4243
1,2024-04-23,부평삼거리,5523,2729,2794
1,2024-04-23,간석오거리,22542,11698,10844
1,2024-04-23,인천시청,11757,5975,5782
1,2024-04-23,예술회관,24518,12092,12426
1,2024-04-23,인천터미널,25762,12666,13096
1,2024-04-23,문학경기장,3979,1986,1993
1,2024-04-23,선학,12720,6373,6347
1,2024-04-23,신연수,12346,6217,6129
1,2024-04-23,원인재,6049,3246,2803
1,2024-04-23,동춘,20718,10105,10613
1,2024-04-23,동막,11425,5949,5476
1,2024-04-23,캠퍼스타운,12385,6239,6146
1,2024-04-23,테크노파크,21924,10946,10978
1,2024-04-23,지식정보단지,11298,5487,5811
1,2024-04-23,인천대입구,18845,9494,9351
1,2024-04-23,센트럴파크(재외동포청),8424,4234,4190
1,2024-04-23,국제업무지구,4162,2093,2069
1,2024-04-23,송도달빛축제공원,11305,5624,5681
1,2024-04-24,계양,8143,4151,3992
1,2024-04-24,귤현,2533,1003,1530
1,2024-04-24,박촌,8260,4333,3927
1,2024-04-24,임학,16738,8360,8378
1,2024-04-24,계산,21180,10771,10409
1,2024-04-24,경인교대입구,11090,5517,5573
1,2024-04-24,작전,30110,15235,14875
1,2024-04-24,갈산,19721,9981,9740
1,2024-04-24,부평구청,14043,6874,7169
1,2024-04-24,부평시장,27508,13763,13745
1,2024-04-24,부평,12760,6402,6358
1,2024-04-24,동수,8502,4349,4153
1,2024-04-24,부평삼거리,5277,2659,2618
1,2024-04-24,간석오거리,22283,11619,10664
1,2024-04-24,인천시청,11797,5913,5884
1,2024-04-24,예술회관,24951,12202,12749
1,2024-04-24,인천터미널,25293,12431,12862
1,2024-04-24,문학경기장,3692,1875,1817
1,2024-04-24,선학,12878,6499,6379
1,2024-04-24,신연수,12057,6130,5927
1,2024-04-24,원인재,6010,3269,2741
1,2024-04-24,동춘,20751,10107,10644
1,2024-04-24,동막,11112,5914,5198
1,2024-04-24,캠퍼스타운,12546,6396,6150
1,2024-04-24,테크노파크,22156,11080,11076
1,2024-04-24,지식정보단지,10978,5313,5665
1,2024-04-24,인천대입구,18551,9349,9202
1,2024-04-24,센트럴파크(재외동포청),8011,4019,3992
1,2024-04-24,국제업무지구,4166,2132,2034
1,2024-04-24,송도달빛축제공원,11060,5470,5590
1,2024-04-25,계양,8579,4268,4311
1,2024-04-25,귤현,2879,1166,1713
1,2024-04-25,박촌,8442,4397,4045
1,2024-04-25,임학,17235,8645,8590
1,2024-04-25,계산,22636,11490,11146
1,2024-04-25,경인교대입구,11459,5683,5776
1,2024-04-25,작전,30756,15623,15133
1,2024-04-25,갈산,19680,9973,9707
1,2024-04-25,부평구청,14541,7118,7423
1,2024-04-25,부평시장,28445,14199,14246
1,2024-04-25,부평,13506,6711,6795
1,2024-04-25,동수,8169,4099,4070
1,2024-04-25,부평삼거리,5502,2792,2710
1,2024-04-25,간석오거리,22505,11796,10709
1,2024-04-25,인천시청,11756,5889,5867
1,2024-04-25,예술회관,25061,12217,12844
1,2024-04-25,인천터미널,27622,13776,13846
1,2024-04-25,문학경기장,4025,2033,1992
1,2024-04-25,선학,13078,6574,6504
1,2024-04-25,신연수,12486,6342,6144
1,2024-04-25,원인재,6204,3307,2897
1,2024-04-25,동춘,21516,10428,11088
1,2024-04-25,동막,10889,5723,5166
1,2024-04-25,캠퍼스타운,13098,6766,6332
1,2024-04-25,테크노파크,22825,11454,11371
1,2024-04-25,지식정보단지,11359,5423,5936
1,2024-04-25,인천대입구,19264,9886,9378
1,2024-04-25,센트럴파크(재외동포청),8834,4426,4408
1,2024-04-25,국제업무지구,4169,2075,2094
1,2024-04-25,송도달빛축제공원,11458,5707,5751
1,2024-04-26,계양,8871,4378,4493
1,2024-04-26,귤현,2744,1106,1638
1,2024-04-26,박촌,8959,4745,4214
1,2024-04-26,임학,17657,8874,8783
1,2024-04-26,계산,23981,12295,11686
1,2024-04-26,경인교대입구,11965,5916,6049
1,2024-04-26,작전,32086,16210,15876
1,2024-04-26,갈산,19875,10116,9759
1,2024-04-26,부평구청,14724,7240,7484
1,2024-04-26,부평시장,29346,14635,14711
1,2024-04-26,부평,15197,7418,7779
1,2024-04-26,동수,8394,4313,4081
1,2024-04-26,부평삼거리,5719,2913,2806
1,2024-04-26,간석오거리,23242,12212,11030
1,2024-04-26,인천시청,12038,6081,5957
1,2024-04-26,예술회관,26616,12742,13874
1,2024-04-26,인천터미널,32464,15798,16666
1,2024-04-26,문학경기장,11649,5506,6143
1,2024-04-26,선학,13822,7030,6792
1,2024-04-26,신연수,12375,6421,5954
1,2024-04-26,원인재,6263,3343,2920
1,2024-04-26,동춘,22711,11001,11710
1,2024-04-26,동막,11610,6230,5380
1,2024-04-26,캠퍼스타운,13782,7202,6580
1,2024-04-26,테크노파크,24538,12397,12141
1,2024-04-26,지식정보단지,10920,5369,5551
1,2024-04-26,인천대입구,18612,9394,9218
1,2024-04-26,센트럴파크(재외동포청),9351,4616,4735
1,2024-04-26,국제업무지구,4148,2118,2030
1,2024-04-26,송도달빛축제공원,12264,6231,6033
1,2024-04-27,계양,7007,3367,3640
1,2024-04-27,귤현,1777,831,946
1,2024-04-27,박촌,6483,3462,3021
1,2024-04-27,임학,13504,6892,6612
1,2024-04-27,계산,20692,10440,10252
1,2024-04-27,경인교대입구,9531,4778,4753
1,2024-04-27,작전,25031,12792,12239
1,2024-04-27,갈산,11831,6155,5676
1,2024-04-27,부평구청,11377,5599,5778
1,2024-04-27,부평시장,20797,10324,10473
1,2024-04-27,부평,14591,7178,7413
1,2024-04-27,동수,5707,2886,2821
1,2024-04-27,부평삼거리,4551,2241,2310
1,2024-04-27,간석오거리,18223,9508,8715
1,2024-04-27,인천시청,8104,4188,3916
1,2024-04-27,예술회관,20429,9632,10797
1,2024-04-27,인천터미널,30918,15075,15843
1,2024-04-27,문학경기장,14256,6793,7463
1,2024-04-27,선학,11570,5890,5680
1,2024-04-27,신연수,7030,3731,3299
1,2024-04-27,원인재,4487,2362,2125
1,2024-04-27,동춘,16852,8302,8550
1,2024-04-27,동막,7790,4116,3674
1,2024-04-27,캠퍼스타운,9760,5198,4562
1,2024-04-27,테크노파크,20815,10258,10557
1,2024-04-27,지식정보단지,4819,2506,2313
1,2024-04-27,인천대입구,18245,9217,9028
1,2024-04-27,센트럴파크(재외동포청),9269,4535,4734
1,2024-04-27,국제업무지구,1951,1016,935
1,2024-04-27,송도달빛축제공원,9627,4921,4706
1,2024-04-28,계양,5250,2423,2827
1,2024-04-28,귤현,1207,583,624
1,2024-04-28,박촌,4532,2348,2184
1,2024-04-28,임학,9496,4842,4654
1,2024-04-28,계산,14822,7313,7509
1,2024-04-28,경인교대입구,7882,3893,3989
1,2024-04-28,작전,16484,8352,8132
1,2024-04-28,갈산,7530,3830,3700
1,2024-04-28,부평구청,8233,4043,4190
1,2024-04-28,부평시장,15756,7929,7827
1,2024-04-28,부평,9808,5160,4648
1,2024-04-28,동수,4432,2231,2201
1,2024-04-28,부평삼거리,3657,1820,1837
1,2024-04-28,간석오거리,12878,6741,6137
1,2024-04-28,인천시청,5965,3042,2923
1,2024-04-28,예술회관,13024,6241,6783
1,2024-04-28,인천터미널,25117,12863,12254
1,2024-04-28,문학경기장,9411,4542,4869
1,2024-04-28,선학,8515,4226,4289
1,2024-04-28,신연수,5055,2602,2453
1,2024-04-28,원인재,3070,1646,1424
1,2024-04-28,동춘,9935,4950,4985
1,2024-04-28,동막,5009,2562,2447
1,2024-04-28,캠퍼스타운,7238,3426,3812
1,2024-04-28,테크노파크,16155,7949,8206
1,2024-04-28,지식정보단지,3165,1596,1569
1,2024-04-28,인천대입구,11117,5333,5784
1,2024-04-28,센트럴파크(재외동포청),5939,2964,2975
1,2024-04-28,국제업무지구,888,477,411
1,2024-04-28,송도달빛축제공원,6970,3434,3536
1,2024-04-29,계양,8362,4197,4165
1,2024-04-29,귤현,2743,1132,1611
1,2024-04-29,박촌,8229,4291,3938
1,2024-04-29,임학,16661,8468,8193
1,2024-04-29,계산,22255,11346,10909
1,2024-04-29,경인교대입구,11902,5943,5959
1,2024-04-29,작전,30819,15661,15158
1,2024-04-29,갈산,19220,9811,9409
1,2024-04-29,부평구청,14145,7001,7144
1,2024-04-29,부평시장,27713,13894,13819
1,2024-04-29,부평,12921,6468,6453
1,2024-04-29,동수,8119,4066,4053
1,2024-04-29,부평삼거리,5371,2725,2646
1,2024-04-29,간석오거리,21731,11339,10392
1,2024-04-29,인천시청,11503,5841,5662
1,2024-04-29,예술회관,23694,11656,12038
1,2024-04-29,인천터미널,26713,12953,13760
1,2024-04-29,문학경기장,3796,1871,1925
1,2024-04-29,선학,12201,6120,6081
1,2024-04-29,신연수,12058,6076,5982
1,2024-04-29,원인재,6028,3186,2842
1,2024-04-29,동춘,20646,9986,10660
1,2024-04-29,동막,11077,5828,5249
1,2024-04-29,캠퍼스타운,13255,6570,6685
1,2024-04-29,테크노파크,22427,11204,11223
1,2024-04-29,지식정보단지,11243,5528,5715
1,2024-04-29,인천대입구,19570,9723,9847
1,2024-04-29,센트럴파크(재외동포청),7802,3919,3883
1,2024-04-29,국제업무지구,4078,2069,2009
1,2024-04-29,송도달빛축제공원,11186,5566,5620
1,2024-04-30,계양,8928,4527,4401
1,2024-04-30,귤현,2795,1109,1686
1,2024-04-30,박촌,8470,4459,4011
1,2024-04-30,임학,17347,8763,8584
1,2024-04-30,계산,22167,11311,10856
1,2024-04-30,경인교대입구,12024,6020,6004
1,2024-04-30,작전,31636,16189,15447
1,2024-04-30,갈산,19853,10097,9756
1,2024-04-30,부평구청,14667,7168,7499
1,2024-04-30,부평시장,29081,14511,14570
1,2024-04-30,부평,14059,7037,7022
1,2024-04-30,동수,8463,4284,4179
1,2024-04-30,부평삼거리,5682,2866,2816
1,2024-04-30,간석오거리,22767,11941,10826
1,2024-04-30,인천시청,12327,6228,6099
1,2024-04-30,예술회관,26406,12850,13556
1,2024-04-30,인천터미널,28139,13667,14472
1,2024-04-30,문학경기장,4094,2065,2029
1,2024-04-30,선학,13199,6649,6550
1,2024-04-30,신연수,12561,6365,6196
1,2024-04-30,원인재,6330,3352,2978
1,2024-04-30,동춘,21884,10674,11210
1,2024-04-30,동막,11468,6057,5411
1,2024-04-30,캠퍼스타운,13385,6774,6611
1,2024-04-30,테크노파크,23692,11835,11857
1,2024-04-30,지식정보단지,11686,5662,6024
1,2024-04-30,인천대입구,20563,10201,10362
1,2024-04-30,센트럴파크(재외동포청),8358,4122,4236
1,2024-04-30,국제업무지구,4327,2207,2120
1,2024-04-30,송도달빛축제공원,11724,5874,5850
1,2024-05-01,계양,6359,3075,3284
1,2024-05-01,귤현,1716,732,984
1,2024-05-01,박촌,6252,3232,3020
1,2024-05-01,임학,12776,6524,6252
1,2024-05-01,계산,19859,9972,9887
1,2024-05-01,경인교대입구,9252,4652,4600
1,2024-05-01,작전,23067,11700,11367
1,2024-05-01,갈산,10224,5235,4989
1,2024-05-01,부평구청,10602,5229,5373
1,2024-05-01,부평시장,20733,10390,10343
1,2024-05-01,부평,11856,6107,5749
1,2024-05-01,동수,5205,2622,2583
1,2024-05-01,부평삼거리,5127,2602,2525
1,2024-05-01,간석오거리,17029,8832,8197
1,2024-05-01,인천시청,10000,5250,4750
1,2024-05-01,예술회관,19611,9281,10330
1,2024-05-01,인천터미널,25944,12941,13003
1,2024-05-01,문학경기장,3072,1525,1547
1,2024-05-01,선학,9768,4901,4867
1,2024-05-01,신연수,7499,3806,3693
1,2024-05-01,원인재,3650,1959,1691
1,2024-05-01,동춘,15765,7792,7973
1,2024-05-01,동막,7087,3764,3323
1,2024-05-01,캠퍼스타운,9418,4830,4588
1,2024-05-01,테크노파크,18672,9250,9422
1,2024-05-01,지식정보단지,5920,2948,2972
1,2024-05-01,인천대입구,16861,8602,8259
1,2024-05-01,센트럴파크(재외동포청),7919,3900,4019
1,2024-05-01,국제업무지구,1575,801,774
1,2024-05-01,송도달빛축제공원,8892,4356,4536
1,2024-05-02,계양,8702,4342,4360
1,2024-05-02,귤현,2773,1092,1681
1,2024-05-02,박촌,8434,4418,4016
1,2024-05-02,임학,17215,8683,8532
1,2024-05-02,계산,22455,11339,11116
1,2024-05-02,경인교대입구,12125,6081,6044
1,2024-05-02,작전,30922,15657,15265
1,2024-05-02,갈산,19502,9875,9627
1,2024-05-02,부평구청,14417,7087,7330
1,2024-05-02,부평시장,27978,14003,13975
1,2024-05-02,부평,13973,6918,7055
1,2024-05-02,동수,8376,4294,4082
1,2024-05-02,부평삼거리,5731,2882,2849
1,2024-05-02,간석오거리,22179,11596,10583
1,2024-05-02,인천시청,12062,6065,5997
1,2024-05-02,예술회관,25291,12450,12841
1,2024-05-02,인천터미널,28081,13874,14207
1,2024-05-02,문학경기장,4036,2052,1984
1,2024-05-02,선학,12705,6402,6303
1,2024-05-02,신연수,12437,6336,6101
1,2024-05-02,원인재,6156,3254,2902
1,2024-05-02,동춘,21662,10472,11190
1,2024-05-02,동막,11287,5962,5325
1,2024-05-02,캠퍼스타운,14503,7652,6851
1,2024-05-02,테크노파크,24465,12330,12135
1,2024-05-02,지식정보단지,11522,5626,5896
1,2024-05-02,인천대입구,20485,10420,10065
1,2024-05-02,센트럴파크(재외동포청),8759,4288,4471
1,2024-05-02,국제업무지구,4452,2253,2199
1,2024-05-02,송도달빛축제공원,11607,5705,5902
1,2024-05-03,계양,9075,4476,4599
1,2024-05-03,귤현,2754,1100,1654
1,2024-05-03,박촌,8679,4512,4167
1,2024-05-03,임학,17924,8942,8982
1,2024-05-03,계산,22941,11695,11246
1,2024-05-03,경인교대입구,12094,6134,5960
1,2024-05-03,작전,32715,16568,16147
1,2024-05-03,갈산,20021,10289,9732
1,2024-05-03,부평구청,15534,7582,7952
1,2024-05-03,부평시장,29213,14613,14600
1,2024-05-03,부평,16010,7901,8109
1,2024-05-03,동수,8660,4455,4205
1,2024-05-03,부평삼거리,5844,2975,2869
1,2024-05-03,간석오거리,23122,12208,10914
1,2024-05-03,인천시청,12041,6046,5995
1,2024-05-03,예술회관,27325,13064,14261
1,2024-05-03,인천터미널,34996,16707,18289
1,2024-05-03,문학경기장,15526,7412,8114
1,2024-05-03,선학,13387,6750,6637
1,2024-05-03,신연수,12124,6262,5862
1,2024-05-03,원인재,6271,3315,2956
1,2024-05-03,동춘,23710,11542,12168
1,2024-05-03,동막,11853,6357,5496
1,2024-05-03,캠퍼스타운,14985,7774,7211
1,2024-05-03,테크노파크,27555,13992,13563
1,2024-05-03,지식정보단지,11192,5450,5742
1,2024-05-03,인천대입구,20028,10338,9690
1,2024-05-03,센트럴파크(재외동포청),10352,5122,5230
1,2024-05-03,국제업무지구,4487,2266,2221
1,2024-05-03,송도달빛축제공원,12561,6275,6286
1,2024-05-04,계양,7019,3372,3647
1,2024-05-04,귤현,1673,757,916
1,2024-05-04,박촌,6032,3201,2831
1,2024-05-04,임학,12773,6642,6131
1,2024-05-04,계산,18521,9307,9214
1,2024-05-04,경인교대입구,10350,5240,5110
1,2024-05-04,작전,23550,12157,11393
1,2024-05-04,갈산,10666,5593,5073
1,2024-05-04,부평구청,10787,5291,5496
1,2024-05-04,부평시장,19911,9984,9927
1,2024-05-04,부평,14292,7107,7185
1,2024-05-04,동수,5505,2818,2687
1,2024-05-04,부평삼거리,5358,2647,2711
1,2024-05-04,간석오거리,17026,8905,8121
1,2024-05-04,인천시청,7894,4084,3810
1,2024-05-04,예술회관,18537,8676,9861
1,2024-05-04,인천터미널,31934,15052,16882
1,2024-05-04,문학경기장,17885,8715,9170
1,2024-05-04,선학,10693,5459,5234
1,2024-05-04,신연수,6516,3448,3068
1,2024-05-04,원인재,4218,2220,1998
1,2024-05-04,동춘,16894,8365,8529
1,2024-05-04,동막,6863,3677,3186
1,2024-05-04,캠퍼스타운,9471,5071,4400
1,2024-05-04,테크노파크,22112,10886,11226
1,2024-05-04,지식정보단지,4558,2401,2157
1,2024-05-04,인천대입구,13295,6762,6533
1,2024-05-04,센트럴파크(재외동포청),9193,4510,4683
1,2024-05-04,국제업무지구,2059,1077,982
1,2024-05-04,송도달빛축제공원,11568,5654,5914
1,2024-05-05,계양,3529,1646,1883
1,2024-05-05,귤현,914,417,497
1,2024-05-05,박촌,3912,1995,1917
1,2024-05-05,임학,8073,3991,4082
1,2024-05-05,계산,9633,4874,4759
1,2024-05-05,경인교대입구,6257,3097,3160
1,2024-05-05,작전,13008,6606,6402
1,2024-05-05,갈산,5573,2834,2739
1,2024-05-05,부평구청,6176,3025,3151
1,2024-05-05,부평시장,12538,6236,6302
1,2024-05-05,부평,9199,4791,4408
1,2024-05-05,동수,3683,1854,1829
1,2024-05-05,부평삼거리,2658,1329,1329
1,2024-05-05,간석오거리,10717,5506,5211
1,2024-05-05,인천시청,4482,2315,2167
1,2024-05-05,예술회관,11731,5567,6164
1,2024-05-05,인천터미널,20513,10393,10120
1,2024-05-05,문학경기장,1387,671,716
1,2024-05-05,선학,6477,3254,3223
1,2024-05-05,신연수,3984,2009,1975
1,2024-05-05,원인재,2073,1072,1001
1,2024-05-05,동춘,10593,5261,5332
1,2024-05-05,동막,3806,1981,1825
1,2024-05-05,캠퍼스타운,5103,2627,2476
1,2024-05-05,테크노파크,15553,7849,7704
1,2024-05-05,지식정보단지,2467,1281,1186
1,2024-05-05,인천대입구,7085,3355,3730
1,2024-05-05,센트럴파크(재외동포청),4332,2113,2219
1,2024-05-05,국제업무지구,787,423,364
1,2024-05-05,송도달빛축제공원,4966,2441,2525
1,2024-05-06,계양,4076,1960,2116
1,2024-05-06,귤현,1010,483,527
1,2024-05-06,박촌,3957,2046,1911
1,2024-05-06,임학,8479,4326,4153
1,2024-05-06,계산,11417,5848,5569
1,2024-05-06,경인교대입구,6719,3263,3456
1,2024-05-06,작전,14446,7414,7032
1,2024-05-06,갈산,6765,3454,3311
1,2024-05-06,부평구청,7002,3400,3602
1,2024-05-06,부평시장,13566,6797,6769
1,2024-05-06,부평,9891,5135,4756
1,2024-05-06,동수,3882,1989,1893
1,2024-05-06,부평삼거리,3433,1717,1716
1,2024-05-06,간석오거리,12203,6320,5883
1,2024-05-06,인천시청,4929,2511,2418
1,2024-05-06,예술회관,12591,6110,6481
1,2024-05-06,인천터미널,24142,12677,11465
1,2024-05-06,문학경기장,1685,883,802
1,2024-05-06,선학,7101,3504,3597
1,2024-05-06,신연수,4782,2399,2383
1,2024-05-06,원인재,2404,1234,1170
1,2024-05-06,동춘,12428,6261,6167
1,2024-05-06,동막,4387,2261,2126
1,2024-05-06,캠퍼스타운,6900,3256,3644
1,2024-05-06,테크노파크,15990,7778,8212
1,2024-05-06,지식정보단지,3211,1545,1666
1,2024-05-06,인천대입구,9429,4382,5047
1,2024-05-06,센트럴파크(재외동포청),4587,2227,2360
1,2024-05-06,국제업무지구,1603,831,772
1,2024-05-06,송도달빛축제공원,6170,3169,3001
1,2024-05-07,계양,8221,4142,4079
1,2024-05-07,귤현,2615,1022,1593
1,2024-05-07,박촌,8213,4304,3909
1,2024-05-07,임학,16868,8446,8422
1,2024-05-07,계산,20650,10510,10140
1,2024-05-07,경인교대입구,11617,5799,5818
1,2024-05-07,작전,30683,15633,15050
1,2024-05-07,갈산,19415,9836,9579
1,2024-05-07,부평구청,14186,7008,7178
1,2024-05-07,부평시장,27106,13579,13527
1,2024-05-07,부평,12965,6609,6356
1,2024-05-07,동수,8513,4339,4174
1,2024-05-07,부평삼거리,5799,2918,2881
1,2024-05-07,간석오거리,21873,11400,10473
1,2024-05-07,인천시청,11303,5718,5585
1,2024-05-07,예술회관,24264,11956,12308
1,2024-05-07,인천터미널,26274,12769,13505
1,2024-05-07,문학경기장,3704,1848,1856
1,2024-05-07,선학,12012,6031,5981
1,2024-05-07,신연수,11867,5983,5884
1,2024-05-07,원인재,5871,3172,2699
1,2024-05-07,동춘,20373,9961,10412
1,2024-05-07,동막,10763,5707,5056
1,2024-05-07,캠퍼스타운,12621,6255,6366
1,2024-05-07,테크노파크,22625,11284,11341
1,2024-05-07,지식정보단지,11401,5522,5879
1,2024-05-07,인천대입구,22982,11143,11839
1,2024-05-07,센트럴파크(재외동포청),8388,4210,4178
1,2024-05-07,국제업무지구,4464,2288,2176
1,2024-05-07,송도달빛축제공원,10701,5346,5355
1,2024-05-08,계양,8685,4340,4345
1,2024-05-08,귤현,2746,1104,1642
1,2024-05-08,박촌,8985,4707,4278
1,2024-05-08,임학,17821,8958,8863
1,2024-05-08,계산,23222,11830,11392
1,2024-05-08,경인교대입구,12297,6100,6197
1,2024-05-08,작전,32154,16180,15974
1,2024-05-08,갈산,20392,10418,9974
1,2024-05-08,부평구청,14807,7254,7553
1,2024-05-08,부평시장,28534,14309,14225
1,2024-05-08,부평,13680,6839,6841
1,2024-05-08,동수,8707,4409,4298
1,2024-05-08,부평삼거리,7935,3944,3991
1,2024-05-08,간석오거리,23383,12314,11069
1,2024-05-08,인천시청,12283,6134,6149
1,2024-05-08,예술회관,25089,12368,12721
1,2024-05-08,인천터미널,27636,13494,14142
1,2024-05-08,문학경기장,4130,2074,2056
1,2024-05-08,선학,12854,6470,6384
1,2024-05-08,신연수,12507,6360,6147
1,2024-05-08,원인재,6477,3419,3058
1,2024-05-08,동춘,21930,10720,11210
1,2024-05-08,동막,11409,6023,5386
1,2024-05-08,캠퍼스타운,13426,6764,6662
1,2024-05-08,테크노파크,23350,11653,11697
1,2024-05-08,지식정보단지,11546,5481,6065
1,2024-05-08,인천대입구,21634,10744,10890
1,2024-05-08,센트럴파크(재외동포청),8696,4354,4342
1,2024-05-08,국제업무지구,4544,2299,2245
1,2024-05-08,송도달빛축제공원,11376,5722,5654
1,2024-05-09,계양,8910,4385,4525
1,2024-05-09,귤현,2788,1147,1641
1,2024-05-09,박촌,8587,4474,4113
1,2024-05-09,임학,17694,8821,8873
1,2024-05-09,계산,22424,11419,11005
1,2024-05-09,경인교대입구,12237,6190,6047
1,2024-05-09,작전,31649,16104,15545
1,2024-05-09,갈산,20092,10207,9885
1,2024-05-09,부평구청,14709,7219,7490
1,2024-05-09,부평시장,28514,14268,14246
1,2024-05-09,부평,14042,6944,7098
1,2024-05-09,동수,8579,4368,4211
1,2024-05-09,부평삼거리,5980,3015,2965
1,2024-05-09,간석오거리,23123,12082,11041
1,2024-05-09,인천시청,12351,6193,6158
1,2024-05-09,예술회관,25014,12329,12685
1,2024-05-09,인천터미널,27822,13979,13843
1,2024-05-09,문학경기장,4215,2081,2134
1,2024-05-09,선학,13094,6582,6512
1,2024-05-09,신연수,12348,6323,6025
1,2024-05-09,원인재,6449,3412,3037
1,2024-05-09,동춘,22766,11136,11630
1,2024-05-09,동막,11378,6003,5375
1,2024-05-09,캠퍼스타운,14332,7437,6895
1,2024-05-09,테크노파크,23683,11886,11797
1,2024-05-09,지식정보단지,11633,5654,5979
1,2024-05-09,인천대입구,24099,11814,12285
1,2024-05-09,센트럴파크(재외동포청),8979,4499,4480
1,2024-05-09,국제업무지구,4754,2382,2372
1,2024-05-09,송도달빛축제공원,14473,7070,7403
1,2024-05-10,계양,8988,4392,4596
1,2024-05-10,귤현,2764,1137,1627
1,2024-05-10,박촌,8980,4717,4263
1,2024-05-10,임학,17952,9074,8878
1,2024-05-10,계산,23029,11676,11353
1,2024-05-10,경인교대입구,12143,6028,6115
1,2024-05-10,작전,32748,16708,16040
1,2024-05-10,갈산,20437,10443,9994
1,2024-05-10,부평구청,15424,7578,7846
1,2024-05-10,부평시장,29204,14615,14589
1,2024-05-10,부평,15261,7504,7757
1,2024-05-10,동수,8623,4338,4285
1,2024-05-10,부평삼거리,5849,2952,2897
1,2024-05-10,간석오거리,22705,11951,10754
1,2024-05-10,인천시청,12280,6259,6021
1,2024-05-10,예술회관,26360,12632,13728
1,2024-05-10,인천터미널,32087,15780,16307
1,2024-05-10,문학경기장,4470,2256,2214
1,2024-05-10,선학,13463,6747,6716
1,2024-05-10,신연수,12287,6261,6026
1,2024-05-10,원인재,6554,3456,3098
1,2024-05-10,동춘,22987,11189,11798
1,2024-05-10,동막,11423,5998,5425
1,2024-05-10,캠퍼스타운,14391,7608,6783
1,2024-05-10,테크노파크,24585,12488,12097
1,2024-05-10,지식정보단지,11173,5482,5691
1,2024-05-10,인천대입구,18912,9689,9223
1,2024-05-10,센트럴파크(재외동포청),9561,4693,4868
1,2024-05-10,국제업무지구,4525,2272,2253
1,2024-05-10,송도달빛축제공원,12095,6022,6073
1,2024-05-11,계양,6138,2953,3185
1,2024-05-11,귤현,1580,713,867
1,2024-05-11,박촌,5582,2936,2646
1,2024-05-11,임학,11737,5960,5777
1,2024-05-11,계산,17564,8866,8698
1,2024-05-11,경인교대입구,8800,4410,4390
1,2024-05-11,작전,22094,11245,10849
1,2024-05-11,갈산,10343,5350,4993
1,2024-05-11,부평구청,9826,4842,4984
1,2024-05-11,부평시장,17933,9009,8924
1,2024-05-11,부평,13244,6783,6461
1,2024-05-11,동수,5126,2565,2561
1,2024-05-11,부평삼거리,4179,2113,2066
1,2024-05-11,간석오거리,15538,8039,7499
1,2024-05-11,인천시청,7456,3831,3625
1,2024-05-11,예술회관,17218,8139,9079
1,2024-05-11,인천터미널,26291,12724,13567
1,2024-05-11,문학경기장,2998,1499,1499
1,2024-05-11,선학,9626,4893,4733
1,2024-05-11,신연수,6291,3339,2952
1,2024-05-11,원인재,4197,2250,1947
1,2024-05-11,동춘,14587,7166,7421
1,2024-05-11,동막,6791,3585,3206
1,2024-05-11,캠퍼스타운,8552,4504,4048
1,2024-05-11,테크노파크,18219,9100,9119
1,2024-05-11,지식정보단지,3985,2043,1942
1,2024-05-11,인천대입구,10787,5320,5467
1,2024-05-11,센트럴파크(재외동포청),6666,3247,3419
1,2024-05-11,국제업무지구,1932,1017,915
1,2024-05-11,송도달빛축제공원,7519,3839,3680
1,2024-05-12,계양,5423,2515,2908
1,2024-05-12,귤현,1185,549,636
1,2024-05-12,박촌,4447,2318,2129
1,2024-05-12,임학,9985,5103,4882
1,2024-05-12,계산,15027,7538,7489
1,2024-05-12,경인교대입구,8242,4075,4167
1,2024-05-12,작전,16845,8650,8195
1,2024-05-12,갈산,7476,3814,3662
1,2024-05-12,부평구청,7950,3826,4124
1,2024-05-12,부평시장,16034,7985,8049
1,2024-05-12,부평,10795,5616,5179
1,2024-05-12,동수,4383,2232,2151
1,2024-05-12,부평삼거리,3896,1936,1960
1,2024-05-12,간석오거리,13040,6809,6231
1,2024-05-12,인천시청,6296,3197,3099
1,2024-05-12,예술회관,13353,6510,6843
1,2024-05-12,인천터미널,24768,12682,12086
1,2024-05-12,문학경기장,9790,4499,5291
1,2024-05-12,선학,9640,4931,4709
1,2024-05-12,신연수,5212,2667,2545
1,2024-05-12,원인재,3338,1792,1546
1,2024-05-12,동춘,10671,5368,5303
1,2024-05-12,동막,4871,2522,2349
1,2024-05-12,캠퍼스타운,7909,3774,4135
1,2024-05-12,테크노파크,18869,9324,9545
1,2024-05-12,지식정보단지,3266,1634,1632
1,2024-05-12,인천대입구,9113,4424,4689
1,2024-05-12,센트럴파크(재외동포청),6474,3129,3345
1,2024-05-12,국제업무지구,838,441,397
1,2024-05-12,송도달빛축제공원,7757,3828,3929
1,2024-05-13,계양,8402,4215,4187
1,2024-05-13,귤현,2690,1074,1616
1,2024-05-13,박촌,8450,4491,3959
1,2024-05-13,임학,17184,8670,8514
1,2024-05-13,계산,22317,11353,10964
1,2024-05-13,경인교대입구,11913,5902,6011
1,2024-05-13,작전,31437,15955,15482
1,2024-05-13,갈산,19730,10072,9658
1,2024-05-13,부평구청,14490,7183,7307
1,2024-05-13,부평시장,28112,14027,14085
1,2024-05-13,부평,13547,6817,6730
1,2024-05-13,동수,8396,4352,4044
1,2024-05-13,부평삼거리,5524,2806,2718
1,2024-05-13,간석오거리,21974,11456,10518
1,2024-05-13,인천시청,11669,5884,5785
1,2024-05-13,예술회관,24587,12224,12363
1,2024-05-13,인천터미널,27291,13206,14085
1,2024-05-13,문학경기장,3914,1911,2003
1,2024-05-13,선학,12461,6271,6190
1,2024-05-13,신연수,12281,6225,6056
1,2024-05-13,원인재,6249,3314,2935
1,2024-05-13,동춘,21305,10424,10881
1,2024-05-13,동막,11355,6006,5349
1,2024-05-13,캠퍼스타운,13413,6609,6804
1,2024-05-13,테크노파크,22546,11248,11298
1,2024-05-13,지식정보단지,11313,5480,5833
1,2024-05-13,인천대입구,19352,9633,9719
1,2024-05-13,센트럴파크(재외동포청),8192,4144,4048
1,2024-05-13,국제업무지구,4614,2335,2279
1,2024-05-13,송도달빛축제공원,11160,5590,5570
1,2024-05-14,계양,9357,4703,4654
1,2024-05-14,귤현,2819,1151,1668
1,2024-05-14,박촌,9132,4841,4291
1,2024-05-14,임학,19246,9777,9469
1,2024-05-14,계산,22510,11400,11110
1,2024-05-14,경인교대입구,12482,6311,6171
1,2024-05-14,작전,32985,16896,16089
1,2024-05-14,갈산,20449,10438,10011
1,2024-05-14,부평구청,15350,7632,7718
1,2024-05-14,부평시장,29592,14972,14620
1,2024-05-14,부평,14768,7178,7590
1,2024-05-14,동수,9258,4747,4511
1,2024-05-14,부평삼거리,5910,2999,2911
1,2024-05-14,간석오거리,23731,12410,11321
1,2024-05-14,인천시청,12146,6165,5981
1,2024-05-14,예술회관,26892,12885,14007
1,2024-05-14,인천터미널,29922,14459,15463
1,2024-05-14,문학경기장,15964,7556,8408
1,2024-05-14,선학,13613,6923,6690
1,2024-05-14,신연수,12687,6449,6238
1,2024-05-14,원인재,6728,3540,3188
1,2024-05-14,동춘,23193,11476,11717
1,2024-05-14,동막,11364,6077,5287
1,2024-05-14,캠퍼스타운,14502,7543,6959
1,2024-05-14,테크노파크,23784,11954,11830
1,2024-05-14,지식정보단지,11727,5747,5980
1,2024-05-14,인천대입구,20741,10390,10351
1,2024-05-14,센트럴파크(재외동포청),8850,4365,4485
1,2024-05-14,국제업무지구,4623,2357,2266
1,2024-05-14,송도달빛축제공원,11836,5881,5955
1,2024-05-15,계양,5032,2373,2659
1,2024-05-15,귤현,1147,564,583
1,2024-05-15,박촌,4498,2301,2197
1,2024-05-15,임학,9411,4761,4650
1,2024-05-15,계산,13535,6742,6793
1,2024-05-15,경인교대입구,7527,3769,3758
1,2024-05-15,작전,16245,8233,8012
1,2024-05-15,갈산,7975,4074,3901
1,2024-05-15,부평구청,7920,3905,4015
1,2024-05-15,부평시장,15364,7610,7754
1,2024-05-15,부평,10793,5598,5195
1,2024-05-15,동수,4476,2203,2273
1,2024-05-15,부평삼거리,4398,2186,2212
1,2024-05-15,간석오거리,14620,7590,7030
1,2024-05-15,인천시청,5503,2763,2740
1,2024-05-15,예술회관,15583,7638,7945
1,2024-05-15,인천터미널,22146,11116,11030
1,2024-05-15,문학경기장,12630,6277,6353
1,2024-05-15,선학,8243,4080,4163
1,2024-05-15,신연수,5407,2752,2655
1,2024-05-15,원인재,3178,1686,1492
1,2024-05-15,동춘,13003,6464,6539
1,2024-05-15,동막,5280,2674,2606
1,2024-05-15,캠퍼스타운,7535,3853,3682
1,2024-05-15,테크노파크,16602,8274,8328
1,2024-05-15,지식정보단지,3693,1857,1836
1,2024-05-15,인천대입구,9489,4639,4850
1,2024-05-15,센트럴파크(재외동포청),4875,2437,2438
1,2024-05-15,국제업무지구,1641,850,791
1,2024-05-15,송도달빛축제공원,6392,3192,3200
1,2024-05-16,계양,8784,4407,4377
1,2024-05-16,귤현,2805,1121,1684
1,2024-05-16,박촌,8604,4487,4117
1,2024-05-16,임학,17307,8707,8600
1,2024-05-16,계산,22159,11235,10924
1,2024-05-16,경인교대입구,12040,6066,5974
1,2024-05-16,작전,31792,16082,15710
1,2024-05-16,갈산,20018,10204,9814
1,2024-05-16,부평구청,14936,7297,7639
1,2024-05-16,부평시장,28292,14097,14195
1,2024-05-16,부평,14041,7073,6968
1,2024-05-16,동수,8583,4366,4217
1,2024-05-16,부평삼거리,5608,2859,2749
1,2024-05-16,간석오거리,22875,11871,11004
1,2024-05-16,인천시청,12098,6084,6014
1,2024-05-16,예술회관,25022,12331,12691
1,2024-05-16,인천터미널,28199,14058,14141
1,2024-05-16,문학경기장,13490,6482,7008
1,2024-05-16,선학,12907,6546,6361
1,2024-05-16,신연수,12369,6285,6084
1,2024-05-16,원인재,6423,3402,3021
1,2024-05-16,동춘,21863,10663,11200
1,2024-05-16,동막,11198,5897,5301
1,2024-05-16,캠퍼스타운,14470,7542,6928
1,2024-05-16,테크노파크,23229,11702,11527
1,2024-05-16,지식정보단지,11353,5507,5846
1,2024-05-16,인천대입구,19832,10002,9830
1,2024-05-16,센트럴파크(재외동포청),8068,4057,4011
1,2024-05-16,국제업무지구,4616,2362,2254
1,2024-05-16,송도달빛축제공원,11555,5711,5844
1,2024-05-17,계양,8896,4456,4440
1,2024-05-17,귤현,2832,1156,1676
1,2024-05-17,박촌,8713,4609,4104
1,2024-05-17,임학,17769,8882,8887
1,2024-05-17,계산,22666,11485,11181
1,2024-05-17,경인교대입구,12124,6074,6050
1,2024-05-17,작전,32737,16608,16129
1,2024-05-17,갈산,19995,10203,9792
1,2024-05-17,부평구청,15278,7481,7797
1,2024-05-17,부평시장,28891,14439,14452
1,2024-05-17,부평,15052,7425,7627
1,2024-05-17,동수,8452,4323,4129
1,2024-05-17,부평삼거리,5793,2936,2857
1,2024-05-17,간석오거리,23009,12106,10903
1,2024-05-17,인천시청,12252,6200,6052
1,2024-05-17,예술회관,27494,13187,14307
1,2024-05-17,인천터미널,31368,15472,15896
1,2024-05-17,문학경기장,4222,2182,2040
1,2024-05-17,선학,13453,6759,6694
1,2024-05-17,신연수,12187,6321,5866
1,2024-05-17,원인재,6563,3454,3109
1,2024-05-17,동춘,22568,10954,11614
1,2024-05-17,동막,11243,5948,5295
1,2024-05-17,캠퍼스타운,14036,7323,6713
1,2024-05-17,테크노파크,25345,12770,12575
1,2024-05-17,지식정보단지,11231,5450,5781
1,2024-05-17,인천대입구,19159,9791,9368
1,2024-05-17,센트럴파크(재외동포청),9796,4851,4945
1,2024-05-17,국제업무지구,4589,2290,2299
1,2024-05-17,송도달빛축제공원,11875,5978,5897
1,2024-05-18,계양,7253,3447,3806
1,2024-05-18,귤현,1721,765,956
1,2024-05-18,박촌,6134,3229,2905
1,2024-05-18,임학,13112,6806,6306
1,2024-05-18,계산,19721,9874,9847
1,2024-05-18,경인교대입구,9653,4928,4725
1,2024-05-18,작전,25032,12852,12180
1,2024-05-18,갈산,11528,5903,5625
1,2024-05-18,부평구청,11286,5568,5718
1,2024-05-18,부평시장,20389,10131,10258
1,2024-05-18,부평,14290,7088,7202
1,2024-05-18,동수,5466,2771,2695
1,2024-05-18,부평삼거리,4575,2273,2302
1,2024-05-18,간석오거리,17392,9049,8343
1,2024-05-18,인천시청,8216,4223,3993
1,2024-05-18,예술회관,18450,8709,9741
1,2024-05-18,인천터미널,29540,14288,15252
1,2024-05-18,문학경기장,3461,1656,1805
1,2024-05-18,선학,11502,5799,5703
1,2024-05-18,신연수,6777,3551,3226
1,2024-05-18,원인재,3910,2075,1835
1,2024-05-18,동춘,16518,8236,8282
1,2024-05-18,동막,7344,3902,3442
1,2024-05-18,캠퍼스타운,9810,5206,4604
1,2024-05-18,테크노파크,20818,10326,10492
1,2024-05-18,지식정보단지,4559,2367,2192
1,2024-05-18,인천대입구,12554,6305,6249
1,2024-05-18,센트럴파크(재외동포청),9261,4533,4728
1,2024-05-18,국제업무지구,2071,1062,1009
1,2024-05-18,송도달빛축제공원,9301,4658,4643
1,2024-05-19,계양,5564,2560,3004
1,2024-05-19,귤현,1219,566,653
1,2024-05-19,박촌,4632,2381,2251
1,2024-05-19,임학,9643,4871,4772
1,2024-05-19,계산,14778,7318,7460
1,2024-05-19,경인교대입구,7844,3932,3912
1,2024-05-19,작전,16752,8452,8300
1,2024-05-19,갈산,7331,3748,3583
1,2024-05-19,부평구청,8212,3986,4226
1,2024-05-19,부평시장,15820,7900,7920
1,2024-05-19,부평,10312,5336,4976
1,2024-05-19,동수,4539,2271,2268
1,2024-05-19,부평삼거리,3600,1721,1879
1,2024-05-19,간석오거리,13082,6896,6186
1,2024-05-19,인천시청,6202,3182,3020
1,2024-05-19,예술회관,13329,6576,6753
1,2024-05-19,인천터미널,24916,12763,12153
1,2024-05-19,문학경기장,15124,7248,7876
1,2024-05-19,선학,8688,4261,4427
1,2024-05-19,신연수,5150,2627,2523
1,2024-05-19,원인재,3307,1740,1567
1,2024-05-19,동춘,12069,5974,6095
1,2024-05-19,동막,4906,2573,2333
1,2024-05-19,캠퍼스타운,7498,3510,3988
1,2024-05-19,테크노파크,16597,8143,8454
1,2024-05-19,지식정보단지,3360,1661,1699
1,2024-05-19,인천대입구,9036,4235,4801
1,2024-05-19,센트럴파크(재외동포청),5949,2908,3041
1,2024-05-19,국제업무지구,948,504,444
1,2024-05-19,송도달빛축제공원,7674,3708,3966
1,2024-05-20,계양,8330,4174,4156
1,2024-05-20,귤현,2598,1033,1565
1,2024-05-20,박촌,8359,4341,4018
1,2024-05-20,임학,16837,8503,8334
1,2024-05-20,계산,21957,11196,10761
1,2024-05-20,경인교대입구,11791,5880,5911
1,2024-05-20,작전,31054,15858,15196
1,2024-05-20,갈산,19451,9889,9562
1,2024-05-20,부평구청,14011,6787,7224
1,2024-05-20,부평시장,27786,13909,13877
1,2024-05-20,부평,13111,6506,6605
1,2024-05-20,동수,8158,4152,4006
1,2024-05-20,부평삼거리,5482,2724,2758
1,2024-05-20,간석오거리,22035,11442,10593
1,2024-05-20,인천시청,11535,5811,5724
1,2024-05-20,예술회관,24205,12130,12075
1,2024-05-20,인천터미널,26239,12677,13562
1,2024-05-20,문학경기장,3985,1974,2011
1,2024-05-20,선학,11972,5970,6002
1,2024-05-20,신연수,12396,6311,6085
1,2024-05-20,원인재,6174,3279,2895
1,2024-05-20,동춘,20495,9993,10502
1,2024-05-20,동막,11028,5888,5140
1,2024-05-20,캠퍼스타운,13208,6564,6644
1,2024-05-20,테크노파크,22440,11214,11226
1,2024-05-20,지식정보단지,11313,5480,5833
1,2024-05-20,인천대입구,18851,9321,9530
1,2024-05-20,센트럴파크(재외동포청),7937,4007,3930
1,2024-05-20,국제업무지구,4503,2278,2225
1,2024-05-20,송도달빛축제공원,10852,5403,5449
1,2024-05-21,계양,8597,4336,4261
1,2024-05-21,귤현,2648,1013,1635
1,2024-05-21,박촌,8429,4372,4057
1,2024-05-21,임학,17150,8655,8495
1,2024-05-21,계산,21830,11054,10776
1,2024-05-21,경인교대입구,11695,5872,5823
1,2024-05-21,작전,31989,16299,15690
1,2024-05-21,갈산,19984,10169,9815
1,2024-05-21,부평구청,14608,7160,7448
1,2024-05-21,부평시장,28276,14129,14147
1,2024-05-21,부평,13020,6450,6570
1,2024-05-21,동수,8538,4343,4195
1,2024-05-21,부평삼거리,5429,2712,2717
1,2024-05-21,간석오거리,22635,11738,10897
1,2024-05-21,인천시청,11854,6017,5837
1,2024-05-21,예술회관,24485,12064,12421
1,2024-05-21,인천터미널,26645,13105,13540
1,2024-05-21,문학경기장,3983,1997,1986
1,2024-05-21,선학,12535,6263,6272
1,2024-05-21,신연수,12290,6234,6056
1,2024-05-21,원인재,6406,3388,3018
1,2024-05-21,동춘,21482,10552,10930
1,2024-05-21,동막,10936,5877,5059
1,2024-05-21,캠퍼스타운,13208,6780,6428
1,2024-05-21,테크노파크,22550,11294,11256
1,2024-05-21,지식정보단지,11366,5482,5884
1,2024-05-21,인천대입구,19476,9771,9705
1,2024-05-21,센트럴파크(재외동포청),8083,4050,4033
1,2024-05-21,국제업무지구,4606,2333,2273
1,2024-05-21,송도달빛축제공원,11166,5533,5633
1,2024-05-22,계양,8584,4288,4296
1,2024-05-22,귤현,2811,1117,1694
1,2024-05-22,박촌,8421,4378,4043
1,2024-05-22,임학,17287,8698,8589
1,2024-05-22,계산,22826,11562,11264
1,2024-05-22,경인교대입구,11911,5942,5969
1,2024-05-22,작전,31564,16003,15561
1,2024-05-22,갈산,20130,10287,9843
1,2024-05-22,부평구청,14924,7321,7603
1,2024-05-22,부평시장,28671,14390,14281
1,2024-05-22,부평,13638,6808,6830
1,2024-05-22,동수,8531,4328,4203
1,2024-05-22,부평삼거리,5565,2793,2772
1,2024-05-22,간석오거리,22877,11917,10960
1,2024-05-22,인천시청,11983,5943,6040
1,2024-05-22,예술회관,25252,12446,12806
1,2024-05-22,인천터미널,26793,13322,13471
1,2024-05-22,문학경기장,4140,2085,2055
1,2024-05-22,선학,13023,6516,6507
1,2024-05-22,신연수,12675,6433,6242
1,2024-05-22,원인재,6377,3407,2970
1,2024-05-22,동춘,21523,10548,10975
1,2024-05-22,동막,11507,6104,5403
1,2024-05-22,캠퍼스타운,13503,6878,6625
1,2024-05-22,테크노파크,23014,11541,11473
1,2024-05-22,지식정보단지,11557,5628,5929
1,2024-05-22,인천대입구,20019,10069,9950
1,2024-05-22,센트럴파크(재외동포청),8640,4329,4311
1,2024-05-22,국제업무지구,4472,2274,2198
1,2024-05-22,송도달빛축제공원,11164,5561,5603
1,2024-05-23,계양,8614,4299,4315
1,2024-05-23,귤현,2689,1076,1613
1,2024-05-23,박촌,8383,4331,4052
1,2024-05-23,임학,17276,8714,8562
1,2024-05-23,계산,22427,11363,11064
1,2024-05-23,경인교대입구,11955,6043,5912
1,2024-05-23,작전,31039,15767,15272
1,2024-05-23,갈산,19651,9972,9679
1,2024-05-23,부평구청,14849,7293,7556
1,2024-05-23,부평시장,27538,13748,13790
1,2024-05-23,부평,13395,6681,6714
1,2024-05-23,동수,8466,4289,4177
1,2024-05-23,부평삼거리,5494,2798,2696
1,2024-05-23,간석오거리,22545,11814,10731
1,2024-05-23,인천시청,11926,6011,5915
1,2024-05-23,예술회관,24897,12158,12739
1,2024-05-23,인천터미널,27749,13826,13923
1,2024-05-23,문학경기장,4185,2035,2150
1,2024-05-23,선학,12695,6349,6346
1,2024-05-23,신연수,12622,6401,6221
1,2024-05-23,원인재,6423,3377,3046
1,2024-05-23,동춘,21884,10669,11215
1,2024-05-23,동막,11147,5901,5246
1,2024-05-23,캠퍼스타운,14381,7614,6767
1,2024-05-23,테크노파크,23218,11624,11594
1,2024-05-23,지식정보단지,11454,5554,5900
1,2024-05-23,인천대입구,19943,10030,9913
1,2024-05-23,센트럴파크(재외동포청),8826,4382,4444
1,2024-05-23,국제업무지구,4639,2333,2306
1,2024-05-23,송도달빛축제공원,11323,5638,5685
1,2024-05-24,계양,8893,4391,4502
1,2024-05-24,귤현,2717,1091,1626
1,2024-05-24,박촌,8520,4519,4001
1,2024-05-24,임학,17700,8869,8831
1,2024-05-24,계산,22307,11326,10981
1,2024-05-24,경인교대입구,12245,6178,6067
1,2024-05-24,작전,32335,16347,15988
1,2024-05-24,갈산,20251,10384,9867
1,2024-05-24,부평구청,15059,7510,7549
1,2024-05-24,부평시장,29226,14574,14652
1,2024-05-24,부평,15616,7548,8068
1,2024-05-24,동수,8709,4437,4272
1,2024-05-24,부평삼거리,5787,2937,2850
1,2024-05-24,간석오거리,23286,12087,11199
1,2024-05-24,인천시청,12101,6151,5950
1,2024-05-24,예술회관,26803,12914,13889
1,2024-05-24,인천터미널,32156,15759,16397
1,2024-05-24,문학경기장,18317,8767,9550
1,2024-05-24,선학,13399,6773,6626
1,2024-05-24,신연수,12225,6281,5944
1,2024-05-24,원인재,6608,3490,3118
1,2024-05-24,동춘,22546,11052,11494
1,2024-05-24,동막,11644,6151,5493
1,2024-05-24,캠퍼스타운,14600,7576,7024
1,2024-05-24,테크노파크,24128,12114,12014
1,2024-05-24,지식정보단지,11129,5435,5694
1,2024-05-24,인천대입구,18769,9573,9196
1,2024-05-24,센트럴파크(재외동포청),9154,4578,4576
1,2024-05-24,국제업무지구,4744,2376,2368
1,2024-05-24,송도달빛축제공원,11715,5863,5852
1,2024-05-25,계양,7287,3518,3769
1,2024-05-25,귤현,1786,796,990
1,2024-05-25,박촌,6207,3317,2890
1,2024-05-25,임학,13598,6942,6656
1,2024-05-25,계산,20625,10332,10293
1,2024-05-25,경인교대입구,9718,4895,4823
1,2024-05-25,작전,25561,13216,12345
1,2024-05-25,갈산,11719,6009,5710
1,2024-05-25,부평구청,11787,5773,6014
1,2024-05-25,부평시장,20602,10318,10284
1,2024-05-25,부평,14906,7425,7481
1,2024-05-25,동수,5567,2882,2685
1,2024-05-25,부평삼거리,4530,2260,2270
1,2024-05-25,간석오거리,17603,9205,8398
1,2024-05-25,인천시청,8130,4193,3937
1,2024-05-25,예술회관,19570,9291,10279
1,2024-05-25,인천터미널,30136,14739,15397
1,2024-05-25,문학경기장,19261,9146,10115
1,2024-05-25,선학,11539,5804,5735
1,2024-05-25,신연수,7131,3774,3357
1,2024-05-25,원인재,4890,2603,2287
1,2024-05-25,동춘,16964,8441,8523
1,2024-05-25,동막,7206,3817,3389
1,2024-05-25,캠퍼스타운,11162,6310,4852
1,2024-05-25,테크노파크,20492,10191,10301
1,2024-05-25,지식정보단지,4637,2435,2202
1,2024-05-25,인천대입구,12064,6039,6025
1,2024-05-25,센트럴파크(재외동포청),9923,4860,5063
1,2024-05-25,국제업무지구,2107,1094,1013
1,2024-05-25,송도달빛축제공원,9630,4894,4736
1,2024-05-26,계양,4718,2183,2535
1,2024-05-26,귤현,1137,524,613
1,2024-05-26,박촌,4240,2173,2067
1,2024-05-26,임학,8729,4431,4298
1,2024-05-26,계산,13434,6697,6737
1,2024-05-26,경인교대입구,7464,3736,3728
1,2024-05-26,작전,15419,7885,7534
1,2024-05-26,갈산,7046,3643,3403
1,2024-05-26,부평구청,7200,3495,3705
1,2024-05-26,부평시장,14560,7201,7359
1,2024-05-26,부평,9954,5183,4771
1,2024-05-26,동수,4260,2186,2074
1,2024-05-26,부평삼거리,3018,1504,1514
1,2024-05-26,간석오거리,11786,6103,5683
1,2024-05-26,인천시청,5417,2736,2681
1,2024-05-26,예술회관,12301,6025,6276
1,2024-05-26,인천터미널,23482,11965,11517
1,2024-05-26,문학경기장,14084,6898,7186
1,2024-05-26,선학,7568,3691,3877
1,2024-05-26,신연수,4799,2417,2382
1,2024-05-26,원인재,2984,1552,1432
1,2024-05-26,동춘,8768,4366,4402
1,2024-05-26,동막,4432,2293,2139
1,2024-05-26,캠퍼스타운,6900,3258,3642
1,2024-05-26,테크노파크,14818,7316,7502
1,2024-05-26,지식정보단지,2926,1424,1502
1,2024-05-26,인천대입구,8008,3758,4250
1,2024-05-26,센트럴파크(재외동포청),4835,2307,2528
1,2024-05-26,국제업무지구,894,481,413
1,2024-05-26,송도달빛축제공원,6149,3022,3127
1,2024-05-27,계양,8314,4148,4166
1,2024-05-27,귤현,2678,1084,1594
1,2024-05-27,박촌,8266,4320,3946
1,2024-05-27,임학,16861,8521,8340
1,2024-05-27,계산,21912,11127,10785
1,2024-05-27,경인교대입구,11579,5830,5749
1,2024-05-27,작전,31204,15949,15255
1,2024-05-27,갈산,19677,9997,9680
1,2024-05-27,부평구청,14527,7115,7412
1,2024-05-27,부평시장,27889,13998,13891
1,2024-05-27,부평,13477,6755,6722
1,2024-05-27,동수,8452,4307,4145
1,2024-05-27,부평삼거리,5428,2757,2671
1,2024-05-27,간석오거리,21895,11430,10465
1,2024-05-27,인천시청,11250,5710,5540
1,2024-05-27,예술회관,24253,11991,12262
1,2024-05-27,인천터미널,26896,13143,13753
1,2024-05-27,문학경기장,3848,1916,1932
1,2024-05-27,선학,12232,6120,6112
1,2024-05-27,신연수,12417,6283,6134
1,2024-05-27,원인재,6372,3361,3011
1,2024-05-27,동춘,21160,10347,10813
1,2024-05-27,동막,10883,5801,5082
1,2024-05-27,캠퍼스타운,13439,6670,6769
1,2024-05-27,테크노파크,22118,11005,11113
1,2024-05-27,지식정보단지,11226,5464,5762
1,2024-05-27,인천대입구,19580,9666,9914
1,2024-05-27,센트럴파크(재외동포청),7958,3990,3968
1,2024-05-27,국제업무지구,4395,2231,2164
1,2024-05-27,송도달빛축제공원,11402,5687,5715
1,2024-05-28,계양,8836,4420,4416
1,2024-05-28,귤현,2741,1066,1675
1,2024-05-28,박촌,8516,4486,4030
1,2024-05-28,임학,17279,8749,8530
1,2024-05-28,계산,21991,11138,10853
1,2024-05-28,경인교대입구,11884,5993,5891
1,2024-05-28,작전,31906,16199,15707
1,2024-05-28,갈산,20050,10230,9820
1,2024-05-28,부평구청,15212,7411,7801
1,2024-05-28,부평시장,28479,14222,14257
1,2024-05-28,부평,13197,6715,6482
1,2024-05-28,동수,8868,4477,4391
1,2024-05-28,부평삼거리,5709,2913,2796
1,2024-05-28,간석오거리,23131,12044,11087
1,2024-05-28,인천시청,12445,6287,6158
1,2024-05-28,예술회관,24747,12176,12571
1,2024-05-28,인천터미널,26432,12968,13464
1,2024-05-28,문학경기장,14186,6704,7482
1,2024-05-28,선학,12650,6289,6361
1,2024-05-28,신연수,12488,6361,6127
1,2024-05-28,원인재,6496,3484,3012
1,2024-05-28,동춘,21346,10482,10864
1,2024-05-28,동막,11029,5836,5193
1,2024-05-28,캠퍼스타운,13779,6992,6787
1,2024-05-28,테크노파크,22706,11381,11325
1,2024-05-28,지식정보단지,11548,5552,5996
1,2024-05-28,인천대입구,20430,10250,10180
1,2024-05-28,센트럴파크(재외동포청),8436,4224,4212
1,2024-05-28,국제업무지구,4521,2281,2240
1,2024-05-28,송도달빛축제공원,11502,5732,5770
1,2024-05-29,계양,9133,4595,4538
1,2024-05-29,귤현,2847,1174,1673
1,2024-05-29,박촌,8548,4420,4128
1,2024-05-29,임학,17291,8702,8589
1,2024-05-29,계산,22419,11479,10940
1,2024-05-29,경인교대입구,11790,5908,5882
1,2024-05-29,작전,31822,16231,15591
1,2024-05-29,갈산,20095,10144,9951
1,2024-05-29,부평구청,15201,7511,7690
1,2024-05-29,부평시장,28664,14340,14324
1,2024-05-29,부평,13665,6822,6843
1,2024-05-29,동수,8553,4329,4224
1,2024-05-29,부평삼거리,5676,2872,2804
1,2024-05-29,간석오거리,22927,11978,10949
1,2024-05-29,인천시청,12324,6205,6119
1,2024-05-29,예술회관,25318,12435,12883
1,2024-05-29,인천터미널,26872,13205,13667
1,2024-05-29,문학경기장,14706,7214,7492
1,2024-05-29,선학,12784,6416,6368
1,2024-05-29,신연수,12299,6257,6042
1,2024-05-29,원인재,6204,3310,2894
1,2024-05-29,동춘,21411,10425,10986
1,2024-05-29,동막,11236,5992,5244
1,2024-05-29,캠퍼스타운,14121,7208,6913
1,2024-05-29,테크노파크,23389,11751,11638
1,2024-05-29,지식정보단지,11575,5632,5943
1,2024-05-29,인천대입구,20200,10199,10001
1,2024-05-29,센트럴파크(재외동포청),9039,4527,4512
1,2024-05-29,국제업무지구,4479,2259,2220
1,2024-05-29,송도달빛축제공원,11557,5758,5799
1,2024-05-30,계양,8778,4371,4407
1,2024-05-30,귤현,2726,1068,1658
1,2024-05-30,박촌,8358,4394,3964
1,2024-05-30,임학,17134,8649,8485
1,2024-05-30,계산,21938,11014,10924
1,2024-05-30,경인교대입구,12020,6013,6007
1,2024-05-30,작전,31101,15821,15280
1,2024-05-30,갈산,19956,10043,9913
1,2024-05-30,부평구청,14992,7314,7678
1,2024-05-30,부평시장,28164,14034,14130
1,2024-05-30,부평,13502,6768,6734
1,2024-05-30,동수,8506,4317,4189
1,2024-05-30,부평삼거리,5673,2845,2828
1,2024-05-30,간석오거리,22688,11835,10853
1,2024-05-30,인천시청,11836,5883,5953
1,2024-05-30,예술회관,24726,12103,12623
1,2024-05-30,인천터미널,27043,13500,13543
1,2024-05-30,문학경기장,15137,7493,7644
1,2024-05-30,선학,12815,6448,6367
1,2024-05-30,신연수,12491,6301,6190
1,2024-05-30,원인재,6151,3303,2848
1,2024-05-30,동춘,21231,10306,10925
1,2024-05-30,동막,10939,5807,5132
1,2024-05-30,캠퍼스타운,14264,7656,6608
1,2024-05-30,테크노파크,22921,11522,11399
1,2024-05-30,지식정보단지,11365,5537,5828
1,2024-05-30,인천대입구,20070,10150,9920
1,2024-05-30,센트럴파크(재외동포청),8643,4332,4311
1,2024-05-30,국제업무지구,4506,2250,2256
1,2024-05-30,송도달빛축제공원,11701,5825,5876
1,2024-05-31,계양,9130,4458,4672
1,2024-05-31,귤현,2704,1092,1612
1,2024-05-31,박촌,8549,4445,4104
1,2024-05-31,임학,17465,8828,8637
1,2024-05-31,계산,22273,11340,10933
1,2024-05-31,경인교대입구,11683,5924,5759
1,2024-05-31,작전,31595,16126,15469
1,2024-05-31,갈산,19795,10056,9739
1,2024-05-31,부평구청,15120,7439,7681
1,2024-05-31,부평시장,28423,14176,14247
1,2024-05-31,부평,15161,7451,7710
1,2024-05-31,동수,8418,4266,4152
1,2024-05-31,부평삼거리,5624,2877,2747
1,2024-05-31,간석오거리,22538,11853,10685
1,2024-05-31,인천시청,11806,5987,5819
1,2024-05-31,예술회관,26167,12622,13545
1,2024-05-31,인천터미널,31151,15172,15979
1,2024-05-31,문학경기장,3979,2019,1960
1,2024-05-31,선학,13318,6675,6643
1,2024-05-31,신연수,12133,6255,5878
1,2024-05-31,원인재,6114,3249,2865
1,2024-05-31,동춘,22488,10928,11560
1,2024-05-31,동막,11231,5992,5239
1,2024-05-31,캠퍼스타운,13783,7204,6579
1,2024-05-31,테크노파크,24205,12095,12110
1,2024-05-31,지식정보단지,10996,5333,5663
1,2024-05-31,인천대입구,18618,9436,9182
1,2024-05-31,센트럴파크(재외동포청),9953,4905,5048
1,2024-05-31,국제업무지구,4785,2387,2398
1,2024-05-31,송도달빛축제공원,11628,5869,5759
1,2024-06-01,계양,6852,3256,3596
1,2024-06-01,귤현,1598,719,879
1,2024-06-01,박촌,6027,3216,2811
1,2024-06-01,임학,12687,6493,6194
1,2024-06-01,계산,19307,9607,9700
1,2024-06-01,경인교대입구,9309,4716,4593
1,2024-06-01,작전,23525,12126,11399
1,2024-06-01,갈산,10888,5606,5282
1,2024-06-01,부평구청,11164,5512,5652
1,2024-06-01,부평시장,19433,9723,9710
1,2024-06-01,부평,14262,7013,7249
1,2024-06-01,동수,5415,2786,2629
1,2024-06-01,부평삼거리,4429,2225,2204
1,2024-06-01,간석오거리,16905,8805,8100
1,2024-06-01,인천시청,7994,4172,3822
1,2024-06-01,예술회관,18181,8597,9584
1,2024-06-01,인천터미널,27612,13518,14094
1,2024-06-01,문학경기장,3114,1532,1582
1,2024-06-01,선학,10653,5445,5208
1,2024-06-01,신연수,6989,3655,3334
1,2024-06-01,원인재,4054,2124,1930
1,2024-06-01,동춘,16533,8186,8347
1,2024-06-01,동막,6816,3639,3177
1,2024-06-01,캠퍼스타운,9619,4996,4623
1,2024-06-01,테크노파크,20193,9995,10198
1,2024-06-01,지식정보단지,4706,2422,2284
1,2024-06-01,인천대입구,11645,5912,5733
1,2024-06-01,센트럴파크(재외동포청),8395,4102,4293
1,2024-06-01,국제업무지구,2081,1095,986
1,2024-06-01,송도달빛축제공원,9464,4809,4655
1,2024-06-02,계양,5081,2379,2702
1,2024-06-02,귤현,1132,515,617
1,2024-06-02,박촌,4432,2300,2132
1,2024-06-02,임학,9410,4804,4606
1,2024-06-02,계산,14564,7164,7400
1,2024-06-02,경인교대입구,7569,3803,3766
1,2024-06-02,작전,15809,7977,7832
1,2024-06-02,갈산,7052,3614,3438
1,2024-06-02,부평구청,7264,3579,3685
1,2024-06-02,부평시장,15090,7506,7584
1,2024-06-02,부평,9524,4995,4529
1,2024-06-02,동수,4210,2157,2053
1,2024-06-02,부평삼거리,3452,1654,1798
1,2024-06-02,간석오거리,12370,6458,5912
1,2024-06-02,인천시청,5938,3032,2906
1,2024-06-02,예술회관,12260,5994,6266
1,2024-06-02,인천터미널,22729,11508,11221
1,2024-06-02,문학경기장,1589,806,783
1,2024-06-02,선학,8163,4087,4076
1,2024-06-02,신연수,4912,2525,2387
1,2024-06-02,원인재,2862,1517,1345
1,2024-06-02,동춘,11842,5815,6027
1,2024-06-02,동막,4553,2353,2200
1,2024-06-02,캠퍼스타운,7502,3546,3956
1,2024-06-02,테크노파크,15639,7673,7966
1,2024-06-02,지식정보단지,3124,1556,1568
1,2024-06-02,인천대입구,7977,3761,4216
1,2024-06-02,센트럴파크(재외동포청),6306,3123,3183
1,2024-06-02,국제업무지구,1045,529,516
1,2024-06-02,송도달빛축제공원,6781,3386,3395
1,2024-06-03,계양,8374,4234,4140
1,2024-06-03,귤현,2703,1074,1629
1,2024-06-03,박촌,8197,4244,3953
1,2024-06-03,임학,16532,8472,8060
1,2024-06-03,계산,21677,11076,10601
1,2024-06-03,경인교대입구,11694,5906,5788
1,2024-06-03,작전,30585,15580,15005
1,2024-06-03,갈산,19517,9972,9545
1,2024-06-03,부평구청,14362,7066,7296
1,2024-06-03,부평시장,27779,13936,13843
1,2024-06-03,부평,12962,6452,6510
1,2024-06-03,동수,8150,4170,3980
1,2024-06-03,부평삼거리,5407,2699,2708
1,2024-06-03,간석오거리,21647,11341,10306
1,2024-06-03,인천시청,11540,5799,5741
1,2024-06-03,예술회관,23418,11618,11800
1,2024-06-03,인천터미널,26171,12685,13486
1,2024-06-03,문학경기장,3935,1922,2013
1,2024-06-03,선학,12343,6217,6126
1,2024-06-03,신연수,12029,6078,5951
1,2024-06-03,원인재,6065,3242,2823
1,2024-06-03,동춘,21046,10362,10684
1,2024-06-03,동막,11107,5845,5262
1,2024-06-03,캠퍼스타운,13283,6574,6709
1,2024-06-03,테크노파크,22009,10929,11080
1,2024-06-03,지식정보단지,11437,5531,5906
1,2024-06-03,인천대입구,19140,9579,9561
1,2024-06-03,센트럴파크(재외동포청),7838,3930,3908
1,2024-06-03,국제업무지구,4437,2252,2185
1,2024-06-03,송도달빛축제공원,10865,5422,5443
1,2024-06-04,계양,8667,4354,4313
1,2024-06-04,귤현,2795,1065,1730
1,2024-06-04,박촌,8352,4345,4007
1,2024-06-04,임학,17095,8637,8458
1,2024-06-04,계산,21507,10841,10666
1,2024-06-04,경인교대입구,11809,5941,5868
1,2024-06-04,작전,31566,16058,15508
1,2024-06-04,갈산,19935,10136,9799
1,2024-06-04,부평구청,14736,7187,7549
1,2024-06-04,부평시장,28483,14263,14220
1,2024-06-04,부평,12962,6547,6415
1,2024-06-04,동수,8523,4302,4221
1,2024-06-04,부평삼거리,5475,2772,2703
1,2024-06-04,간석오거리,22631,11713,10918
1,2024-06-04,인천시청,11940,6099,5841
1,2024-06-04,예술회관,24401,11988,12413
1,2024-06-04,인천터미널,26400,12979,13421
1,2024-06-04,문학경기장,10636,5163,5473
1,2024-06-04,선학,12537,6356,6181
1,2024-06-04,신연수,12425,6307,6118
1,2024-06-04,원인재,6119,3306,2813
1,2024-06-04,동춘,21470,10525,10945
1,2024-06-04,동막,11049,5886,5163
1,2024-06-04,캠퍼스타운,13276,6682,6594
1,2024-06-04,테크노파크,22609,11179,11430
1,2024-06-04,지식정보단지,11667,5649,6018
1,2024-06-04,인천대입구,19774,9982,9792
1,2024-06-04,센트럴파크(재외동포청),8186,4107,4079
1,2024-06-04,국제업무지구,4583,2339,2244
1,2024-06-04,송도달빛축제공원,11468,5745,5723
1,2024-06-05,계양,8924,4431,4493
1,2024-06-05,귤현,2812,1145,1667
1,2024-06-05,박촌,8221,4396,3825
1,2024-06-05,임학,17683,8930,8753
1,2024-06-05,계산,22364,11326,11038
1,2024-06-05,경인교대입구,12263,6215,6048
1,2024-06-05,작전,30880,15752,15128
1,2024-06-05,갈산,20428,10409,10019
1,2024-06-05,부평구청,15154,7444,7710
1,2024-06-05,부평시장,28626,14401,14225
1,2024-06-05,부평,14453,7041,7412
1,2024-06-05,동수,8815,4485,4330
1,2024-06-05,부평삼거리,5659,2877,2782
1,2024-06-05,간석오거리,23080,12028,11052
1,2024-06-05,인천시청,13277,6683,6594
1,2024-06-05,예술회관,26380,12714,13666
1,2024-06-05,인천터미널,29790,14437,15353
1,2024-06-05,문학경기장,13483,6388,7095
1,2024-06-05,선학,13355,6757,6598
1,2024-06-05,신연수,12513,6393,6120
1,2024-06-05,원인재,6344,3371,2973
1,2024-06-05,동춘,22856,11184,11672
1,2024-06-05,동막,11524,6189,5335
1,2024-06-05,캠퍼스타운,14170,7496,6674
1,2024-06-05,테크노파크,23637,11828,11809
1,2024-06-05,지식정보단지,11908,5805,6103
1,2024-06-05,인천대입구,20157,10175,9982
1,2024-06-05,센트럴파크(재외동포청),8535,4240,4295
1,2024-06-05,국제업무지구,4588,2299,2289
1,2024-06-05,송도달빛축제공원,11713,5838,5875
1,2024-06-06,계양,5819,2799,3020
1,2024-06-06,귤현,1328,588,740
1,2024-06-06,박촌,4915,2523,2392
1,2024-06-06,임학,10575,5329,5246
1,2024-06-06,계산,15637,7807,7830
1,2024-06-06,경인교대입구,7777,4035,3742
1,2024-06-06,작전,17787,9084,8703
1,2024-06-06,갈산,8472,4351,4121
1,2024-06-06,부평구청,8796,4299,4497
1,2024-06-06,부평시장,16651,8300,8351
1,2024-06-06,부평,11087,5779,5308
1,2024-06-06,동수,4844,2463,2381
1,2024-06-06,부평삼거리,3858,1919,1939
1,2024-06-06,간석오거리,14783,7709,7074
1,2024-06-06,인천시청,6406,3265,3141
1,2024-06-06,예술회관,15063,7332,7731
1,2024-06-06,인천터미널,24325,12112,12213
1,2024-06-06,문학경기장,17161,8379,8782
1,2024-06-06,선학,9088,4514,4574
1,2024-06-06,신연수,5880,3100,2780
1,2024-06-06,원인재,3313,1711,1602
1,2024-06-06,동춘,14493,7104,7389
1,2024-06-06,동막,5552,2858,2694
1,2024-06-06,캠퍼스타운,8021,4187,3834
1,2024-06-06,테크노파크,17725,8738,8987
1,2024-06-06,지식정보단지,3881,1949,1932
1,2024-06-06,인천대입구,10378,5286,5092
1,2024-06-06,센트럴파크(재외동포청),7232,3527,3705
1,2024-06-06,국제업무지구,1970,998,972
1,2024-06-06,송도달빛축제공원,7930,3954,3976
1,2024-06-07,계양,7744,3862,3882
1,2024-06-07,귤현,2482,1012,1470
1,2024-06-07,박촌,7893,4166,3727
1,2024-06-07,임학,16288,8214,8074
1,2024-06-07,계산,20300,10227,10073
1,2024-06-07,경인교대입구,10914,5537,5377
1,2024-06-07,작전,29734,15179,14555
1,2024-06-07,갈산,17721,9098,8623
1,2024-06-07,부평구청,13830,6792,7038
1,2024-06-07,부평시장,26775,13330,13445
1,2024-06-07,부평,14565,7157,7408
1,2024-06-07,동수,7955,4097,3858
1,2024-06-07,부평삼거리,5285,2715,2570
1,2024-06-07,간석오거리,20809,10926,9883
1,2024-06-07,인천시청,10512,5307,5205
1,2024-06-07,예술회관,24208,11776,12432
1,2024-06-07,인천터미널,28909,14154,14755
1,2024-06-07,문학경기장,3712,1891,1821
1,2024-06-07,선학,12299,6124,6175
1,2024-06-07,신연수,10769,5519,5250
1,2024-06-07,원인재,5441,2840,2601
1,2024-06-07,동춘,20475,10000,10475
1,2024-06-07,동막,10008,5278,4730
1,2024-06-07,캠퍼스타운,12143,6187,5956
1,2024-06-07,테크노파크,22375,11269,11106
1,2024-06-07,지식정보단지,8974,4384,4590
1,2024-06-07,인천대입구,16564,8380,8184
1,2024-06-07,센트럴파크(재외동포청),8499,4232,4267
1,2024-06-07,국제업무지구,4050,2063,1987
1,2024-06-07,송도달빛축제공원,10671,5453,5218
1,2024-06-08,계양,5651,2704,2947
1,2024-06-08,귤현,1443,687,756
1,2024-06-08,박촌,5360,2829,2531
1,2024-06-08,임학,11370,5787,5583
1,2024-06-08,계산,15001,7535,7466
1,2024-06-08,경인교대입구,8568,4288,4280
1,2024-06-08,작전,21445,11002,10443
1,2024-06-08,갈산,9687,5009,4678
1,2024-06-08,부평구청,9868,4838,5030
1,2024-06-08,부평시장,17617,8872,8745
1,2024-06-08,부평,12335,6096,6239
1,2024-06-08,동수,5078,2584,2494
1,2024-06-08,부평삼거리,3654,1806,1848
1,2024-06-08,간석오거리,15168,7938,7230
1,2024-06-08,인천시청,7179,3668,3511
1,2024-06-08,예술회관,16260,7606,8654
1,2024-06-08,인천터미널,25059,12232,12827
1,2024-06-08,문학경기장,2465,1164,1301
1,2024-06-08,선학,9418,4723,4695
1,2024-06-08,신연수,6093,3199,2894
1,2024-06-08,원인재,3691,1901,1790
1,2024-06-08,동춘,14014,6974,7040
1,2024-06-08,동막,6280,3326,2954
1,2024-06-08,캠퍼스타운,7615,3960,3655
1,2024-06-08,테크노파크,17437,8722,8715
1,2024-06-08,지식정보단지,3937,2027,1910
1,2024-06-08,인천대입구,12222,6188,6034
1,2024-06-08,센트럴파크(재외동포청),6918,3435,3483
1,2024-06-08,국제업무지구,2033,1070,963
1,2024-06-08,송도달빛축제공원,7752,3928,3824
1,2024-06-09,계양,4980,2306,2674
1,2024-06-09,귤현,1166,557,609
1,2024-06-09,박촌,4317,2250,2067
1,2024-06-09,임학,9062,4651,4411
1,2024-06-09,계산,13947,6844,7103
1,2024-06-09,경인교대입구,7311,3667,3644
1,2024-06-09,작전,15397,7827,7570
1,2024-06-09,갈산,6692,3377,3315
1,2024-06-09,부평구청,7253,3557,3696
1,2024-06-09,부평시장,14804,7335,7469
1,2024-06-09,부평,8884,4767,4117
1,2024-06-09,동수,4184,2125,2059
1,2024-06-09,부평삼거리,3338,1643,1695
1,2024-06-09,간석오거리,11991,6239,5752
1,2024-06-09,인천시청,5744,2886,2858
1,2024-06-09,예술회관,11468,5628,5840
1,2024-06-09,인천터미널,21954,11225,10729
1,2024-06-09,문학경기장,1393,673,720
1,2024-06-09,선학,7903,3882,4021
1,2024-06-09,신연수,4460,2275,2185
1,2024-06-09,원인재,2512,1312,1200
1,2024-06-09,동춘,8958,4469,4489
1,2024-06-09,동막,4460,2334,2126
1,2024-06-09,캠퍼스타운,6050,2906,3144
1,2024-06-09,테크노파크,13809,6751,7058
1,2024-06-09,지식정보단지,2940,1427,1513
1,2024-06-09,인천대입구,7710,3711,3999
1,2024-06-09,센트럴파크(재외동포청),5105,2508,2597
1,2024-06-09,국제업무지구,1066,551,515
1,2024-06-09,송도달빛축제공원,6429,3194,3235
1,2024-06-10,계양,8272,4137,4135
1,2024-06-10,귤현,2670,1086,1584
1,2024-06-10,박촌,8031,4230,3801
1,2024-06-10,임학,16783,8501,8282
1,2024-06-10,계산,21872,11186,10686
1,2024-06-10,경인교대입구,11604,5737,5867
1,2024-06-10,작전,30225,15370,14855
1,2024-06-10,갈산,19257,9792,9465
1,2024-06-10,부평구청,14190,6990,7200
1,2024-06-10,부평시장,27220,13623,13597
1,2024-06-10,부평,12587,6367,6220
1,2024-06-10,동수,8137,4126,4011
1,2024-06-10,부평삼거리,5131,2587,2544
1,2024-06-10,간석오거리,21672,11321,10351
1,2024-06-10,인천시청,11406,5758,5648
1,2024-06-10,예술회관,23540,11673,11867
1,2024-06-10,인천터미널,23792,11548,12244
1,2024-06-10,문학경기장,3900,1934,1966
1,2024-06-10,선학,11885,5943,5942
1,2024-06-10,신연수,12174,6219,5955
1,2024-06-10,원인재,5954,3249,2705
1,2024-06-10,동춘,20962,10240,10722
1,2024-06-10,동막,10462,5521,4941
1,2024-06-10,캠퍼스타운,12693,6302,6391
1,2024-06-10,테크노파크,21608,10798,10810
1,2024-06-10,지식정보단지,11278,5465,5813
1,2024-06-10,인천대입구,18268,9085,9183
1,2024-06-10,센트럴파크(재외동포청),7791,3896,3895
1,2024-06-10,국제업무지구,4376,2191,2185
1,2024-06-10,송도달빛축제공원,10983,5495,5488
1,2024-06-11,계양,8749,4378,4371
1,2024-06-11,귤현,2699,1060,1639
1,2024-06-11,박촌,8320,4364,3956
1,2024-06-11,임학,16676,8419,8257
1,2024-06-11,계산,21480,10853,10627
1,2024-06-11,경인교대입구,11766,5829,5937
1,2024-06-11,작전,30549,15486,15063
1,2024-06-11,갈산,19798,10005,9793
1,2024-06-11,부평구청,14612,7153,7459
1,2024-06-11,부평시장,27588,13821,13767
1,2024-06-11,부평,12819,6499,6320
1,2024-06-11,동수,8722,4474,4248
1,2024-06-11,부평삼거리,5389,2758,2631
1,2024-06-11,간석오거리,22297,11558,10739
1,2024-06-11,인천시청,11973,6006,5967
1,2024-06-11,예술회관,24868,12234,12634
1,2024-06-11,인천터미널,25919,12603,13316
1,2024-06-11,문학경기장,14020,6694,7326
1,2024-06-11,선학,12361,6156,6205
1,2024-06-11,신연수,12037,6134,5903
1,2024-06-11,원인재,6083,3286,2797
1,2024-06-11,동춘,20966,10250,10716
1,2024-06-11,동막,10859,5766,5093
1,2024-06-11,캠퍼스타운,12544,6318,6226
1,2024-06-11,테크노파크,21974,10944,11030
1,2024-06-11,지식정보단지,11536,5601,5935
1,2024-06-11,인천대입구,18685,9435,9250
1,2024-06-11,센트럴파크(재외동포청),8194,4129,4065
1,2024-06-11,국제업무지구,4580,2331,2249
1,2024-06-11,송도달빛축제공원,10978,5471,5507
1,2024-06-12,계양,8702,4399,4303
1,2024-06-12,귤현,2737,1097,1640
1,2024-06-12,박촌,8646,4482,4164
1,2024-06-12,임학,16819,8467,8352
1,2024-06-12,계산,22098,11232,10866
1,2024-06-12,경인교대입구,11698,5855,5843
1,2024-06-12,작전,31344,15868,15476
1,2024-06-12,갈산,20070,10241,9829
1,2024-06-12,부평구청,14620,7180,7440
1,2024-06-12,부평시장,28271,14171,14100
1,2024-06-12,부평,13225,6665,6560
1,2024-06-12,동수,8523,4352,4171
1,2024-06-12,부평삼거리,5492,2769,2723
1,2024-06-12,간석오거리,22808,11770,11038
1,2024-06-12,인천시청,11642,5799,5843
1,2024-06-12,예술회관,24821,12099,12722
1,2024-06-12,인천터미널,26233,12865,13368
1,2024-06-12,문학경기장,15659,7481,8178
1,2024-06-12,선학,12654,6355,6299
1,2024-06-12,신연수,12389,6330,6059
1,2024-06-12,원인재,6084,3244,2840
1,2024-06-12,동춘,21492,10576,10916
1,2024-06-12,동막,11263,5974,5289
1,2024-06-12,캠퍼스타운,12869,6455,6414
1,2024-06-12,테크노파크,22105,11021,11084
1,2024-06-12,지식정보단지,11551,5682,5869
1,2024-06-12,인천대입구,18623,9377,9246
1,2024-06-12,센트럴파크(재외동포청),8388,4242,4146
1,2024-06-12,국제업무지구,4507,2298,2209
1,2024-06-12,송도달빛축제공원,11333,5626,5707
1,2024-06-13,계양,8754,4361,4393
1,2024-06-13,귤현,2779,1056,1723
1,2024-06-13,박촌,8423,4402,4021
1,2024-06-13,임학,17021,8546,8475
1,2024-06-13,계산,21952,11135,10817
1,2024-06-13,경인교대입구,11957,6032,5925
1,2024-06-13,작전,30943,15737,15206
1,2024-06-13,갈산,19653,9918,9735
1,2024-06-13,부평구청,14681,7295,7386
1,2024-06-13,부평시장,27859,13932,13927
1,2024-06-13,부평,13793,6991,6802
1,2024-06-13,동수,8482,4276,4206
1,2024-06-13,부평삼거리,5351,2697,2654
1,2024-06-13,간석오거리,22605,11756,10849
1,2024-06-13,인천시청,12127,6110,6017
1,2024-06-13,예술회관,24906,12202,12704
1,2024-06-13,인천터미널,27167,13564,13603
1,2024-06-13,문학경기장,17287,8241,9046
1,2024-06-13,선학,12874,6442,6432
1,2024-06-13,신연수,12172,6174,5998
1,2024-06-13,원인재,6353,3388,2965
1,2024-06-13,동춘,21571,10434,11137
1,2024-06-13,동막,11125,5961,5164
1,2024-06-13,캠퍼스타운,12916,6530,6386
1,2024-06-13,테크노파크,22854,11423,11431
1,2024-06-13,지식정보단지,11636,5633,6003
1,2024-06-13,인천대입구,19120,9736,9384
1,2024-06-13,센트럴파크(재외동포청),8585,4262,4323
1,2024-06-13,국제업무지구,4706,2377,2329
1,2024-06-13,송도달빛축제공원,11256,5622,5634
1,2024-06-14,계양,8560,4283,4277
1,2024-06-14,귤현,2853,1196,1657
1,2024-06-14,박촌,8385,4340,4045
1,2024-06-14,임학,17000,8541,8459
1,2024-06-14,계산,21788,11063,10725
1,2024-06-14,경인교대입구,11645,5825,5820
1,2024-06-14,작전,30840,15819,15021
1,2024-06-14,갈산,19656,10011,9645
1,2024-06-14,부평구청,14649,7196,7453
1,2024-06-14,부평시장,27667,13795,13872
1,2024-06-14,부평,14690,7186,7504
1,2024-06-14,동수,8334,4211,4123
1,2024-06-14,부평삼거리,5410,2713,2697
1,2024-06-14,간석오거리,22253,11727,10526
1,2024-06-14,인천시청,11588,5923,5665
1,2024-06-14,예술회관,26145,12617,13528
1,2024-06-14,인천터미널,30598,14857,15741
1,2024-06-14,문학경기장,4196,2105,2091
1,2024-06-14,선학,13850,6946,6904
1,2024-06-14,신연수,11939,6211,5728
1,2024-06-14,원인재,6402,3410,2992
1,2024-06-14,동춘,22597,11008,11589
1,2024-06-14,동막,11480,6111,5369
1,2024-06-14,캠퍼스타운,13217,6773,6444
1,2024-06-14,테크노파크,24330,12109,12221
1,2024-06-14,지식정보단지,11031,5328,5703
1,2024-06-14,인천대입구,18087,9098,8989
1,2024-06-14,센트럴파크(재외동포청),8703,4362,4341
1,2024-06-14,국제업무지구,4649,2354,2295
1,2024-06-14,송도달빛축제공원,11742,5936,5806
1,2024-06-15,계양,6235,2986,3249
1,2024-06-15,귤현,1562,708,854
1,2024-06-15,박촌,5615,3002,2613
1,2024-06-15,임학,12121,6145,5976
1,2024-06-15,계산,16942,8545,8397
1,2024-06-15,경인교대입구,8862,4545,4317
1,2024-06-15,작전,22516,11586,10930
1,2024-06-15,갈산,11008,5654,5354
1,2024-06-15,부평구청,10483,5086,5397
1,2024-06-15,부평시장,18807,9394,9413
1,2024-06-15,부평,13103,6490,6613
1,2024-06-15,동수,5096,2591,2505
1,2024-06-15,부평삼거리,4007,1991,2016
1,2024-06-15,간석오거리,16532,8673,7859
1,2024-06-15,인천시청,7472,3906,3566
1,2024-06-15,예술회관,17961,8553,9408
1,2024-06-15,인천터미널,26983,13002,13981
1,2024-06-15,문학경기장,3210,1551,1659
1,2024-06-15,선학,10723,5409,5314
1,2024-06-15,신연수,6453,3413,3040
1,2024-06-15,원인재,3954,2108,1846
1,2024-06-15,동춘,15638,7764,7874
1,2024-06-15,동막,6587,3477,3110
1,2024-06-15,캠퍼스타운,8444,4477,3967
1,2024-06-15,테크노파크,18554,9202,9352
1,2024-06-15,지식정보단지,4646,2442,2204
1,2024-06-15,인천대입구,11859,5948,5911
1,2024-06-15,센트럴파크(재외동포청),7539,3726,3813
1,2024-06-15,국제업무지구,2231,1143,1088
1,2024-06-15,송도달빛축제공원,8657,4369,4288
1,2024-06-16,계양,5042,2337,2705
1,2024-06-16,귤현,1123,506,617
1,2024-06-16,박촌,4184,2208,1976
1,2024-06-16,임학,9220,4645,4575
1,2024-06-16,계산,13896,6964,6932
1,2024-06-16,경인교대입구,7273,3617,3656
1,2024-06-16,작전,15414,7830,7584
1,2024-06-16,갈산,6625,3362,3263
1,2024-06-16,부평구청,7469,3685,3784
1,2024-06-16,부평시장,14769,7419,7350
1,2024-06-16,부평,9309,4906,4403
1,2024-06-16,동수,4195,2124,2071
1,2024-06-16,부평삼거리,3186,1528,1658
1,2024-06-16,간석오거리,12556,6569,5987
1,2024-06-16,인천시청,5285,2702,2583
1,2024-06-16,예술회관,12012,5810,6202
1,2024-06-16,인천터미널,21826,11144,10682
1,2024-06-16,문학경기장,1611,823,788
1,2024-06-16,선학,8144,4040,4104
1,2024-06-16,신연수,4914,2496,2418
1,2024-06-16,원인재,3283,1704,1579
1,2024-06-16,동춘,11600,5673,5927
1,2024-06-16,동막,4594,2388,2206
1,2024-06-16,캠퍼스타운,6233,3042,3191
1,2024-06-16,테크노파크,15082,7499,7583
1,2024-06-16,지식정보단지,3038,1493,1545
1,2024-06-16,인천대입구,7828,3803,4025
1,2024-06-16,센트럴파크(재외동포청),5273,2587,2686
1,2024-06-16,국제업무지구,1161,596,565
1,2024-06-16,송도달빛축제공원,6620,3295,3325
1,2024-06-17,계양,8168,4100,4068
1,2024-06-17,귤현,2583,1053,1530
1,2024-06-17,박촌,8131,4250,3881
1,2024-06-17,임학,16050,8104,7946
1,2024-06-17,계산,20645,10523,10122
1,2024-06-17,경인교대입구,11343,5599,5744
1,2024-06-17,작전,29896,15185,14711
1,2024-06-17,갈산,18828,9507,9321
1,2024-06-17,부평구청,14109,6957,7152
1,2024-06-17,부평시장,26995,13436,13559
1,2024-06-17,부평,13080,6593,6487
1,2024-06-17,동수,8146,4123,4023
1,2024-06-17,부평삼거리,5312,2713,2599
1,2024-06-17,간석오거리,21144,11046,10098
1,2024-06-17,인천시청,11347,5800,5547
1,2024-06-17,예술회관,23709,11685,12024
1,2024-06-17,인천터미널,25655,12515,13140
1,2024-06-17,문학경기장,3685,1839,1846
1,2024-06-17,선학,11818,5954,5864
1,2024-06-17,신연수,11231,5699,5532
1,2024-06-17,원인재,6049,3203,2846
1,2024-06-17,동춘,20779,10171,10608
1,2024-06-17,동막,11060,5868,5192
1,2024-06-17,캠퍼스타운,12175,6084,6091
1,2024-06-17,테크노파크,21686,10733,10953
1,2024-06-17,지식정보단지,10938,5329,5609
1,2024-06-17,인천대입구,15057,7430,7627
1,2024-06-17,센트럴파크(재외동포청),7528,3779,3749
1,2024-06-17,국제업무지구,4425,2248,2177
1,2024-06-17,송도달빛축제공원,10827,5421,5406
1,2024-06-18,계양,8261,4147,4114
1,2024-06-18,귤현,2671,1088,1583
1,2024-06-18,박촌,8350,4358,3992
1,2024-06-18,임학,16657,8323,8334
1,2024-06-18,계산,20075,10234,9841
1,2024-06-18,경인교대입구,11161,5626,5535
1,2024-06-18,작전,30516,15467,15049
1,2024-06-18,갈산,19244,9768,9476
1,2024-06-18,부평구청,14144,6924,7220
1,2024-06-18,부평시장,27060,13548,13512
1,2024-06-18,부평,12745,6369,6376
1,2024-06-18,동수,8446,4246,4200
1,2024-06-18,부평삼거리,5297,2670,2627
1,2024-06-18,간석오거리,21989,11471,10518
1,2024-06-18,인천시청,11990,6086,5904
1,2024-06-18,예술회관,24121,11828,12293
1,2024-06-18,인천터미널,25169,12359,12810
1,2024-06-18,문학경기장,3823,1890,1933
1,2024-06-18,선학,12349,6184,6165
1,2024-06-18,신연수,11396,5843,5553
1,2024-06-18,원인재,6134,3265,2869
1,2024-06-18,동춘,20746,10134,10612
1,2024-06-18,동막,10799,5671,5128
1,2024-06-18,캠퍼스타운,12492,6254,6238
1,2024-06-18,테크노파크,22275,11120,11155
1,2024-06-18,지식정보단지,10895,5271,5624
1,2024-06-18,인천대입구,15640,7845,7795
1,2024-06-18,센트럴파크(재외동포청),8462,4202,4260
1,2024-06-18,국제업무지구,4709,2386,2323
1,2024-06-18,송도달빛축제공원,11032,5537,5495
1,2024-06-19,계양,8330,4132,4198
1,2024-06-19,귤현,2661,1078,1583
1,2024-06-19,박촌,8313,4346,3967
1,2024-06-19,임학,16630,8407,8223
1,2024-06-19,계산,20392,10216,10176
1,2024-06-19,경인교대입구,11286,5641,5645
1,2024-06-19,작전,30176,15364,14812
1,2024-06-19,갈산,19388,9820,9568
1,2024-06-19,부평구청,14446,7111,7335
1,2024-06-19,부평시장,26878,13515,13363
1,2024-06-19,부평,13365,6730,6635
1,2024-06-19,동수,8381,4217,4164
1,2024-06-19,부평삼거리,5263,2635,2628
1,2024-06-19,간석오거리,22102,11494,10608
1,2024-06-19,인천시청,11710,5850,5860
1,2024-06-19,예술회관,24305,11932,12373
1,2024-06-19,인천터미널,25956,12794,13162
1,2024-06-19,문학경기장,4006,2027,1979
1,2024-06-19,선학,12250,6149,6101
1,2024-06-19,신연수,11317,5797,5520
1,2024-06-19,원인재,6032,3213,2819
1,2024-06-19,동춘,20870,10154,10716
1,2024-06-19,동막,11244,5999,5245
1,2024-06-19,캠퍼스타운,12367,6270,6097
1,2024-06-19,테크노파크,22677,11338,11339
1,2024-06-19,지식정보단지,10818,5205,5613
1,2024-06-19,인천대입구,16303,8075,8228
1,2024-06-19,센트럴파크(재외동포청),8248,4067,4181
1,2024-06-19,국제업무지구,4729,2407,2322
1,2024-06-19,송도달빛축제공원,10757,5366,5391
1,2024-06-20,계양,8222,4068,4154
1,2024-06-20,귤현,2580,1048,1532
1,2024-06-20,박촌,8245,4288,3957
1,2024-06-20,임학,16372,8252,8120
1,2024-06-20,계산,20330,10287,10043
1,2024-06-20,경인교대입구,11406,5735,5671
1,2024-06-20,작전,29694,15112,14582
1,2024-06-20,갈산,19425,9819,9606
1,2024-06-20,부평구청,14073,6919,7154
1,2024-06-20,부평시장,27013,13517,13496
1,2024-06-20,부평,13713,6868,6845
1,2024-06-20,동수,8358,4273,4085
1,2024-06-20,부평삼거리,5345,2671,2674
1,2024-06-20,간석오거리,22196,11578,10618
1,2024-06-20,인천시청,11780,5954,5826
1,2024-06-20,예술회관,24083,11848,12235
1,2024-06-20,인천터미널,26110,12838,13272
1,2024-06-20,문학경기장,3823,1946,1877
1,2024-06-20,선학,12619,6324,6295
1,2024-06-20,신연수,11377,5790,5587
1,2024-06-20,원인재,6247,3316,2931
1,2024-06-20,동춘,21395,10452,10943
1,2024-06-20,동막,11063,5831,5232
1,2024-06-20,캠퍼스타운,12488,6319,6169
1,2024-06-20,테크노파크,22418,11181,11237
1,2024-06-20,지식정보단지,10819,5209,5610
1,2024-06-20,인천대입구,15838,7969,7869
1,2024-06-20,센트럴파크(재외동포청),8510,4259,4251
1,2024-06-20,국제업무지구,4658,2326,2332
1,2024-06-20,송도달빛축제공원,10904,5459,5445
1,2024-06-21,계양,8451,4209,4242
1,2024-06-21,귤현,2717,1108,1609
1,2024-06-21,박촌,8273,4302,3971
1,2024-06-21,임학,16976,8531,8445
1,2024-06-21,계산,20715,10540,10175
1,2024-06-21,경인교대입구,11578,5817,5761
1,2024-06-21,작전,30424,15531,14893
1,2024-06-21,갈산,19377,9876,9501
1,2024-06-21,부평구청,14832,7285,7547
1,2024-06-21,부평시장,27855,13952,13903
1,2024-06-21,부평,14972,7425,7547
1,2024-06-21,동수,8243,4188,4055
1,2024-06-21,부평삼거리,5523,2792,2731
1,2024-06-21,간석오거리,22383,11756,10627
1,2024-06-21,인천시청,11710,6015,5695
1,2024-06-21,예술회관,26053,12442,13611
1,2024-06-21,인천터미널,30806,14825,15981
1,2024-06-21,문학경기장,11770,5543,6227
1,2024-06-21,선학,12742,6467,6275
1,2024-06-21,신연수,11581,5967,5614
1,2024-06-21,원인재,6150,3312,2838
1,2024-06-21,동춘,22395,11017,11378
1,2024-06-21,동막,11130,5946,5184
1,2024-06-21,캠퍼스타운,13243,6814,6429
1,2024-06-21,테크노파크,24073,12010,12063
1,2024-06-21,지식정보단지,10432,5117,5315
1,2024-06-21,인천대입구,15877,7936,7941
1,2024-06-21,센트럴파크(재외동포청),9278,4625,4653
1,2024-06-21,국제업무지구,4616,2317,2299
1,2024-06-21,송도달빛축제공원,11234,5691,5543
1,2024-06-22,계양,5738,2768,2970
1,2024-06-22,귤현,1563,727,836
1,2024-06-22,박촌,5465,2848,2617
1,2024-06-22,임학,11588,5918,5670
1,2024-06-22,계산,15244,7678,7566
1,2024-06-22,경인교대입구,8556,4266,4290
1,2024-06-22,작전,21305,11005,10300
1,2024-06-22,갈산,10250,5297,4953
1,2024-06-22,부평구청,9679,4755,4924
1,2024-06-22,부평시장,17718,8818,8900
1,2024-06-22,부평,12925,6439,6486
1,2024-06-22,동수,5016,2568,2448
1,2024-06-22,부평삼거리,3811,1943,1868
1,2024-06-22,간석오거리,15819,8264,7555
1,2024-06-22,인천시청,7195,3735,3460
1,2024-06-22,예술회관,17059,8030,9029
1,2024-06-22,인천터미널,25717,12468,13249
1,2024-06-22,문학경기장,12119,5821,6298
1,2024-06-22,선학,9563,4761,4802
1,2024-06-22,신연수,5892,3096,2796
1,2024-06-22,원인재,3394,1775,1619
1,2024-06-22,동춘,14535,7181,7354
1,2024-06-22,동막,6377,3434,2943
1,2024-06-22,캠퍼스타운,8084,4227,3857
1,2024-06-22,테크노파크,17225,8551,8674
1,2024-06-22,지식정보단지,4067,2095,1972
1,2024-06-22,인천대입구,10817,5402,5415
1,2024-06-22,센트럴파크(재외동포청),5967,2947,3020
1,2024-06-22,국제업무지구,2094,1077,1017
1,2024-06-22,송도달빛축제공원,7894,3994,3900
1,2024-06-23,계양,4790,2255,2535
1,2024-06-23,귤현,1131,484,647
1,2024-06-23,박촌,4275,2216,2059
1,2024-06-23,임학,8732,4436,4296
1,2024-06-23,계산,13352,6634,6718
1,2024-06-23,경인교대입구,7342,3757,3585
1,2024-06-23,작전,15452,7792,7660
1,2024-06-23,갈산,6922,3616,3306
1,2024-06-23,부평구청,7504,3699,3805
1,2024-06-23,부평시장,15099,7474,7625
1,2024-06-23,부평,9887,5244,4643
1,2024-06-23,동수,4283,2169,2114
1,2024-06-23,부평삼거리,3489,1737,1752
1,2024-06-23,간석오거리,12621,6551,6070
1,2024-06-23,인천시청,5424,2775,2649
1,2024-06-23,예술회관,12072,5795,6277
1,2024-06-23,인천터미널,23072,11817,11255
1,2024-06-23,문학경기장,10023,4933,5090
1,2024-06-23,선학,7875,3868,4007
1,2024-06-23,신연수,4689,2383,2306
1,2024-06-23,원인재,2618,1393,1225
1,2024-06-23,동춘,9643,4792,4851
1,2024-06-23,동막,4666,2418,2248
1,2024-06-23,캠퍼스타운,5995,3059,2936
1,2024-06-23,테크노파크,15881,7805,8076
1,2024-06-23,지식정보단지,2915,1432,1483
1,2024-06-23,인천대입구,8236,4005,4231
1,2024-06-23,센트럴파크(재외동포청),5013,2443,2570
1,2024-06-23,국제업무지구,1177,631,546
1,2024-06-23,송도달빛축제공원,6577,3265,3312
1,2024-06-24,계양,7984,3985,3999
1,2024-06-24,귤현,2499,1017,1482
1,2024-06-24,박촌,7768,4050,3718
1,2024-06-24,임학,15963,8062,7901
1,2024-06-24,계산,18972,9527,9445
1,2024-06-24,경인교대입구,10543,5282,5261
1,2024-06-24,작전,29418,14955,14463
1,2024-06-24,갈산,18790,9511,9279
1,2024-06-24,부평구청,13982,6853,7129
1,2024-06-24,부평시장,26767,13430,13337
1,2024-06-24,부평,13288,6756,6532
1,2024-06-24,동수,8168,4173,3995
1,2024-06-24,부평삼거리,5066,2534,2532
1,2024-06-24,간석오거리,21243,11122,10121
1,2024-06-24,인천시청,11419,5806,5613
1,2024-06-24,예술회관,24069,11890,12179
1,2024-06-24,인천터미널,25134,12404,12730
1,2024-06-24,문학경기장,3629,1827,1802
1,2024-06-24,선학,11749,5817,5932
1,2024-06-24,신연수,11266,5755,5511
1,2024-06-24,원인재,5774,3119,2655
1,2024-06-24,동춘,21109,10273,10836
1,2024-06-24,동막,10820,5686,5134
1,2024-06-24,캠퍼스타운,11987,6040,5947
1,2024-06-24,테크노파크,21568,10725,10843
1,2024-06-24,지식정보단지,10535,5088,5447
1,2024-06-24,인천대입구,14293,7067,7226
1,2024-06-24,센트럴파크(재외동포청),7844,3892,3952
1,2024-06-24,국제업무지구,4668,2390,2278
1,2024-06-24,송도달빛축제공원,10620,5286,5334
1,2024-06-25,계양,8154,4102,4052
1,2024-06-25,귤현,2557,1034,1523
1,2024-06-25,박촌,8096,4216,3880
1,2024-06-25,임학,16491,8335,8156
1,2024-06-25,계산,19764,10028,9736
1,2024-06-25,경인교대입구,10735,5356,5379
1,2024-06-25,작전,30491,15540,14951
1,2024-06-25,갈산,19709,9972,9737
1,2024-06-25,부평구청,14420,7100,7320
1,2024-06-25,부평시장,27690,13879,13811
1,2024-06-25,부평,13269,6698,6571
1,2024-06-25,동수,8480,4311,4169
1,2024-06-25,부평삼거리,5525,2765,2760
1,2024-06-25,간석오거리,22269,11564,10705
1,2024-06-25,인천시청,12181,6122,6059
1,2024-06-25,예술회관,24480,12046,12434
1,2024-06-25,인천터미널,26844,13200,13644
1,2024-06-25,문학경기장,9329,4548,4781
1,2024-06-25,선학,12184,6094,6090
1,2024-06-25,신연수,11367,5794,5573
1,2024-06-25,원인재,6153,3304,2849
1,2024-06-25,동춘,21455,10541,10914
1,2024-06-25,동막,10872,5762,5110
1,2024-06-25,캠퍼스타운,12040,6074,5966
1,2024-06-25,테크노파크,21926,10851,11075
1,2024-06-25,지식정보단지,10696,5190,5506
1,2024-06-25,인천대입구,14624,7300,7324
1,2024-06-25,센트럴파크(재외동포청),8368,4199,4169
1,2024-06-25,국제업무지구,4794,2412,2382
1,2024-06-25,송도달빛축제공원,10956,5480,5476
1,2024-06-26,계양,8260,4121,4139
1,2024-06-26,귤현,2602,1073,1529
1,2024-06-26,박촌,8212,4264,3948
1,2024-06-26,임학,16674,8435,8239
1,2024-06-26,계산,19977,10140,9837
1,2024-06-26,경인교대입구,10940,5413,5527
1,2024-06-26,작전,30339,15436,14903
1,2024-06-26,갈산,19650,9931,9719
1,2024-06-26,부평구청,14479,7141,7338
1,2024-06-26,부평시장,27940,13864,14076
1,2024-06-26,부평,13899,7107,6792
1,2024-06-26,동수,8300,4184,4116
1,2024-06-26,부평삼거리,5414,2700,2714
1,2024-06-26,간석오거리,22635,11759,10876
1,2024-06-26,인천시청,11862,5996,5866
1,2024-06-26,예술회관,25321,12397,12924
1,2024-06-26,인천터미널,26604,13257,13347
1,2024-06-26,문학경기장,10483,5053,5430
1,2024-06-26,선학,12157,6110,6047
1,2024-06-26,신연수,11496,5844,5652
1,2024-06-26,원인재,6166,3258,2908
1,2024-06-26,동춘,21375,10499,10876
1,2024-06-26,동막,11060,5818,5242
1,2024-06-26,캠퍼스타운,12020,6023,5997
1,2024-06-26,테크노파크,22228,11142,11086
1,2024-06-26,지식정보단지,10716,5215,5501
1,2024-06-26,인천대입구,15071,7565,7506
1,2024-06-26,센트럴파크(재외동포청),8423,4258,4165
1,2024-06-26,국제업무지구,4844,2461,2383
1,2024-06-26,송도달빛축제공원,11076,5569,5507
1,2024-06-27,계양,8316,4054,4262
1,2024-06-27,귤현,2572,1025,1547
1,2024-06-27,박촌,8014,4203,3811
1,2024-06-27,임학,16360,8384,7976
1,2024-06-27,계산,19857,9971,9886
1,2024-06-27,경인교대입구,10760,5352,5408
1,2024-06-27,작전,30087,15342,14745
1,2024-06-27,갈산,19468,9919,9549
1,2024-06-27,부평구청,14411,7108,7303
1,2024-06-27,부평시장,27224,13699,13525
1,2024-06-27,부평,13584,6830,6754
1,2024-06-27,동수,8316,4190,4126
1,2024-06-27,부평삼거리,5455,2775,2680
1,2024-06-27,간석오거리,22011,11526,10485
1,2024-06-27,인천시청,11776,5966,5810
1,2024-06-27,예술회관,24491,11943,12548
1,2024-06-27,인천터미널,26505,13099,13406
1,2024-06-27,문학경기장,10432,4976,5456
1,2024-06-27,선학,12317,6190,6127
1,2024-06-27,신연수,11150,5727,5423
1,2024-06-27,원인재,6096,3252,2844
1,2024-06-27,동춘,21746,10575,11171
1,2024-06-27,동막,10713,5698,5015
1,2024-06-27,캠퍼스타운,12082,6075,6007
1,2024-06-27,테크노파크,22518,11196,11322
1,2024-06-27,지식정보단지,10775,5260,5515
1,2024-06-27,인천대입구,14423,7184,7239
1,2024-06-27,센트럴파크(재외동포청),8811,4379,4432
1,2024-06-27,국제업무지구,4986,2487,2499
1,2024-06-27,송도달빛축제공원,10767,5387,5380
1,2024-06-28,계양,8401,4221,4180
1,2024-06-28,귤현,2678,1093,1585
1,2024-06-28,박촌,8248,4340,3908
1,2024-06-28,임학,17181,8614,8567
1,2024-06-28,계산,20173,10153,10020
1,2024-06-28,경인교대입구,11212,5619,5593
1,2024-06-28,작전,31121,15928,15193
1,2024-06-28,갈산,19235,9686,9549
1,2024-06-28,부평구청,14334,7011,7323
1,2024-06-28,부평시장,28148,14058,14090
1,2024-06-28,부평,14962,7472,7490
1,2024-06-28,동수,8184,4189,3995
1,2024-06-28,부평삼거리,5563,2839,2724
1,2024-06-28,간석오거리,22389,11830,10559
1,2024-06-28,인천시청,11780,5991,5789
1,2024-06-28,예술회관,25648,12195,13453
1,2024-06-28,인천터미널,29855,14581,15274
1,2024-06-28,문학경기장,3698,1872,1826
1,2024-06-28,선학,12915,6548,6367
1,2024-06-28,신연수,11135,5748,5387
1,2024-06-28,원인재,6138,3235,2903
1,2024-06-28,동춘,22345,10955,11390
1,2024-06-28,동막,11073,5852,5221
1,2024-06-28,캠퍼스타운,12140,6108,6032
1,2024-06-28,테크노파크,23182,11509,11673
1,2024-06-28,지식정보단지,10625,5202,5423
1,2024-06-28,인천대입구,14968,7477,7491
1,2024-06-28,센트럴파크(재외동포청),9071,4471,4600
1,2024-06-28,국제업무지구,4842,2434,2408
1,2024-06-28,송도달빛축제공원,11395,5706,5689
1,2024-06-29,계양,6322,3028,3294
1,2024-06-29,귤현,1535,716,819
1,2024-06-29,박촌,5382,2854,2528
1,2024-06-29,임학,12147,6163,5984
1,2024-06-29,계산,16732,8444,8288
1,2024-06-29,경인교대입구,8529,4244,4285
1,2024-06-29,작전,21975,11233,10742
1,2024-06-29,갈산,10346,5234,5112
1,2024-06-29,부평구청,9784,4789,4995
1,2024-06-29,부평시장,18999,9423,9576
1,2024-06-29,부평,13251,6678,6573
1,2024-06-29,동수,5244,2686,2558
1,2024-06-29,부평삼거리,4050,2009,2041
1,2024-06-29,간석오거리,16356,8546,7810
1,2024-06-29,인천시청,6991,3582,3409
1,2024-06-29,예술회관,17563,8454,9109
1,2024-06-29,인천터미널,26194,12788,13406
1,2024-06-29,문학경기장,2785,1356,1429
1,2024-06-29,선학,10190,5043,5147
1,2024-06-29,신연수,6091,3199,2892
1,2024-06-29,원인재,3524,1886,1638
1,2024-06-29,동춘,14974,7411,7563
1,2024-06-29,동막,6361,3375,2986
1,2024-06-29,캠퍼스타운,7794,4027,3767
1,2024-06-29,테크노파크,19402,9567,9835
1,2024-06-29,지식정보단지,4282,2225,2057
1,2024-06-29,인천대입구,10497,5104,5393
1,2024-06-29,센트럴파크(재외동포청),7035,3430,3605
1,2024-06-29,국제업무지구,2518,1293,1225
1,2024-06-29,송도달빛축제공원,10136,5081,5055
1,2024-06-30,계양,4087,1898,2189
1,2024-06-30,귤현,984,444,540
1,2024-06-30,박촌,3855,1993,1862
1,2024-06-30,임학,7881,4026,3855
1,2024-06-30,계산,10459,5256,5203
1,2024-06-30,경인교대입구,6431,3218,3213
1,2024-06-30,작전,13748,6957,6791
1,2024-06-30,갈산,6143,3113,3030
1,2024-06-30,부평구청,6087,2984,3103
1,2024-06-30,부평시장,13231,6607,6624
1,2024-06-30,부평,8356,4438,3918
1,2024-06-30,동수,3781,1914,1867
1,2024-06-30,부평삼거리,2808,1392,1416
1,2024-06-30,간석오거리,11296,5879,5417
1,2024-06-30,인천시청,4749,2414,2335
1,2024-06-30,예술회관,10599,5134,5465
1,2024-06-30,인천터미널,19623,10000,9623
1,2024-06-30,문학경기장,1426,706,720
1,2024-06-30,선학,7205,3527,3678
1,2024-06-30,신연수,4111,2131,1980
1,2024-06-30,원인재,2236,1153,1083
1,2024-06-30,동춘,10061,5028,5033
1,2024-06-30,동막,4028,2116,1912
1,2024-06-30,캠퍼스타운,5172,2603,2569
1,2024-06-30,테크노파크,13644,6745,6899
1,2024-06-30,지식정보단지,2808,1377,1431
1,2024-06-30,인천대입구,7030,3415,3615
1,2024-06-30,센트럴파크(재외동포청),4577,2240,2337
1,2024-06-30,국제업무지구,1083,585,498
1,2024-06-30,송도달빛축제공원,5804,2871,2933
2,2023-07-01,검단오류(검단산업단지),2166,1146,1020
2,2023-07-01,왕길,3032,1556,1476
2,2023-07-01,검단사거리,13381,6860,6521
2,2023-07-01,마전,5730,2871,2859
2,2023-07-01,완정,9745,5112,4633
2,2023-07-01,독정,5056,2487,2569
2,2023-07-01,검암,4689,2540,2149
2,2023-07-01,검바위,3660,1754,1906
2,2023-07-01,아시아드경기장(공촌사거리),6590,3427,3163
2,2023-07-01,서구청,10627,5280,5347
2,2023-07-01,가정(루원시티),14129,7318,6811
2,2023-07-01,가정중앙시장,9251,4537,4714
2,2023-07-01,석남(거북시장),4551,2233,2318
2,2023-07-01,서부여성회관,5878,3004,2874
2,2023-07-01,인천가좌,4534,2285,2249
2,2023-07-01,가재울,3883,1979,1904
2,2023-07-01,주안국가산단,1501,736,765
2,2023-07-01,주안,12622,5059,7563
2,2023-07-01,시민공원(문화창작지대),12901,6645,6256
2,2023-07-01,석바위시장,6284,3060,3224
2,2023-07-01,인천시청,4379,2073,2306
2,2023-07-01,석천사거리,6036,3199,2837
2,2023-07-01,모래내시장,12655,6153,6502
2,2023-07-01,만수,7422,3865,3557
2,2023-07-01,남동구청,5571,2866,2705
2,2023-07-01,인천대공원,6174,3087,3087
2,2023-07-01,운연(서창),1659,865,794
2,2023-07-02,검단오류(검단산업단지),1484,742,742
2,2023-07-02,왕길,1942,960,982
2,2023-07-02,검단사거리,9936,4931,5005
2,2023-07-02,마전,4232,2066,2166
2,2023-07-02,완정,6764,3385,3379
2,2023-07-02,독정,3936,1913,2023
2,2023-07-02,검암,3331,1764,1567
2,2023-07-02,검바위,2984,1388,1596
2,2023-07-02,아시아드경기장(공촌사거리),4923,2598,2325
2,2023-07-02,서구청,7543,3791,3752
2,2023-07-02,가정(루원시티),9931,5061,4870
2,2023-07-02,가정중앙시장,6700,3290,3410
2,2023-07-02,석남(거북시장),3339,1581,1758
2,2023-07-02,서부여성회관,5010,2562,2448
2,2023-07-02,인천가좌,3174,1614,1560
2,2023-07-02,가재울,2906,1458,1448
2,2023-07-02,주안국가산단,708,333,375
2,2023-07-02,주안,9063,3741,5322
2,2023-07-02,시민공원(문화창작지대),10257,5221,5036
2,2023-07-02,석바위시장,4748,2329,2419
2,2023-07-02,인천시청,3324,1574,1750
2,2023-07-02,석천사거리,4391,2331,2060
2,2023-07-02,모래내시장,9367,4590,4777
2,2023-07-02,만수,5780,2942,2838
2,2023-07-02,남동구청,4178,2202,1976
2,2023-07-02,인천대공원,5600,2780,2820
2,2023-07-02,운연(서창),1297,668,629
2,2023-07-03,검단오류(검단산업단지),5792,2806,2986
2,2023-07-03,왕길,5170,2611,2559
2,2023-07-03,검단사거리,16584,8628,7956
2,2023-07-03,마전,8831,4346,4485
2,2023-07-03,완정,14934,7742,7192
2,2023-07-03,독정,8133,4031,4102
2,2023-07-03,검암,5869,3110,2759
2,2023-07-03,검바위,7297,3501,3796
2,2023-07-03,아시아드경기장(공촌사거리),9495,5085,4410
2,2023-07-03,서구청,16834,8351,8483
2,2023-07-03,가정(루원시티),22665,11550,11115
2,2023-07-03,가정중앙시장,10800,5176,5624
2,2023-07-03,석남(거북시장),6078,2963,3115
2,2023-07-03,서부여성회관,7955,4084,3871
2,2023-07-03,인천가좌,8239,4208,4031
2,2023-07-03,가재울,7261,3677,3584
2,2023-07-03,주안국가산단,5506,2682,2824
2,2023-07-03,주안,15259,6532,8727
2,2023-07-03,시민공원(문화창작지대),18428,9517,8911
2,2023-07-03,석바위시장,8840,4317,4523
2,2023-07-03,인천시청,6197,2976,3221
2,2023-07-03,석천사거리,9231,4740,4491
2,2023-07-03,모래내시장,15252,7415,7837
2,2023-07-03,만수,10089,5234,4855
2,2023-07-03,남동구청,9222,4712,4510
2,2023-07-03,인천대공원,4808,2388,2420
2,2023-07-03,운연(서창),2537,1310,1227
2,2023-07-04,검단오류(검단산업단지),5669,2756,2913
2,2023-07-04,왕길,4935,2438,2497
2,2023-07-04,검단사거리,15297,8030,7267
2,2023-07-04,마전,8492,4138,4354
2,2023-07-04,완정,14129,7357,6772
2,2023-07-04,독정,7563,3739,3824
2,2023-07-04,검암,5649,2918,2731
2,2023-07-04,검바위,7098,3403,3695
2,2023-07-04,아시아드경기장(공촌사거리),8964,4771,4193
2,2023-07-04,서구청,15384,7605,7779
2,2023-07-04,가정(루원시티),21465,10959,10506
2,2023-07-04,가정중앙시장,9926,4783,5143
2,2023-07-04,석남(거북시장),5516,2678,2838
2,2023-07-04,서부여성회관,7320,3738,3582
2,2023-07-04,인천가좌,7942,4015,3927
2,2023-07-04,가재울,6832,3462,3370
2,2023-07-04,주안국가산단,5552,2718,2834
2,2023-07-04,주안,14002,5949,8053
2,2023-07-04,시민공원(문화창작지대),17622,9073,8549
2,2023-07-04,석바위시장,8401,4051,4350
2,2023-07-04,인천시청,5953,2866,3087
2,2023-07-04,석천사거리,8996,4558,4438
2,2023-07-04,모래내시장,13484,6636,6848
2,2023-07-04,만수,9560,4988,4572
2,2023-07-04,남동구청,8259,4268,3991
2,2023-07-04,인천대공원,3572,1813,1759
2,2023-07-04,운연(서창),2364,1257,1107
2,2023-07-05,검단오류(검단산업단지),5885,2891,2994
2,2023-07-05,왕길,5288,2664,2624
2,2023-07-05,검단사거리,16765,8736,8029
2,2023-07-05,마전,8801,4323,4478
2,2023-07-05,완정,15558,8109,7449
2,2023-07-05,독정,8266,4158,4108
2,2023-07-05,검암,6090,3253,2837
2,2023-07-05,검바위,7410,3603,3807
2,2023-07-05,아시아드경기장(공촌사거리),9749,5216,4533
2,2023-07-05,서구청,17288,8458,8830
2,2023-07-05,가정(루원시티),23271,11951,11320
2,2023-07-05,가정중앙시장,11812,5683,6129
2,2023-07-05,석남(거북시장),6337,3074,3263
2,2023-07-05,서부여성회관,8347,4255,4092
2,2023-07-05,인천가좌,8631,4399,4232
2,2023-07-05,가재울,7500,3807,3693
2,2023-07-05,주안국가산단,5683,2745,2938
2,2023-07-05,주안,15903,6903,9000
2,2023-07-05,시민공원(문화창작지대),18767,9599,9168
2,2023-07-05,석바위시장,9152,4444,4708
2,2023-07-05,인천시청,6801,3238,3563
2,2023-07-05,석천사거리,9531,4948,4583
2,2023-07-05,모래내시장,16048,7792,8256
2,2023-07-05,만수,10659,5507,5152
2,2023-07-05,남동구청,9315,4866,4449
2,2023-07-05,인천대공원,5227,2634,2593
2,2023-07-05,운연(서창),2874,1511,1363
2,2023-07-06,검단오류(검단산업단지),5895,2914,2981
2,2023-07-06,왕길,5425,2749,2676
2,2023-07-06,검단사거리,17128,8929,8199
2,2023-07-06,마전,9021,4440,4581
2,2023-07-06,완정,15490,7990,7500
2,2023-07-06,독정,8609,4297,4312
2,2023-07-06,검암,6078,3230,2848
2,2023-07-06,검바위,7737,3796,3941
2,2023-07-06,아시아드경기장(공촌사거리),9444,5036,4408
2,2023-07-06,서구청,17146,8449,8697
2,2023-07-06,가정(루원시티),23673,12126,11547
2,2023-07-06,가정중앙시장,11462,5534,5928
2,2023-07-06,석남(거북시장),6251,3002,3249
2,2023-07-06,서부여성회관,8298,4248,4050
2,2023-07-06,인천가좌,8660,4405,4255
2,2023-07-06,가재울,7256,3656,3600
2,2023-07-06,주안국가산단,5774,2824,2950
2,2023-07-06,주안,15858,6805,9053
2,2023-07-06,시민공원(문화창작지대),18753,9616,9137
2,2023-07-06,석바위시장,9088,4359,4729
2,2023-07-06,인천시청,6928,3310,3618
2,2023-07-06,석천사거리,9581,4990,4591
2,2023-07-06,모래내시장,15529,7573,7956
2,2023-07-06,만수,10521,5391,5130
2,2023-07-06,남동구청,9361,4866,4495
2,2023-07-06,인천대공원,5365,2732,2633
2,2023-07-06,운연(서창),2688,1463,1225
2,2023-07-07,검단오류(검단산업단지),5924,2937,2987
2,2023-07-07,왕길,5555,2812,2743
2,2023-07-07,검단사거리,18570,9617,8953
2,2023-07-07,마전,9518,4776,4742
2,2023-07-07,완정,16627,8691,7936
2,2023-07-07,독정,9098,4543,4555
2,2023-07-07,검암,6364,3377,2987
2,2023-07-07,검바위,7871,3852,4019
2,2023-07-07,아시아드경기장(공촌사거리),9769,5303,4466
2,2023-07-07,서구청,17705,8714,8991
2,2023-07-07,가정(루원시티),24102,12374,11728
2,2023-07-07,가정중앙시장,11912,5702,6210
2,2023-07-07,석남(거북시장),6500,3215,3285
2,2023-07-07,서부여성회관,8800,4461,4339
2,2023-07-07,인천가좌,8634,4398,4236
2,2023-07-07,가재울,7534,3832,3702
2,2023-07-07,주안국가산단,5619,2750,2869
2,2023-07-07,주안,16634,7113,9521
2,2023-07-07,시민공원(문화창작지대),19211,9808,9403
2,2023-07-07,석바위시장,9265,4519,4746
2,2023-07-07,인천시청,6706,3187,3519
2,2023-07-07,석천사거리,9673,5103,4570
2,2023-07-07,모래내시장,16500,8049,8451
2,2023-07-07,만수,10909,5658,5251
2,2023-07-07,남동구청,9374,4872,4502
2,2023-07-07,인천대공원,5308,2695,2613
2,2023-07-07,운연(서창),2673,1425,1248
2,2023-07-08,검단오류(검단산업단지),2200,1171,1029
2,2023-07-08,왕길,3021,1580,1441
2,2023-07-08,검단사거리,13650,7032,6618
2,2023-07-08,마전,5978,2986,2992
2,2023-07-08,완정,10358,5417,4941
2,2023-07-08,독정,5621,2776,2845
2,2023-07-08,검암,4912,2643,2269
2,2023-07-08,검바위,3839,1864,1975
2,2023-07-08,아시아드경기장(공촌사거리),6943,3604,3339
2,2023-07-08,서구청,11192,5578,5614
2,2023-07-08,가정(루원시티),14667,7466,7201
2,2023-07-08,가정중앙시장,9572,4607,4965
2,2023-07-08,석남(거북시장),4852,2298,2554
2,2023-07-08,서부여성회관,6138,3224,2914
2,2023-07-08,인천가좌,4750,2429,2321
2,2023-07-08,가재울,4077,2069,2008
2,2023-07-08,주안국가산단,1504,743,761
2,2023-07-08,주안,13420,5489,7931
2,2023-07-08,시민공원(문화창작지대),13115,6730,6385
2,2023-07-08,석바위시장,6558,3186,3372
2,2023-07-08,인천시청,4609,2160,2449
2,2023-07-08,석천사거리,6245,3295,2950
2,2023-07-08,모래내시장,13147,6467,6680
2,2023-07-08,만수,7823,4017,3806
2,2023-07-08,남동구청,5893,3049,2844
2,2023-07-08,인천대공원,6141,3061,3080
2,2023-07-08,운연(서창),1914,984,930
2,2023-07-09,검단오류(검단산업단지),1371,657,714
2,2023-07-09,왕길,1819,906,913
2,2023-07-09,검단사거리,9146,4549,4597
2,2023-07-09,마전,3880,1877,2003
2,2023-07-09,완정,6472,3291,3181
2,2023-07-09,독정,3318,1611,1707
2,2023-07-09,검암,2967,1549,1418
2,2023-07-09,검바위,2716,1268,1448
2,2023-07-09,아시아드경기장(공촌사거리),4590,2462,2128
2,2023-07-09,서구청,6995,3528,3467
2,2023-07-09,가정(루원시티),9402,4730,4672
2,2023-07-09,가정중앙시장,6214,3053,3161
2,2023-07-09,석남(거북시장),3037,1436,1601
2,2023-07-09,서부여성회관,4383,2250,2133
2,2023-07-09,인천가좌,2988,1499,1489
2,2023-07-09,가재울,2636,1301,1335
2,2023-07-09,주안국가산단,704,338,366
2,2023-07-09,주안,8467,3520,4947
2,2023-07-09,시민공원(문화창작지대),9155,4647,4508
2,2023-07-09,석바위시장,4426,2132,2294
2,2023-07-09,인천시청,3194,1576,1618
2,2023-07-09,석천사거리,4032,2127,1905
2,2023-07-09,모래내시장,8155,3970,4185
2,2023-07-09,만수,5272,2718,2554
2,2023-07-09,남동구청,3684,1907,1777
2,2023-07-09,인천대공원,3495,1737,1758
2,2023-07-09,운연(서창),1177,609,568
2,2023-07-10,검단오류(검단산업단지),5789,2821,2968
2,2023-07-10,왕길,5279,2628,2651
2,2023-07-10,검단사거리,16412,8566,7846
2,2023-07-10,마전,8709,4266,4443
2,2023-07-10,완정,14991,7746,7245
2,2023-07-10,독정,8396,4196,4200
2,2023-07-10,검암,5948,3162,2786
2,2023-07-10,검바위,7364,3573,3791
2,2023-07-10,아시아드경기장(공촌사거리),9478,5049,4429
2,2023-07-10,서구청,16759,8339,8420
2,2023-07-10,가정(루원시티),22416,11471,10945
2,2023-07-10,가정중앙시장,11176,5398,5778
2,2023-07-10,석남(거북시장),6101,2956,3145
2,2023-07-10,서부여성회관,8011,4108,3903
2,2023-07-10,인천가좌,8191,4124,4067
2,2023-07-10,가재울,7228,3704,3524
2,2023-07-10,주안국가산단,5584,2723,2861
2,2023-07-10,주안,15059,6501,8558
2,2023-07-10,시민공원(문화창작지대),18391,9484,8907
2,2023-07-10,석바위시장,8984,4332,4652
2,2023-07-10,인천시청,6385,3089,3296
2,2023-07-10,석천사거리,8993,4684,4309
2,2023-07-10,모래내시장,15162,7323,7839
2,2023-07-10,만수,9893,5092,4801
2,2023-07-10,남동구청,8880,4625,4255
2,2023-07-10,인천대공원,4321,2166,2155
2,2023-07-10,운연(서창),2474,1320,1154
2,2023-07-11,검단오류(검단산업단지),5654,2736,2918
2,2023-07-11,왕길,4843,2415,2428
2,2023-07-11,검단사거리,15077,7926,7151
2,2023-07-11,마전,8298,4029,4269
2,2023-07-11,완정,14195,7371,6824
2,2023-07-11,독정,7613,3758,3855
2,2023-07-11,검암,5772,3128,2644
2,2023-07-11,검바위,6967,3317,3650
2,2023-07-11,아시아드경기장(공촌사거리),8942,4786,4156
2,2023-07-11,서구청,15508,7701,7807
2,2023-07-11,가정(루원시티),21515,11007,10508
2,2023-07-11,가정중앙시장,10349,4948,5401
2,2023-07-11,석남(거북시장),5538,2705,2833
2,2023-07-11,서부여성회관,7469,3815,3654
2,2023-07-11,인천가좌,7958,4029,3929
2,2023-07-11,가재울,6914,3501,3413
2,2023-07-11,주안국가산단,5518,2699,2819
2,2023-07-11,주안,14322,6163,8159
2,2023-07-11,시민공원(문화창작지대),17724,9146,8578
2,2023-07-11,석바위시장,8215,3913,4302
2,2023-07-11,인천시청,5944,2866,3078
2,2023-07-11,석천사거리,8873,4581,4292
2,2023-07-11,모래내시장,13473,6546,6927
2,2023-07-11,만수,9298,4831,4467
2,2023-07-11,남동구청,8368,4337,4031
2,2023-07-11,인천대공원,3359,1694,1665
2,2023-07-11,운연(서창),2315,1251,1064
2,2023-07-12,검단오류(검단산업단지),5860,2882,2978
2,2023-07-12,왕길,5302,2641,2661
2,2023-07-12,검단사거리,16768,8787,7981
2,2023-07-12,마전,9403,4631,4772
2,2023-07-12,완정,16405,8506,7899
2,2023-07-12,독정,8689,4329,4360
2,2023-07-12,검암,6200,3334,2866
2,2023-07-12,검바위,7684,3712,3972
2,2023-07-12,아시아드경기장(공촌사거리),9862,5276,4586
2,2023-07-12,서구청,17450,8657,8793
2,2023-07-12,가정(루원시티),23879,12191,11688
2,2023-07-12,가정중앙시장,11911,5733,6178
2,2023-07-12,석남(거북시장),6586,3226,3360
2,2023-07-12,서부여성회관,8461,4310,4151
2,2023-07-12,인천가좌,8834,4494,4340
2,2023-07-12,가재울,7559,3822,3737
2,2023-07-12,주안국가산단,5684,2744,2940
2,2023-07-12,주안,15952,6878,9074
2,2023-07-12,시민공원(문화창작지대),19310,9957,9353
2,2023-07-12,석바위시장,9092,4388,4704
2,2023-07-12,인천시청,6868,3290,3578
2,2023-07-12,석천사거리,9739,4939,4800
2,2023-07-12,모래내시장,16279,7909,8370
2,2023-07-12,만수,10515,5451,5064
2,2023-07-12,남동구청,9457,4928,4529
2,2023-07-12,인천대공원,4945,2505,2440
2,2023-07-12,운연(서창),2771,1479,1292
2,2023-07-13,검단오류(검단산업단지),5550,2715,2835
2,2023-07-13,왕길,5006,2473,2533
2,2023-07-13,검단사거리,15042,7739,7303
2,2023-07-13,마전,8526,4140,4386
2,2023-07-13,완정,13939,7191,6748
2,2023-07-13,독정,7737,3858,3879
2,2023-07-13,검암,5738,3043,2695
2,2023-07-13,검바위,6948,3322,3626
2,2023-07-13,아시아드경기장(공촌사거리),8403,4546,3857
2,2023-07-13,서구청,15064,7389,7675
2,2023-07-13,가정(루원시티),21556,11097,10459
2,2023-07-13,가정중앙시장,10084,4829,5255
2,2023-07-13,석남(거북시장),5482,2652,2830
2,2023-07-13,서부여성회관,7465,3801,3664
2,2023-07-13,인천가좌,7874,3941,3933
2,2023-07-13,가재울,6806,3437,3369
2,2023-07-13,주안국가산단,5449,2636,2813
2,2023-07-13,주안,13867,5949,7918
2,2023-07-13,시민공원(문화창작지대),17226,8813,8413
2,2023-07-13,석바위시장,7770,3762,4008
2,2023-07-13,인천시청,5883,2838,3045
2,2023-07-13,석천사거리,8658,4401,4257
2,2023-07-13,모래내시장,12782,6244,6538
2,2023-07-13,만수,9030,4655,4375
2,2023-07-13,남동구청,8064,4136,3928
2,2023-07-13,인천대공원,3180,1652,1528
2,2023-07-13,운연(서창),2229,1216,1013
2,2023-07-14,검단오류(검단산업단지),5550,2748,2802
2,2023-07-14,왕길,5067,2529,2538
2,2023-07-14,검단사거리,16297,8575,7722
2,2023-07-14,마전,8432,4136,4296
2,2023-07-14,완정,14682,7607,7075
2,2023-07-14,독정,7940,3959,3981
2,2023-07-14,검암,5810,3118,2692
2,2023-07-14,검바위,7326,3581,3745
2,2023-07-14,아시아드경기장(공촌사거리),8815,4734,4081
2,2023-07-14,서구청,16230,7946,8284
2,2023-07-14,가정(루원시티),22000,11307,10693
2,2023-07-14,가정중앙시장,10854,5177,5677
2,2023-07-14,석남(거북시장),5898,2860,3038
2,2023-07-14,서부여성회관,7908,4060,3848
2,2023-07-14,인천가좌,8076,4068,4008
2,2023-07-14,가재울,6881,3482,3399
2,2023-07-14,주안국가산단,5272,2560,2712
2,2023-07-14,주안,15150,6464,8686
2,2023-07-14,시민공원(문화창작지대),17872,9213,8659
2,2023-07-14,석바위시장,8271,3992,4279
2,2023-07-14,인천시청,6184,3002,3182
2,2023-07-14,석천사거리,8755,4545,4210
2,2023-07-14,모래내시장,14009,6756,7253
2,2023-07-14,만수,9745,5086,4659
2,2023-07-14,남동구청,8198,4272,3926
2,2023-07-14,인천대공원,3108,1588,1520
2,2023-07-14,운연(서창),2301,1238,1063
2,2023-07-15,검단오류(검단산업단지),1948,1037,911
2,2023-07-15,왕길,2771,1406,1365
2,2023-07-15,검단사거리,12766,6571,6195
2,2023-07-15,마전,5514,2767,2747
2,2023-07-15,완정,9420,4916,4504
2,2023-07-15,독정,5085,2515,2570
2,2023-07-15,검암,4183,2212,1971
2,2023-07-15,검바위,3506,1688,1818
2,2023-07-15,아시아드경기장(공촌사거리),6056,3193,2863
2,2023-07-15,서구청,10223,5069,5154
2,2023-07-15,가정(루원시티),13275,6862,6413
2,2023-07-15,가정중앙시장,8923,4370,4553
2,2023-07-15,석남(거북시장),4233,2035,2198
2,2023-07-15,서부여성회관,5512,2830,2682
2,2023-07-15,인천가좌,4502,2305,2197
2,2023-07-15,가재울,3949,2017,1932
2,2023-07-15,주안국가산단,1544,759,785
2,2023-07-15,주안,12248,4905,7343
2,2023-07-15,시민공원(문화창작지대),12348,6239,6109
2,2023-07-15,석바위시장,5761,2791,2970
2,2023-07-15,인천시청,4072,1932,2140
2,2023-07-15,석천사거리,5541,2949,2592
2,2023-07-15,모래내시장,11718,5715,6003
2,2023-07-15,만수,7151,3670,3481
2,2023-07-15,남동구청,5422,2831,2591
2,2023-07-15,인천대공원,4156,2087,2069
2,2023-07-15,운연(서창),1576,823,753
2,2023-07-16,검단오류(검단산업단지),1470,743,727
2,2023-07-16,왕길,2017,1015,1002
2,2023-07-16,검단사거리,9633,4834,4799
2,2023-07-16,마전,3958,1925,2033
2,2023-07-16,완정,6957,3501,3456
2,2023-07-16,독정,3885,1878,2007
2,2023-07-16,검암,3310,1746,1564
2,2023-07-16,검바위,2981,1439,1542
2,2023-07-16,아시아드경기장(공촌사거리),4709,2513,2196
2,2023-07-16,서구청,7528,3767,3761
2,2023-07-16,가정(루원시티),9602,4921,4681
2,2023-07-16,가정중앙시장,6517,3199,3318
2,2023-07-16,석남(거북시장),3210,1481,1729
2,2023-07-16,서부여성회관,4817,2467,2350
2,2023-07-16,인천가좌,3197,1614,1583
2,2023-07-16,가재울,2779,1393,1386
2,2023-07-16,주안국가산단,764,354,410
2,2023-07-16,주안,9230,3859,5371
2,2023-07-16,시민공원(문화창작지대),9981,5086,4895
2,2023-07-16,석바위시장,4468,2174,2294
2,2023-07-16,인천시청,3234,1561,1673
2,2023-07-16,석천사거리,4209,2239,1970
2,2023-07-16,모래내시장,9088,4443,4645
2,2023-07-16,만수,5428,2751,2677
2,2023-07-16,남동구청,3980,2083,1897
2,2023-07-16,인천대공원,4157,2091,2066
2,2023-07-16,운연(서창),1276,666,610
2,2023-07-17,검단오류(검단산업단지),5722,2796,2926
2,2023-07-17,왕길,5237,2594,2643
2,2023-07-17,검단사거리,16467,8578,7889
2,2023-07-17,마전,8661,4251,4410
2,2023-07-17,완정,14943,7796,7147
2,2023-07-17,독정,8365,4189,4176
2,2023-07-17,검암,6193,3353,2840
2,2023-07-17,검바위,7283,3427,3856
2,2023-07-17,아시아드경기장(공촌사거리),9393,5001,4392
2,2023-07-17,서구청,16803,8349,8454
2,2023-07-17,가정(루원시티),22399,11480,10919
2,2023-07-17,가정중앙시장,11204,5355,5849
2,2023-07-17,석남(거북시장),6081,2972,3109
2,2023-07-17,서부여성회관,7854,4016,3838
2,2023-07-17,인천가좌,8404,4253,4151
2,2023-07-17,가재울,7206,3712,3494
2,2023-07-17,주안국가산단,5564,2705,2859
2,2023-07-17,주안,15236,6580,8656
2,2023-07-17,시민공원(문화창작지대),18505,9547,8958
2,2023-07-17,석바위시장,8880,4338,4542
2,2023-07-17,인천시청,6450,3094,3356
2,2023-07-17,석천사거리,9092,4671,4421
2,2023-07-17,모래내시장,15361,7520,7841
2,2023-07-17,만수,10242,5302,4940
2,2023-07-17,남동구청,9054,4734,4320
2,2023-07-17,인천대공원,4649,2351,2298
2,2023-07-17,운연(서창),2639,1391,1248
2,2023-07-18,검단오류(검단산업단지),5897,2913,2984
2,2023-07-18,왕길,5354,2700,2654
2,2023-07-18,검단사거리,16495,8623,7872
2,2023-07-18,마전,8776,4303,4473
2,2023-07-18,완정,14835,7646,7189
2,2023-07-18,독정,8589,4231,4358
2,2023-07-18,검암,6279,3356,2923
2,2023-07-18,검바위,7444,3649,3795
2,2023-07-18,아시아드경기장(공촌사거리),9496,5105,4391
2,2023-07-18,서구청,16613,8218,8395
2,2023-07-18,가정(루원시티),22848,11648,11200
2,2023-07-18,가정중앙시장,11412,5516,5896
2,2023-07-18,석남(거북시장),6098,2947,3151
2,2023-07-18,서부여성회관,7812,3994,3818
2,2023-07-18,인천가좌,8432,4248,4184
2,2023-07-18,가재울,7134,3604,3530
2,2023-07-18,주안국가산단,5557,2698,2859
2,2023-07-18,주안,15096,6531,8565
2,2023-07-18,시민공원(문화창작지대),18464,9497,8967
2,2023-07-18,석바위시장,8708,4242,4466
2,2023-07-18,인천시청,6512,3147,3365
2,2023-07-18,석천사거리,9222,4808,4414
2,2023-07-18,모래내시장,14807,7210,7597
2,2023-07-18,만수,10047,5230,4817
2,2023-07-18,남동구청,8810,4546,4264
2,2023-07-18,인천대공원,4092,2052,2040
2,2023-07-18,운연(서창),2548,1361,1187
2,2023-07-19,검단오류(검단산업단지),5979,2952,3027
2,2023-07-19,왕길,5449,2711,2738
2,2023-07-19,검단사거리,17184,9090,8094
2,2023-07-19,마전,9116,4414,4702
2,2023-07-19,완정,15493,7998,7495
2,2023-07-19,독정,8690,4342,4348
2,2023-07-19,검암,6697,3599,3098
2,2023-07-19,검바위,7597,3620,3977
2,2023-07-19,아시아드경기장(공촌사거리),9932,5351,4581
2,2023-07-19,서구청,17639,8769,8870
2,2023-07-19,가정(루원시티),23597,11970,11627
2,2023-07-19,가정중앙시장,11709,5630,6079
2,2023-07-19,석남(거북시장),6449,3142,3307
2,2023-07-19,서부여성회관,8048,4143,3905
2,2023-07-19,인천가좌,8577,4325,4252
2,2023-07-19,가재울,7625,3847,3778
2,2023-07-19,주안국가산단,5738,2777,2961
2,2023-07-19,주안,15862,6776,9086
2,2023-07-19,시민공원(문화창작지대),19447,9977,9470
2,2023-07-19,석바위시장,9260,4485,4775
2,2023-07-19,인천시청,6925,3277,3648
2,2023-07-19,석천사거리,9415,4883,4532
2,2023-07-19,모래내시장,15705,7580,8125
2,2023-07-19,만수,10357,5383,4974
2,2023-07-19,남동구청,9451,4920,4531
2,2023-07-19,인천대공원,5258,2672,2586
2,2023-07-19,운연(서창),2562,1381,1181
2,2023-07-20,검단오류(검단산업단지),5845,2891,2954
2,2023-07-20,왕길,5088,2572,2516
2,2023-07-20,검단사거리,16121,8402,7719
2,2023-07-20,마전,8627,4207,4420
2,2023-07-20,완정,14996,7771,7225
2,2023-07-20,독정,8332,4286,4046
2,2023-07-20,검암,6506,3503,3003
2,2023-07-20,검바위,6333,3044,3289
2,2023-07-20,아시아드경기장(공촌사거리),9017,4872,4145
2,2023-07-20,서구청,16756,8269,8487
2,2023-07-20,가정(루원시티),23146,11896,11250
2,2023-07-20,가정중앙시장,11539,5599,5940
2,2023-07-20,석남(거북시장),6052,2945,3107
2,2023-07-20,서부여성회관,8074,4091,3983
2,2023-07-20,인천가좌,8113,4111,4002
2,2023-07-20,가재울,7320,3697,3623
2,2023-07-20,주안국가산단,5649,2719,2930
2,2023-07-20,주안,15704,6659,9045
2,2023-07-20,시민공원(문화창작지대),18957,9744,9213
2,2023-07-20,석바위시장,9005,4323,4682
2,2023-07-20,인천시청,7017,3339,3678
2,2023-07-20,석천사거리,9280,4808,4472
2,2023-07-20,모래내시장,15857,7668,8189
2,2023-07-20,만수,10157,5297,4860
2,2023-07-20,남동구청,9032,4678,4354
2,2023-07-20,인천대공원,5131,2616,2515
2,2023-07-20,운연(서창),2645,1435,1210
2,2023-07-21,검단오류(검단산업단지),5836,2881,2955
2,2023-07-21,왕길,5137,2594,2543
2,2023-07-21,검단사거리,16800,8823,7977
2,2023-07-21,마전,8726,4279,4447
2,2023-07-21,완정,14810,7765,7045
2,2023-07-21,독정,7928,3946,3982
2,2023-07-21,검암,6571,3540,3031
2,2023-07-21,검바위,5749,2801,2948
2,2023-07-21,아시아드경기장(공촌사거리),9197,4923,4274
2,2023-07-21,서구청,17110,8413,8697
2,2023-07-21,가정(루원시티),22996,11855,11141
2,2023-07-21,가정중앙시장,11932,5754,6178
2,2023-07-21,석남(거북시장),6350,3111,3239
2,2023-07-21,서부여성회관,8330,4243,4087
2,2023-07-21,인천가좌,8353,4208,4145
2,2023-07-21,가재울,7399,3763,3636
2,2023-07-21,주안국가산단,5512,2656,2856
2,2023-07-21,주안,15979,6751,9228
2,2023-07-21,시민공원(문화창작지대),18921,9700,9221
2,2023-07-21,석바위시장,9133,4453,4680
2,2023-07-21,인천시청,6871,3343,3528
2,2023-07-21,석천사거리,9390,4936,4454
2,2023-07-21,모래내시장,15628,7622,8006
2,2023-07-21,만수,10149,5234,4915
2,2023-07-21,남동구청,8884,4683,4201
2,2023-07-21,인천대공원,5016,2535,2481
2,2023-07-21,운연(서창),2645,1435,1210
2,2023-07-22,검단오류(검단산업단지),2083,1091,992
2,2023-07-22,왕길,2685,1386,1299
2,2023-07-22,검단사거리,12266,6372,5894
2,2023-07-22,마전,5483,2720,2763
2,2023-07-22,완정,9499,4934,4565
2,2023-07-22,독정,5260,2607,2653
2,2023-07-22,검암,4519,2382,2137
2,2023-07-22,검바위,3620,1736,1884
2,2023-07-22,아시아드경기장(공촌사거리),6036,3179,2857
2,2023-07-22,서구청,10181,5029,5152
2,2023-07-22,가정(루원시티),13576,6992,6584
2,2023-07-22,가정중앙시장,8875,4314,4561
2,2023-07-22,석남(거북시장),4266,2056,2210
2,2023-07-22,서부여성회관,5471,2770,2701
2,2023-07-22,인천가좌,4575,2361,2214
2,2023-07-22,가재울,3863,1946,1917
2,2023-07-22,주안국가산단,1686,802,884
2,2023-07-22,주안,11962,4777,7185
2,2023-07-22,시민공원(문화창작지대),13200,6786,6414
2,2023-07-22,석바위시장,6204,3054,3150
2,2023-07-22,인천시청,3978,1885,2093
2,2023-07-22,석천사거리,5962,3101,2861
2,2023-07-22,모래내시장,11309,5492,5817
2,2023-07-22,만수,7432,3813,3619
2,2023-07-22,남동구청,5240,2686,2554
2,2023-07-22,인천대공원,4986,2519,2467
2,2023-07-22,운연(서창),1549,836,713
2,2023-07-23,검단오류(검단산업단지),1192,583,609
2,2023-07-23,왕길,1663,830,833
2,2023-07-23,검단사거리,8022,3952,4070
2,2023-07-23,마전,3436,1680,1756
2,2023-07-23,완정,5754,2899,2855
2,2023-07-23,독정,2863,1394,1469
2,2023-07-23,검암,2843,1538,1305
2,2023-07-23,검바위,2429,1109,1320
2,2023-07-23,아시아드경기장(공촌사거리),3960,2137,1823
2,2023-07-23,서구청,6227,3119,3108
2,2023-07-23,가정(루원시티),8549,4259,4290
2,2023-07-23,가정중앙시장,5417,2616,2801
2,2023-07-23,석남(거북시장),2795,1323,1472
2,2023-07-23,서부여성회관,3814,1944,1870
2,2023-07-23,인천가좌,2645,1323,1322
2,2023-07-23,가재울,2458,1242,1216
2,2023-07-23,주안국가산단,600,299,301
2,2023-07-23,주안,7567,3108,4459
2,2023-07-23,시민공원(문화창작지대),8534,4329,4205
2,2023-07-23,석바위시장,4023,1932,2091
2,2023-07-23,인천시청,2704,1284,1420
2,2023-07-23,석천사거리,3510,1814,1696
2,2023-07-23,모래내시장,7042,3449,3593
2,2023-07-23,만수,4609,2335,2274
2,2023-07-23,남동구청,3289,1707,1582
2,2023-07-23,인천대공원,2301,1153,1148
2,2023-07-23,운연(서창),935,488,447
2,2023-07-24,검단오류(검단산업단지),5728,2801,2927
2,2023-07-24,왕길,4940,2486,2454
2,2023-07-24,검단사거리,15664,8126,7538
2,2023-07-24,마전,8297,4063,4234
2,2023-07-24,완정,14163,7295,6868
2,2023-07-24,독정,7820,3940,3880
2,2023-07-24,검암,6216,3306,2910
2,2023-07-24,검바위,5584,2685,2899
2,2023-07-24,아시아드경기장(공촌사거리),8730,4638,4092
2,2023-07-24,서구청,16003,7970,8033
2,2023-07-24,가정(루원시티),21554,11045,10509
2,2023-07-24,가정중앙시장,10873,5222,5651
2,2023-07-24,석남(거북시장),5776,2793,2983
2,2023-07-24,서부여성회관,7638,3899,3739
2,2023-07-24,인천가좌,8062,4058,4004
2,2023-07-24,가재울,6957,3523,3434
2,2023-07-24,주안국가산단,5448,2661,2787
2,2023-07-24,주안,14593,6263,8330
2,2023-07-24,시민공원(문화창작지대),17828,9185,8643
2,2023-07-24,석바위시장,8315,4057,4258
2,2023-07-24,인천시청,6119,2972,3147
2,2023-07-24,석천사거리,8825,4588,4237
2,2023-07-24,모래내시장,14849,7222,7627
2,2023-07-24,만수,9428,4849,4579
2,2023-07-24,남동구청,8654,4532,4122
2,2023-07-24,인천대공원,4965,2505,2460
2,2023-07-24,운연(서창),2453,1322,1131
2,2023-07-25,검단오류(검단산업단지),5787,2843,2944
2,2023-07-25,왕길,4941,2481,2460
2,2023-07-25,검단사거리,15956,8335,7621
2,2023-07-25,마전,8389,4095,4294
2,2023-07-25,완정,14541,7459,7082
2,2023-07-25,독정,7517,3789,3728
2,2023-07-25,검암,6186,3346,2840
2,2023-07-25,검바위,5502,2636,2866
2,2023-07-25,아시아드경기장(공촌사거리),8893,4792,4101
2,2023-07-25,서구청,16450,8098,8352
2,2023-07-25,가정(루원시티),22103,11381,10722
2,2023-07-25,가정중앙시장,11706,5673,6033
2,2023-07-25,석남(거북시장),5880,2821,3059
2,2023-07-25,서부여성회관,7688,3929,3759
2,2023-07-25,인천가좌,7993,4025,3968
2,2023-07-25,가재울,7029,3533,3496
2,2023-07-25,주안국가산단,5509,2670,2839
2,2023-07-25,주안,15044,6381,8663
2,2023-07-25,시민공원(문화창작지대),18302,9502,8800
2,2023-07-25,석바위시장,8712,4160,4552
2,2023-07-25,인천시청,6478,3133,3345
2,2023-07-25,석천사거리,8880,4625,4255
2,2023-07-25,모래내시장,14983,7251,7732
2,2023-07-25,만수,9684,4989,4695
2,2023-07-25,남동구청,8487,4400,4087
2,2023-07-25,인천대공원,4931,2481,2450
2,2023-07-25,운연(서창),2500,1333,1167
2,2023-07-26,검단오류(검단산업단지),5761,2861,2900
2,2023-07-26,왕길,5140,2583,2557
2,2023-07-26,검단사거리,15656,8183,7473
2,2023-07-26,마전,8326,4067,4259
2,2023-07-26,완정,14299,7424,6875
2,2023-07-26,독정,7707,3870,3837
2,2023-07-26,검암,6402,3433,2969
2,2023-07-26,검바위,5493,2663,2830
2,2023-07-26,아시아드경기장(공촌사거리),8819,4733,4086
2,2023-07-26,서구청,16349,8072,8277
2,2023-07-26,가정(루원시티),21939,11253,10686
2,2023-07-26,가정중앙시장,11022,5368,5654
2,2023-07-26,석남(거북시장),5822,2845,2977
2,2023-07-26,서부여성회관,7686,3938,3748
2,2023-07-26,인천가좌,8000,4036,3964
2,2023-07-26,가재울,7145,3629,3516
2,2023-07-26,주안국가산단,5645,2746,2899
2,2023-07-26,주안,15095,6371,8724
2,2023-07-26,시민공원(문화창작지대),18614,9608,9006
2,2023-07-26,석바위시장,8633,4189,4444
2,2023-07-26,인천시청,6438,3084,3354
2,2023-07-26,석천사거리,8826,4611,4215
2,2023-07-26,모래내시장,14916,7257,7659
2,2023-07-26,만수,9853,5061,4792
2,2023-07-26,남동구청,8537,4438,4099
2,2023-07-26,인천대공원,4653,2390,2263
2,2023-07-26,운연(서창),2489,1337,1152
2,2023-07-27,검단오류(검단산업단지),5542,2720,2822
2,2023-07-27,왕길,4918,2476,2442
2,2023-07-27,검단사거리,15645,8223,7422
2,2023-07-27,마전,8301,4068,4233
2,2023-07-27,완정,14225,7389,6836
2,2023-07-27,독정,7430,3744,3686
2,2023-07-27,검암,6448,3456,2992
2,2023-07-27,검바위,5363,2604,2759
2,2023-07-27,아시아드경기장(공촌사거리),8693,4700,3993
2,2023-07-27,서구청,16125,7949,8176
2,2023-07-27,가정(루원시티),21738,11285,10453
2,2023-07-27,가정중앙시장,11072,5302,5770
2,2023-07-27,석남(거북시장),5842,2829,3013
2,2023-07-27,서부여성회관,7756,3949,3807
2,2023-07-27,인천가좌,8017,4052,3965
2,2023-07-27,가재울,6867,3471,3396
2,2023-07-27,주안국가산단,5351,2580,2771
2,2023-07-27,주안,14724,6292,8432
2,2023-07-27,시민공원(문화창작지대),18337,9433,8904
2,2023-07-27,석바위시장,8564,4152,4412
2,2023-07-27,인천시청,6309,3019,3290
2,2023-07-27,석천사거리,8654,4512,4142
2,2023-07-27,모래내시장,14703,7166,7537
2,2023-07-27,만수,9640,4990,4650
2,2023-07-27,남동구청,8171,4259,3912
2,2023-07-27,인천대공원,4803,2430,2373
2,2023-07-27,운연(서창),2359,1271,1088
2,2023-07-28,검단오류(검단산업단지),5477,2686,2791
2,2023-07-28,왕길,4825,2406,2419
2,2023-07-28,검단사거리,16493,8598,7895
2,2023-07-28,마전,8162,4108,4054
2,2023-07-28,완정,14101,7375,6726
2,2023-07-28,독정,7605,3880,3725
2,2023-07-28,검암,6377,3446,2931
2,2023-07-28,검바위,5346,2598,2748
2,2023-07-28,아시아드경기장(공촌사거리),8396,4523,3873
2,2023-07-28,서구청,16110,7890,8220
2,2023-07-28,가정(루원시티),21629,11226,10403
2,2023-07-28,가정중앙시장,11310,5485,5825
2,2023-07-28,석남(거북시장),5804,2765,3039
2,2023-07-28,서부여성회관,7817,4012,3805
2,2023-07-28,인천가좌,7794,3954,3840
2,2023-07-28,가재울,6763,3410,3353
2,2023-07-28,주안국가산단,5139,2516,2623
2,2023-07-28,주안,14890,6207,8683
2,2023-07-28,시민공원(문화창작지대),18179,9324,8855
2,2023-07-28,석바위시장,8439,4093,4346
2,2023-07-28,인천시청,5937,2825,3112
2,2023-07-28,석천사거리,8387,4403,3984
2,2023-07-28,모래내시장,14555,7090,7465
2,2023-07-28,만수,9599,4914,4685
2,2023-07-28,남동구청,8257,4361,3896
2,2023-07-28,인천대공원,4429,2288,2141
2,2023-07-28,운연(서창),2387,1288,1099
2,2023-07-29,검단오류(검단산업단지),2124,1158,966
2,2023-07-29,왕길,2719,1387,1332
2,2023-07-29,검단사거리,12387,6479,5908
2,2023-07-29,마전,5093,2496,2597
2,2023-07-29,완정,9308,4924,4384
2,2023-07-29,독정,5259,2594,2665
2,2023-07-29,검암,4461,2331,2130
2,2023-07-29,검바위,3457,1699,1758
2,2023-07-29,아시아드경기장(공촌사거리),5928,3145,2783
2,2023-07-29,서구청,9744,4763,4981
2,2023-07-29,가정(루원시티),12945,6724,6221
2,2023-07-29,가정중앙시장,8628,4232,4396
2,2023-07-29,석남(거북시장),4120,1991,2129
2,2023-07-29,서부여성회관,5458,2833,2625
2,2023-07-29,인천가좌,4502,2310,2192
2,2023-07-29,가재울,3411,1710,1701
2,2023-07-29,주안국가산단,1106,550,556
2,2023-07-29,주안,11514,4714,6800
2,2023-07-29,시민공원(문화창작지대),12126,6215,5911
2,2023-07-29,석바위시장,5830,2815,3015
2,2023-07-29,인천시청,3882,1888,1994
2,2023-07-29,석천사거리,5540,2929,2611
2,2023-07-29,모래내시장,11098,5475,5623
2,2023-07-29,만수,6764,3508,3256
2,2023-07-29,남동구청,5292,2785,2507
2,2023-07-29,인천대공원,4633,2349,2284
2,2023-07-29,운연(서창),1519,800,719
2,2023-07-30,검단오류(검단산업단지),1551,773,778
2,2023-07-30,왕길,1822,916,906
2,2023-07-30,검단사거리,9125,4615,4510
2,2023-07-30,마전,3775,1881,1894
2,2023-07-30,완정,6355,3201,3154
2,2023-07-30,독정,3811,1885,1926
2,2023-07-30,검암,3355,1770,1585
2,2023-07-30,검바위,2550,1208,1342
2,2023-07-30,아시아드경기장(공촌사거리),4578,2448,2130
2,2023-07-30,서구청,6824,3399,3425
2,2023-07-30,가정(루원시티),9385,4720,4665
2,2023-07-30,가정중앙시장,6077,2969,3108
2,2023-07-30,석남(거북시장),3090,1456,1634
2,2023-07-30,서부여성회관,4554,2312,2242
2,2023-07-30,인천가좌,3082,1595,1487
2,2023-07-30,가재울,2696,1321,1375
2,2023-07-30,주안국가산단,624,286,338
2,2023-07-30,주안,8571,3482,5089
2,2023-07-30,시민공원(문화창작지대),9804,4988,4816
2,2023-07-30,석바위시장,4453,2179,2274
2,2023-07-30,인천시청,3070,1456,1614
2,2023-07-30,석천사거리,3992,2093,1899
2,2023-07-30,모래내시장,8608,4241,4367
2,2023-07-30,만수,5296,2683,2613
2,2023-07-30,남동구청,3754,1947,1807
2,2023-07-30,인천대공원,4063,2031,2032
2,2023-07-30,운연(서창),1115,588,527
2,2023-07-31,검단오류(검단산업단지),4163,2028,2135
2,2023-07-31,왕길,4069,2037,2032
2,2023-07-31,검단사거리,14626,7516,7110
2,2023-07-31,마전,7110,3444,3666
2,2023-07-31,완정,12605,6565,6040
2,2023-07-31,독정,7078,3546,3532
2,2023-07-31,검암,5597,3010,2587
2,2023-07-31,검바위,4639,2284,2355
2,2023-07-31,아시아드경기장(공촌사거리),7646,4096,3550
2,2023-07-31,서구청,14108,7012,7096
2,2023-07-31,가정(루원시티),18576,9526,9050
2,2023-07-31,가정중앙시장,10195,4903,5292
2,2023-07-31,석남(거북시장),5129,2463,2666
2,2023-07-31,서부여성회관,6737,3458,3279
2,2023-07-31,인천가좌,6603,3325,3278
2,2023-07-31,가재울,5364,2744,2620
2,2023-07-31,주안국가산단,3103,1530,1573
2,2023-07-31,주안,13208,5675,7533
2,2023-07-31,시민공원(문화창작지대),16453,8478,7975
2,2023-07-31,석바위시장,7823,3772,4051
2,2023-07-31,인천시청,5248,2544,2704
2,2023-07-31,석천사거리,7769,4049,3720
2,2023-07-31,모래내시장,13069,6386,6683
2,2023-07-31,만수,8238,4236,4002
2,2023-07-31,남동구청,7440,3887,3553
2,2023-07-31,인천대공원,4193,2116,2077
2,2023-07-31,운연(서창),2023,1076,947
2,2023-08-01,검단오류(검단산업단지),4103,2025,2078
2,2023-08-01,왕길,4089,2076,2013
2,2023-08-01,검단사거리,14551,7427,7124
2,2023-08-01,마전,7350,3615,3735
2,2023-08-01,완정,12742,6553,6189
2,2023-08-01,독정,6898,3452,3446
2,2023-08-01,검암,5962,3242,2720
2,2023-08-01,검바위,4714,2284,2430
2,2023-08-01,아시아드경기장(공촌사거리),7620,4062,3558
2,2023-08-01,서구청,14297,7080,7217
2,2023-08-01,가정(루원시티),19053,9850,9203
2,2023-08-01,가정중앙시장,10134,4916,5218
2,2023-08-01,석남(거북시장),5249,2487,2762
2,2023-08-01,서부여성회관,6686,3371,3315
2,2023-08-01,인천가좌,6610,3361,3249
2,2023-08-01,가재울,5308,2709,2599
2,2023-08-01,주안국가산단,2958,1428,1530
2,2023-08-01,주안,13031,5414,7617
2,2023-08-01,시민공원(문화창작지대),16407,8391,8016
2,2023-08-01,석바위시장,7735,3797,3938
2,2023-08-01,인천시청,5578,2668,2910
2,2023-08-01,석천사거리,7882,4111,3771
2,2023-08-01,모래내시장,13015,6251,6764
2,2023-08-01,만수,8315,4325,3990
2,2023-08-01,남동구청,7314,3780,3534
2,2023-08-01,인천대공원,4267,2158,2109
2,2023-08-01,운연(서창),1991,1061,930
2,2023-08-02,검단오류(검단산업단지),3844,1888,1956
2,2023-08-02,왕길,4058,2048,2010
2,2023-08-02,검단사거리,14304,7400,6904
2,2023-08-02,마전,7210,3542,3668
2,2023-08-02,완정,12377,6418,5959
2,2023-08-02,독정,6916,3447,3469
2,2023-08-02,검암,5924,3205,2719
2,2023-08-02,검바위,4594,2238,2356
2,2023-08-02,아시아드경기장(공촌사거리),7551,4044,3507
2,2023-08-02,서구청,14022,6915,7107
2,2023-08-02,가정(루원시티),18670,9674,8996
2,2023-08-02,가정중앙시장,9944,4808,5136
2,2023-08-02,석남(거북시장),5196,2462,2734
2,2023-08-02,서부여성회관,7125,3603,3522
2,2023-08-02,인천가좌,6217,3141,3076
2,2023-08-02,가재울,5352,2691,2661
2,2023-08-02,주안국가산단,2969,1449,1520
2,2023-08-02,주안,13334,5581,7753
2,2023-08-02,시민공원(문화창작지대),16488,8480,8008
2,2023-08-02,석바위시장,7675,3715,3960
2,2023-08-02,인천시청,5694,2746,2948
2,2023-08-02,석천사거리,7695,4006,3689
2,2023-08-02,모래내시장,12897,6269,6628
2,2023-08-02,만수,8612,4450,4162
2,2023-08-02,남동구청,7335,3818,3517
2,2023-08-02,인천대공원,4209,2130,2079
2,2023-08-02,운연(서창),2057,1094,963
2,2023-08-03,검단오류(검단산업단지),4523,2255,2268
2,2023-08-03,왕길,4265,2162,2103
2,2023-08-03,검단사거리,14235,7399,6836
2,2023-08-03,마전,7342,3605,3737
2,2023-08-03,완정,12625,6507,6118
2,2023-08-03,독정,7072,3567,3505
2,2023-08-03,검암,6263,3311,2952
2,2023-08-03,검바위,4522,2179,2343
2,2023-08-03,아시아드경기장(공촌사거리),7780,4151,3629
2,2023-08-03,서구청,14063,6936,7127
2,2023-08-03,가정(루원시티),19379,9988,9391
2,2023-08-03,가정중앙시장,10133,4963,5170
2,2023-08-03,석남(거북시장),5159,2469,2690
2,2023-08-03,서부여성회관,7211,3685,3526
2,2023-08-03,인천가좌,6657,3330,3327
2,2023-08-03,가재울,5687,2898,2789
2,2023-08-03,주안국가산단,3830,1853,1977
2,2023-08-03,주안,13239,5562,7677
2,2023-08-03,시민공원(문화창작지대),16386,8461,7925
2,2023-08-03,석바위시장,7717,3742,3975
2,2023-08-03,인천시청,5575,2635,2940
2,2023-08-03,석천사거리,7758,4040,3718
2,2023-08-03,모래내시장,12823,6252,6571
2,2023-08-03,만수,8400,4352,4048
2,2023-08-03,남동구청,7303,3809,3494
2,2023-08-03,인천대공원,4294,2174,2120
2,2023-08-03,운연(서창),2103,1136,967
2,2023-08-04,검단오류(검단산업단지),4454,2212,2242
2,2023-08-04,왕길,4252,2173,2079
2,2023-08-04,검단사거리,14811,7645,7166
2,2023-08-04,마전,7316,3666,3650
2,2023-08-04,완정,12847,6675,6172
2,2023-08-04,독정,6866,3471,3395
2,2023-08-04,검암,6182,3334,2848
2,2023-08-04,검바위,4626,2254,2372
2,2023-08-04,아시아드경기장(공촌사거리),7501,4073,3428
2,2023-08-04,서구청,14692,7256,7436
2,2023-08-04,가정(루원시티),19538,10054,9484
2,2023-08-04,가정중앙시장,10510,5087,5423
2,2023-08-04,석남(거북시장),5443,2643,2800
2,2023-08-04,서부여성회관,7570,3834,3736
2,2023-08-04,인천가좌,6583,3324,3259
2,2023-08-04,가재울,6077,3127,2950
2,2023-08-04,주안국가산단,3876,1902,1974
2,2023-08-04,주안,14121,5939,8182
2,2023-08-04,시민공원(문화창작지대),16816,8575,8241
2,2023-08-04,석바위시장,7715,3713,4002
2,2023-08-04,인천시청,5537,2670,2867
2,2023-08-04,석천사거리,7652,4003,3649
2,2023-08-04,모래내시장,13602,6613,6989
2,2023-08-04,만수,8817,4527,4290
2,2023-08-04,남동구청,7469,3940,3529
2,2023-08-04,인천대공원,4240,2151,2089
2,2023-08-04,운연(서창),2192,1182,1010
2,2023-08-05,검단오류(검단산업단지),2019,1060,959
2,2023-08-05,왕길,2615,1376,1239
2,2023-08-05,검단사거리,11368,5727,5641
2,2023-08-05,마전,5017,2481,2536
2,2023-08-05,완정,8831,4625,4206
2,2023-08-05,독정,4966,2429,2537
2,2023-08-05,검암,4484,2344,2140
2,2023-08-05,검바위,3287,1602,1685
2,2023-08-05,아시아드경기장(공촌사거리),5342,2881,2461
2,2023-08-05,서구청,9250,4541,4709
2,2023-08-05,가정(루원시티),12339,6294,6045
2,2023-08-05,가정중앙시장,8080,3909,4171
2,2023-08-05,석남(거북시장),3977,1903,2074
2,2023-08-05,서부여성회관,5308,2693,2615
2,2023-08-05,인천가좌,4197,2105,2092
2,2023-08-05,가재울,3445,1759,1686
2,2023-08-05,주안국가산단,1222,583,639
2,2023-08-05,주안,11048,4405,6643
2,2023-08-05,시민공원(문화창작지대),11898,6108,5790
2,2023-08-05,석바위시장,5607,2739,2868
2,2023-08-05,인천시청,3561,1664,1897
2,2023-08-05,석천사거리,5115,2719,2396
2,2023-08-05,모래내시장,10711,5259,5452
2,2023-08-05,만수,6437,3311,3126
2,2023-08-05,남동구청,4807,2440,2367
2,2023-08-05,인천대공원,4427,2230,2197
2,2023-08-05,운연(서창),1425,746,679
2,2023-08-06,검단오류(검단산업단지),1567,741,826
2,2023-08-06,왕길,1878,960,918
2,2023-08-06,검단사거리,8994,4494,4500
2,2023-08-06,마전,3675,1804,1871
2,2023-08-06,완정,6323,3234,3089
2,2023-08-06,독정,3811,1832,1979
2,2023-08-06,검암,3391,1774,1617
2,2023-08-06,검바위,2654,1225,1429
2,2023-08-06,아시아드경기장(공촌사거리),4577,2409,2168
2,2023-08-06,서구청,6770,3381,3389
2,2023-08-06,가정(루원시티),8949,4484,4465
2,2023-08-06,가정중앙시장,6270,3101,3169
2,2023-08-06,석남(거북시장),3037,1416,1621
2,2023-08-06,서부여성회관,4395,2264,2131
2,2023-08-06,인천가좌,2911,1437,1474
2,2023-08-06,가재울,2586,1285,1301
2,2023-08-06,주안국가산단,676,343,333
2,2023-08-06,주안,8377,3482,4895
2,2023-08-06,시민공원(문화창작지대),9882,5102,4780
2,2023-08-06,석바위시장,4408,2144,2264
2,2023-08-06,인천시청,3123,1469,1654
2,2023-08-06,석천사거리,3976,2070,1906
2,2023-08-06,모래내시장,8304,4083,4221
2,2023-08-06,만수,5114,2603,2511
2,2023-08-06,남동구청,3587,1846,1741
2,2023-08-06,인천대공원,3916,1978,1938
2,2023-08-06,운연(서창),1101,570,531
2,2023-08-07,검단오류(검단산업단지),5496,2687,2809
2,2023-08-07,왕길,4351,2224,2127
2,2023-08-07,검단사거리,14835,7663,7172
2,2023-08-07,마전,7549,3647,3902
2,2023-08-07,완정,13042,6707,6335
2,2023-08-07,독정,7081,3542,3539
2,2023-08-07,검암,6133,3282,2851
2,2023-08-07,검바위,4736,2297,2439
2,2023-08-07,아시아드경기장(공촌사거리),7922,4261,3661
2,2023-08-07,서구청,14760,7293,7467
2,2023-08-07,가정(루원시티),20151,10398,9753
2,2023-08-07,가정중앙시장,10163,4897,5266
2,2023-08-07,석남(거북시장),5545,2718,2827
2,2023-08-07,서부여성회관,7192,3659,3533
2,2023-08-07,인천가좌,7399,3673,3726
2,2023-08-07,가재울,6426,3220,3206
2,2023-08-07,주안국가산단,5186,2534,2652
2,2023-08-07,주안,13216,5626,7590
2,2023-08-07,시민공원(문화창작지대),17493,8948,8545
2,2023-08-07,석바위시장,8295,4033,4262
2,2023-08-07,인천시청,5442,2652,2790
2,2023-08-07,석천사거리,8300,4235,4065
2,2023-08-07,모래내시장,13733,6670,7063
2,2023-08-07,만수,8761,4520,4241
2,2023-08-07,남동구청,7971,4132,3839
2,2023-08-07,인천대공원,4012,2023,1989
2,2023-08-07,운연(서창),2169,1187,982
2,2023-08-08,검단오류(검단산업단지),5692,2788,2904
2,2023-08-08,왕길,4534,2310,2224
2,2023-08-08,검단사거리,15027,7792,7235
2,2023-08-08,마전,7772,3766,4006
2,2023-08-08,완정,13566,7003,6563
2,2023-08-08,독정,7193,3576,3617
2,2023-08-08,검암,6419,3429,2990
2,2023-08-08,검바위,4938,2376,2562
2,2023-08-08,아시아드경기장(공촌사거리),8257,4465,3792
2,2023-08-08,서구청,15467,7607,7860
2,2023-08-08,가정(루원시티),21168,10942,10226
2,2023-08-08,가정중앙시장,10924,5328,5596
2,2023-08-08,석남(거북시장),5693,2745,2948
2,2023-08-08,서부여성회관,7355,3750,3605
2,2023-08-08,인천가좌,7703,3896,3807
2,2023-08-08,가재울,6859,3459,3400
2,2023-08-08,주안국가산단,5383,2635,2748
2,2023-08-08,주안,13974,5954,8020
2,2023-08-08,시민공원(문화창작지대),17725,9071,8654
2,2023-08-08,석바위시장,8378,4120,4258
2,2023-08-08,인천시청,5959,2855,3104
2,2023-08-08,석천사거리,8671,4484,4187
2,2023-08-08,모래내시장,14135,6822,7313
2,2023-08-08,만수,9151,4744,4407
2,2023-08-08,남동구청,8216,4262,3954
2,2023-08-08,인천대공원,4280,2168,2112
2,2023-08-08,운연(서창),2290,1204,1086
2,2023-08-09,검단오류(검단산업단지),5681,2807,2874
2,2023-08-09,왕길,4613,2304,2309
2,2023-08-09,검단사거리,15632,8151,7481
2,2023-08-09,마전,7928,3871,4057
2,2023-08-09,완정,13868,7162,6706
2,2023-08-09,독정,7338,3676,3662
2,2023-08-09,검암,6415,3497,2918
2,2023-08-09,검바위,5019,2402,2617
2,2023-08-09,아시아드경기장(공촌사거리),8893,4768,4125
2,2023-08-09,서구청,15638,7659,7979
2,2023-08-09,가정(루원시티),21067,10769,10298
2,2023-08-09,가정중앙시장,11039,5348,5691
2,2023-08-09,석남(거북시장),5860,2831,3029
2,2023-08-09,서부여성회관,7898,4044,3854
2,2023-08-09,인천가좌,7813,3903,3910
2,2023-08-09,가재울,6885,3511,3374
2,2023-08-09,주안국가산단,5429,2670,2759
2,2023-08-09,주안,14538,6232,8306
2,2023-08-09,시민공원(문화창작지대),18433,9439,8994
2,2023-08-09,석바위시장,8496,4072,4424
2,2023-08-09,인천시청,6096,2894,3202
2,2023-08-09,석천사거리,8635,4474,4161
2,2023-08-09,모래내시장,14817,7124,7693
2,2023-08-09,만수,9392,4880,4512
2,2023-08-09,남동구청,8289,4333,3956
2,2023-08-09,인천대공원,4380,2211,2169
2,2023-08-09,운연(서창),2320,1243,1077
2,2023-08-10,검단오류(검단산업단지),5128,2450,2678
2,2023-08-10,왕길,3734,1853,1881
2,2023-08-10,검단사거리,12244,6415,5829
2,2023-08-10,마전,6240,2980,3260
2,2023-08-10,완정,11225,5778,5447
2,2023-08-10,독정,5834,2939,2895
2,2023-08-10,검암,5287,2790,2497
2,2023-08-10,검바위,4018,1914,2104
2,2023-08-10,아시아드경기장(공촌사거리),7185,3916,3269
2,2023-08-10,서구청,12631,6170,6461
2,2023-08-10,가정(루원시티),17125,8741,8384
2,2023-08-10,가정중앙시장,8779,4269,4510
2,2023-08-10,석남(거북시장),4633,2262,2371
2,2023-08-10,서부여성회관,6128,3060,3068
2,2023-08-10,인천가좌,6860,3453,3407
2,2023-08-10,가재울,5864,2994,2870
2,2023-08-10,주안국가산단,5122,2490,2632
2,2023-08-10,주안,11148,4768,6380
2,2023-08-10,시민공원(문화창작지대),15036,7725,7311
2,2023-08-10,석바위시장,6813,3293,3520
2,2023-08-10,인천시청,4694,2261,2433
2,2023-08-10,석천사거리,7137,3607,3530
2,2023-08-10,모래내시장,10489,5123,5366
2,2023-08-10,만수,6919,3568,3351
2,2023-08-10,남동구청,6343,3271,3072
2,2023-08-10,인천대공원,2168,1090,1078
2,2023-08-10,운연(서창),1746,917,829
2,2023-08-11,검단오류(검단산업단지),5070,2491,2579
2,2023-08-11,왕길,4287,2198,2089
2,2023-08-11,검단사거리,14720,7652,7068
2,2023-08-11,마전,7095,3465,3630
2,2023-08-11,완정,12780,6651,6129
2,2023-08-11,독정,6834,3450,3384
2,2023-08-11,검암,6341,3569,2772
2,2023-08-11,검바위,4738,2309,2429
2,2023-08-11,아시아드경기장(공촌사거리),8140,4413,3727
2,2023-08-11,서구청,15121,7499,7622
2,2023-08-11,가정(루원시티),19726,10175,9551
2,2023-08-11,가정중앙시장,10440,4995,5445
2,2023-08-11,석남(거북시장),5279,2586,2693
2,2023-08-11,서부여성회관,7471,3784,3687
2,2023-08-11,인천가좌,7569,3860,3709
2,2023-08-11,가재울,6342,3248,3094
2,2023-08-11,주안국가산단,5195,2527,2668
2,2023-08-11,주안,13597,5734,7863
2,2023-08-11,시민공원(문화창작지대),16794,8592,8202
2,2023-08-11,석바위시장,7554,3658,3896
2,2023-08-11,인천시청,5352,2595,2757
2,2023-08-11,석천사거리,7938,4172,3766
2,2023-08-11,모래내시장,12988,6310,6678
2,2023-08-11,만수,8771,4519,4252
2,2023-08-11,남동구청,7291,3812,3479
2,2023-08-11,인천대공원,2934,1500,1434
2,2023-08-11,운연(서창),2075,1121,954
2,2023-08-12,검단오류(검단산업단지),2227,1188,1039
2,2023-08-12,왕길,2667,1387,1280
2,2023-08-12,검단사거리,12440,6394,6046
2,2023-08-12,마전,5450,2740,2710
2,2023-08-12,완정,9604,4953,4651
2,2023-08-12,독정,5399,2711,2688
2,2023-08-12,검암,5083,2671,2412
2,2023-08-12,검바위,3584,1787,1797
2,2023-08-12,아시아드경기장(공촌사거리),13586,7719,5867
2,2023-08-12,서구청,15521,5912,9609
2,2023-08-12,가정(루원시티),13441,6760,6681
2,2023-08-12,가정중앙시장,9212,4535,4677
2,2023-08-12,석남(거북시장),4482,2094,2388
2,2023-08-12,서부여성회관,5810,3017,2793
2,2023-08-12,인천가좌,4300,2172,2128
2,2023-08-12,가재울,3819,1918,1901
2,2023-08-12,주안국가산단,1517,730,787
2,2023-08-12,주안,12711,5116,7595
2,2023-08-12,시민공원(문화창작지대),13084,6783,6301
2,2023-08-12,석바위시장,5802,2806,2996
2,2023-08-12,인천시청,4316,2083,2233
2,2023-08-12,석천사거리,5848,3124,2724
2,2023-08-12,모래내시장,12030,5867,6163
2,2023-08-12,만수,7246,3737,3509
2,2023-08-12,남동구청,5358,2808,2550
2,2023-08-12,인천대공원,4604,2356,2248
2,2023-08-12,운연(서창),1694,899,795
2,2023-08-13,검단오류(검단산업단지),1676,846,830
2,2023-08-13,왕길,1830,925,905
2,2023-08-13,검단사거리,9692,4821,4871
2,2023-08-13,마전,4134,2038,2096
2,2023-08-13,완정,7297,3706,3591
2,2023-08-13,독정,3555,1778,1777
2,2023-08-13,검암,3752,1961,1791
2,2023-08-13,검바위,2767,1320,1447
2,2023-08-13,아시아드경기장(공촌사거리),4932,2600,2332
2,2023-08-13,서구청,7799,4051,3748
2,2023-08-13,가정(루원시티),10125,5164,4961
2,2023-08-13,가정중앙시장,6914,3428,3486
2,2023-08-13,석남(거북시장),3261,1530,1731
2,2023-08-13,서부여성회관,4982,2603,2379
2,2023-08-13,인천가좌,3170,1589,1581
2,2023-08-13,가재울,2912,1448,1464
2,2023-08-13,주안국가산단,643,318,325
2,2023-08-13,주안,9191,3854,5337
2,2023-08-13,시민공원(문화창작지대),10035,5146,4889
2,2023-08-13,석바위시장,4699,2313,2386
2,2023-08-13,인천시청,3340,1587,1753
2,2023-08-13,석천사거리,4537,2351,2186
2,2023-08-13,모래내시장,9848,4821,5027
2,2023-08-13,만수,6003,3097,2906
2,2023-08-13,남동구청,4150,2148,2002
2,2023-08-13,인천대공원,5486,2752,2734
2,2023-08-13,운연(서창),1235,662,573
2,2023-08-14,검단오류(검단산업단지),4372,2133,2239
2,2023-08-14,왕길,4266,2193,2073
2,2023-08-14,검단사거리,15332,7988,7344
2,2023-08-14,마전,7321,3582,3739
2,2023-08-14,완정,12828,6627,6201
2,2023-08-14,독정,7782,3939,3843
2,2023-08-14,검암,6253,3353,2900
2,2023-08-14,검바위,4727,2278,2449
2,2023-08-14,아시아드경기장(공촌사거리),8343,4407,3936
2,2023-08-14,서구청,15741,7806,7935
2,2023-08-14,가정(루원시티),19457,9984,9473
2,2023-08-14,가정중앙시장,10975,5364,5611
2,2023-08-14,석남(거북시장),5604,2707,2897
2,2023-08-14,서부여성회관,7245,3702,3543
2,2023-08-14,인천가좌,7227,3665,3562
2,2023-08-14,가재울,6389,3254,3135
2,2023-08-14,주안국가산단,4264,2071,2193
2,2023-08-14,주안,14185,5941,8244
2,2023-08-14,시민공원(문화창작지대),17080,8755,8325
2,2023-08-14,석바위시장,7872,3812,4060
2,2023-08-14,인천시청,5391,2550,2841
2,2023-08-14,석천사거리,8052,4216,3836
2,2023-08-14,모래내시장,14397,7001,7396
2,2023-08-14,만수,8789,4585,4204
2,2023-08-14,남동구청,7918,4126,3792
2,2023-08-14,인천대공원,4751,2393,2358
2,2023-08-14,운연(서창),2172,1189,983
2,2023-08-15,검단오류(검단산업단지),2082,1017,1065
2,2023-08-15,왕길,2571,1280,1291
2,2023-08-15,검단사거리,10498,5347,5151
2,2023-08-15,마전,4493,2190,2303
2,2023-08-15,완정,7537,3893,3644
2,2023-08-15,독정,4812,2416,2396
2,2023-08-15,검암,3968,2111,1857
2,2023-08-15,검바위,2897,1402,1495
2,2023-08-15,아시아드경기장(공촌사거리),5136,2728,2408
2,2023-08-15,서구청,8068,3977,4091
2,2023-08-15,가정(루원시티),10650,5465,5185
2,2023-08-15,가정중앙시장,7586,3758,3828
2,2023-08-15,석남(거북시장),3594,1724,1870
2,2023-08-15,서부여성회관,4454,2232,2222
2,2023-08-15,인천가좌,3762,1899,1863
2,2023-08-15,가재울,3315,1617,1698
2,2023-08-15,주안국가산단,1601,751,850
2,2023-08-15,주안,9963,4115,5848
2,2023-08-15,시민공원(문화창작지대),10366,5325,5041
2,2023-08-15,석바위시장,4965,2435,2530
2,2023-08-15,인천시청,3633,1704,1929
2,2023-08-15,석천사거리,4761,2490,2271
2,2023-08-15,모래내시장,10402,4994,5408
2,2023-08-15,만수,6109,3151,2958
2,2023-08-15,남동구청,4528,2423,2105
2,2023-08-15,인천대공원,5556,2780,2776
2,2023-08-15,운연(서창),1281,671,610
2,2023-08-16,검단오류(검단산업단지),5766,2836,2930
2,2023-08-16,왕길,4964,2492,2472
2,2023-08-16,검단사거리,16149,8521,7628
2,2023-08-16,마전,8303,3999,4304
2,2023-08-16,완정,14577,7461,7116
2,2023-08-16,독정,8603,4325,4278
2,2023-08-16,검암,6733,3573,3160
2,2023-08-16,검바위,6937,3385,3552
2,2023-08-16,아시아드경기장(공촌사거리),9213,4902,4311
2,2023-08-16,서구청,16475,8219,8256
2,2023-08-16,가정(루원시티),22326,11399,10927
2,2023-08-16,가정중앙시장,11417,5513,5904
2,2023-08-16,석남(거북시장),6024,2929,3095
2,2023-08-16,서부여성회관,8024,4074,3950
2,2023-08-16,인천가좌,8188,4131,4057
2,2023-08-16,가재울,7418,3788,3630
2,2023-08-16,주안국가산단,5382,2645,2737
2,2023-08-16,주안,14566,6283,8283
2,2023-08-16,시민공원(문화창작지대),18439,9471,8968
2,2023-08-16,석바위시장,8871,4271,4600
2,2023-08-16,인천시청,6348,3010,3338
2,2023-08-16,석천사거리,9018,4603,4415
2,2023-08-16,모래내시장,15199,7438,7761
2,2023-08-16,만수,9877,5138,4739
2,2023-08-16,남동구청,8732,4585,4147
2,2023-08-16,인천대공원,4515,2259,2256
2,2023-08-16,운연(서창),2421,1277,1144
2,2023-08-17,검단오류(검단산업단지),5835,2843,2992
2,2023-08-17,왕길,4861,2441,2420
2,2023-08-17,검단사거리,16203,8476,7727
2,2023-08-17,마전,8347,4050,4297
2,2023-08-17,완정,14686,7521,7165
2,2023-08-17,독정,8485,4278,4207
2,2023-08-17,검암,6775,3629,3146
2,2023-08-17,검바위,6865,3295,3570
2,2023-08-17,아시아드경기장(공촌사거리),9287,4949,4338
2,2023-08-17,서구청,16020,7930,8090
2,2023-08-17,가정(루원시티),22388,11454,10934
2,2023-08-17,가정중앙시장,11482,5535,5947
2,2023-08-17,석남(거북시장),6067,2930,3137
2,2023-08-17,서부여성회관,8066,4082,3984
2,2023-08-17,인천가좌,7990,4050,3940
2,2023-08-17,가재울,7193,3658,3535
2,2023-08-17,주안국가산단,5477,2660,2817
2,2023-08-17,주안,14938,6384,8554
2,2023-08-17,시민공원(문화창작지대),18377,9317,9060
2,2023-08-17,석바위시장,8699,4233,4466
2,2023-08-17,인천시청,6349,3049,3300
2,2023-08-17,석천사거리,8980,4610,4370
2,2023-08-17,모래내시장,14755,7208,7547
2,2023-08-17,만수,9994,5173,4821
2,2023-08-17,남동구청,8606,4472,4134
2,2023-08-17,인천대공원,4584,2317,2267
2,2023-08-17,운연(서창),2430,1304,1126
2,2023-08-18,검단오류(검단산업단지),5795,2863,2932
2,2023-08-18,왕길,5003,2536,2467
2,2023-08-18,검단사거리,17009,8917,8092
2,2023-08-18,마전,8537,4180,4357
2,2023-08-18,완정,15276,7982,7294
2,2023-08-18,독정,8674,4354,4320
2,2023-08-18,검암,7108,3839,3269
2,2023-08-18,검바위,7060,3386,3674
2,2023-08-18,아시아드경기장(공촌사거리),9286,4944,4342
2,2023-08-18,서구청,16869,8395,8474
2,2023-08-18,가정(루원시티),23336,11935,11401
2,2023-08-18,가정중앙시장,12015,5834,6181
2,2023-08-18,석남(거북시장),6263,3027,3236
2,2023-08-18,서부여성회관,8421,4320,4101
2,2023-08-18,인천가좌,8298,4212,4086
2,2023-08-18,가재울,7402,3780,3622
2,2023-08-18,주안국가산단,5495,2715,2780
2,2023-08-18,주안,15990,6795,9195
2,2023-08-18,시민공원(문화창작지대),18965,9652,9313
2,2023-08-18,석바위시장,9063,4353,4710
2,2023-08-18,인천시청,6528,3146,3382
2,2023-08-18,석천사거리,9313,4878,4435
2,2023-08-18,모래내시장,15968,7690,8278
2,2023-08-18,만수,10404,5432,4972
2,2023-08-18,남동구청,8860,4652,4208
2,2023-08-18,인천대공원,4602,2359,2243
2,2023-08-18,운연(서창),2525,1347,1178
2,2023-08-19,검단오류(검단산업단지),2268,1200,1068
2,2023-08-19,왕길,2847,1476,1371
2,2023-08-19,검단사거리,12566,6440,6126
2,2023-08-19,마전,5817,2940,2877
2,2023-08-19,완정,9711,5058,4653
2,2023-08-19,독정,5563,2759,2804
2,2023-08-19,검암,4977,2647,2330
2,2023-08-19,검바위,3596,1734,1862
2,2023-08-19,아시아드경기장(공촌사거리),6519,3390,3129
2,2023-08-19,서구청,10621,5225,5396
2,2023-08-19,가정(루원시티),13923,7204,6719
2,2023-08-19,가정중앙시장,9409,4542,4867
2,2023-08-19,석남(거북시장),4496,2170,2326
2,2023-08-19,서부여성회관,5704,2888,2816
2,2023-08-19,인천가좌,4598,2361,2237
2,2023-08-19,가재울,3929,2003,1926
2,2023-08-19,주안국가산단,1477,704,773
2,2023-08-19,주안,12266,5100,7166
2,2023-08-19,시민공원(문화창작지대),13184,6830,6354
2,2023-08-19,석바위시장,6317,3139,3178
2,2023-08-19,인천시청,4439,2078,2361
2,2023-08-19,석천사거리,6362,3403,2959
2,2023-08-19,모래내시장,12664,6149,6515
2,2023-08-19,만수,7827,4045,3782
2,2023-08-19,남동구청,5660,2962,2698
2,2023-08-19,인천대공원,5578,2809,2769
2,2023-08-19,운연(서창),1611,849,762
2,2023-08-20,검단오류(검단산업단지),1514,730,784
2,2023-08-20,왕길,1996,1028,968
2,2023-08-20,검단사거리,9586,4766,4820
2,2023-08-20,마전,4042,1961,2081
2,2023-08-20,완정,6895,3518,3377
2,2023-08-20,독정,4249,2038,2211
2,2023-08-20,검암,3641,1873,1768
2,2023-08-20,검바위,2635,1256,1379
2,2023-08-20,아시아드경기장(공촌사거리),5062,2653,2409
2,2023-08-20,서구청,7303,3686,3617
2,2023-08-20,가정(루원시티),10035,5058,4977
2,2023-08-20,가정중앙시장,6829,3327,3502
2,2023-08-20,석남(거북시장),3262,1529,1733
2,2023-08-20,서부여성회관,4826,2471,2355
2,2023-08-20,인천가좌,3159,1595,1564
2,2023-08-20,가재울,2745,1385,1360
2,2023-08-20,주안국가산단,734,355,379
2,2023-08-20,주안,9144,3786,5358
2,2023-08-20,시민공원(문화창작지대),10422,5363,5059
2,2023-08-20,석바위시장,4803,2302,2501
2,2023-08-20,인천시청,3564,1689,1875
2,2023-08-20,석천사거리,4493,2362,2131
2,2023-08-20,모래내시장,9646,4763,4883
2,2023-08-20,만수,5741,2963,2778
2,2023-08-20,남동구청,4175,2166,2009
2,2023-08-20,인천대공원,5023,2531,2492
2,2023-08-20,운연(서창),1252,631,621
2,2023-08-21,검단오류(검단산업단지),5718,2793,2925
2,2023-08-21,왕길,5229,2600,2629
2,2023-08-21,검단사거리,16089,8395,7694
2,2023-08-21,마전,8698,4229,4469
2,2023-08-21,완정,14277,7391,6886
2,2023-08-21,독정,8567,4319,4248
2,2023-08-21,검암,6651,3553,3098
2,2023-08-21,검바위,6775,3286,3489
2,2023-08-21,아시아드경기장(공촌사거리),9045,4830,4215
2,2023-08-21,서구청,16131,8025,8106
2,2023-08-21,가정(루원시티),22229,11439,10790
2,2023-08-21,가정중앙시장,11344,5498,5846
2,2023-08-21,석남(거북시장),6157,2937,3220
2,2023-08-21,서부여성회관,7778,3997,3781
2,2023-08-21,인천가좌,8258,4202,4056
2,2023-08-21,가재울,7248,3666,3582
2,2023-08-21,주안국가산단,5569,2730,2839
2,2023-08-21,주안,14985,6418,8567
2,2023-08-21,시민공원(문화창작지대),18654,9609,9045
2,2023-08-21,석바위시장,8823,4304,4519
2,2023-08-21,인천시청,6164,2949,3215
2,2023-08-21,석천사거리,9239,4746,4493
2,2023-08-21,모래내시장,14902,7185,7717
2,2023-08-21,만수,9856,5070,4786
2,2023-08-21,남동구청,8904,4678,4226
2,2023-08-21,인천대공원,4520,2295,2225
2,2023-08-21,운연(서창),2324,1272,1052
2,2023-08-22,검단오류(검단산업단지),5696,2798,2898
2,2023-08-22,왕길,5059,2507,2552
2,2023-08-22,검단사거리,15856,8317,7539
2,2023-08-22,마전,8441,4090,4351
2,2023-08-22,완정,14343,7397,6946
2,2023-08-22,독정,8364,4133,4231
2,2023-08-22,검암,6637,3579,3058
2,2023-08-22,검바위,6631,3161,3470
2,2023-08-22,아시아드경기장(공촌사거리),8833,4730,4103
2,2023-08-22,서구청,15817,7875,7942
2,2023-08-22,가정(루원시티),21785,11097,10688
2,2023-08-22,가정중앙시장,11188,5399,5789
2,2023-08-22,석남(거북시장),5946,2859,3087
2,2023-08-22,서부여성회관,7582,3877,3705
2,2023-08-22,인천가좌,8184,4132,4052
2,2023-08-22,가재울,7237,3692,3545
2,2023-08-22,주안국가산단,5504,2669,2835
2,2023-08-22,주안,14494,6185,8309
2,2023-08-22,시민공원(문화창작지대),18318,9429,8889
2,2023-08-22,석바위시장,8736,4176,4560
2,2023-08-22,인천시청,6127,2964,3163
2,2023-08-22,석천사거리,9137,4659,4478
2,2023-08-22,모래내시장,14298,7019,7279
2,2023-08-22,만수,9805,5063,4742
2,2023-08-22,남동구청,8808,4585,4223
2,2023-08-22,인천대공원,3853,1974,1879
2,2023-08-22,운연(서창),2337,1243,1094
2,2023-08-23,검단오류(검단산업단지),5539,2726,2813
2,2023-08-23,왕길,4802,2390,2412
2,2023-08-23,검단사거리,14899,7767,7132
2,2023-08-23,마전,8299,4052,4247
2,2023-08-23,완정,13771,7057,6714
2,2023-08-23,독정,8025,4044,3981
2,2023-08-23,검암,6367,3491,2876
2,2023-08-23,검바위,6449,3131,3318
2,2023-08-23,아시아드경기장(공촌사거리),8522,4552,3970
2,2023-08-23,서구청,14490,7170,7320
2,2023-08-23,가정(루원시티),21351,10826,10525
2,2023-08-23,가정중앙시장,10172,4940,5232
2,2023-08-23,석남(거북시장),5667,2710,2957
2,2023-08-23,서부여성회관,7466,3808,3658
2,2023-08-23,인천가좌,7918,3966,3952
2,2023-08-23,가재울,6839,3432,3407
2,2023-08-23,주안국가산단,5455,2685,2770
2,2023-08-23,주안,13817,5896,7921
2,2023-08-23,시민공원(문화창작지대),17214,8815,8399
2,2023-08-23,석바위시장,7939,3831,4108
2,2023-08-23,인천시청,5722,2719,3003
2,2023-08-23,석천사거리,8579,4405,4174
2,2023-08-23,모래내시장,12712,6140,6572
2,2023-08-23,만수,8977,4646,4331
2,2023-08-23,남동구청,8023,4187,3836
2,2023-08-23,인천대공원,2738,1390,1348
2,2023-08-23,운연(서창),2220,1180,1040
2,2023-08-24,검단오류(검단산업단지),5750,2840,2910
2,2023-08-24,왕길,5130,2553,2577
2,2023-08-24,검단사거리,15897,8285,7612
2,2023-08-24,마전,8427,4129,4298
2,2023-08-24,완정,14673,7610,7063
2,2023-08-24,독정,8525,4322,4203
2,2023-08-24,검암,6861,3753,3108
2,2023-08-24,검바위,6973,3362,3611
2,2023-08-24,아시아드경기장(공촌사거리),9078,4833,4245
2,2023-08-24,서구청,16367,8158,8209
2,2023-08-24,가정(루원시티),22178,11340,10838
2,2023-08-24,가정중앙시장,11741,5634,6107
2,2023-08-24,석남(거북시장),6170,2958,3212
2,2023-08-24,서부여성회관,7995,4076,3919
2,2023-08-24,인천가좌,8139,4114,4025
2,2023-08-24,가재울,7348,3720,3628
2,2023-08-24,주안국가산단,5454,2697,2757
2,2023-08-24,주안,14862,6296,8566
2,2023-08-24,시민공원(문화창작지대),18467,9493,8974
2,2023-08-24,석바위시장,8530,4116,4414
2,2023-08-24,인천시청,6427,3128,3299
2,2023-08-24,석천사거리,8936,4675,4261
2,2023-08-24,모래내시장,14968,7262,7706
2,2023-08-24,만수,9960,5188,4772
2,2023-08-24,남동구청,9012,4674,4338
2,2023-08-24,인천대공원,4040,2046,1994
2,2023-08-24,운연(서창),2420,1279,1141
2,2023-08-25,검단오류(검단산업단지),5746,2774,2972
2,2023-08-25,왕길,5345,2704,2641
2,2023-08-25,검단사거리,17186,9014,8172
2,2023-08-25,마전,9084,4447,4637
2,2023-08-25,완정,15615,8046,7569
2,2023-08-25,독정,9006,4542,4464
2,2023-08-25,검암,7325,3953,3372
2,2023-08-25,검바위,7180,3465,3715
2,2023-08-25,아시아드경기장(공촌사거리),9576,5169,4407
2,2023-08-25,서구청,17867,8791,9076
2,2023-08-25,가정(루원시티),23500,12078,11422
2,2023-08-25,가정중앙시장,12567,6103,6464
2,2023-08-25,석남(거북시장),6357,3094,3263
2,2023-08-25,서부여성회관,8882,4518,4364
2,2023-08-25,인천가좌,8530,4383,4147
2,2023-08-25,가재울,7684,3939,3745
2,2023-08-25,주안국가산단,5519,2701,2818
2,2023-08-25,주안,16035,6833,9202
2,2023-08-25,시민공원(문화창작지대),19419,9928,9491
2,2023-08-25,석바위시장,9319,4557,4762
2,2023-08-25,인천시청,6863,3300,3563
2,2023-08-25,석천사거리,9602,5033,4569
2,2023-08-25,모래내시장,16320,7906,8414
2,2023-08-25,만수,10668,5560,5108
2,2023-08-25,남동구청,9563,4966,4597
2,2023-08-25,인천대공원,5053,2573,2480
2,2023-08-25,운연(서창),2564,1377,1187
2,2023-08-26,검단오류(검단산업단지),2215,1187,1028
2,2023-08-26,왕길,3135,1648,1487
2,2023-08-26,검단사거리,13519,7000,6519
2,2023-08-26,마전,5792,2888,2904
2,2023-08-26,완정,10373,5419,4954
2,2023-08-26,독정,5938,2994,2944
2,2023-08-26,검암,5308,2801,2507
2,2023-08-26,검바위,3867,1934,1933
2,2023-08-26,아시아드경기장(공촌사거리),6760,3478,3282
2,2023-08-26,서구청,11616,5818,5798
2,2023-08-26,가정(루원시티),14855,7647,7208
2,2023-08-26,가정중앙시장,9930,4851,5079
2,2023-08-26,석남(거북시장),4840,2301,2539
2,2023-08-26,서부여성회관,5999,3072,2927
2,2023-08-26,인천가좌,4993,2570,2423
2,2023-08-26,가재울,4063,2026,2037
2,2023-08-26,주안국가산단,1608,764,844
2,2023-08-26,주안,13250,5397,7853
2,2023-08-26,시민공원(문화창작지대),13895,7183,6712
2,2023-08-26,석바위시장,6484,3135,3349
2,2023-08-26,인천시청,4573,2152,2421
2,2023-08-26,석천사거리,6249,3304,2945
2,2023-08-26,모래내시장,12925,6279,6646
2,2023-08-26,만수,7868,4089,3779
2,2023-08-26,남동구청,5826,3065,2761
2,2023-08-26,인천대공원,6109,3039,3070
2,2023-08-26,운연(서창),1704,894,810
2,2023-08-27,검단오류(검단산업단지),1474,744,730
2,2023-08-27,왕길,2046,1006,1040
2,2023-08-27,검단사거리,9902,4936,4966
2,2023-08-27,마전,4240,2061,2179
2,2023-08-27,완정,7012,3497,3515
2,2023-08-27,독정,3606,1776,1830
2,2023-08-27,검암,3803,1920,1883
2,2023-08-27,검바위,2710,1282,1428
2,2023-08-27,아시아드경기장(공촌사거리),5184,2671,2513
2,2023-08-27,서구청,7848,3955,3893
2,2023-08-27,가정(루원시티),10195,5180,5015
2,2023-08-27,가정중앙시장,7204,3561,3643
2,2023-08-27,석남(거북시장),3336,1565,1771
2,2023-08-27,서부여성회관,4832,2460,2372
2,2023-08-27,인천가좌,3336,1674,1662
2,2023-08-27,가재울,2978,1482,1496
2,2023-08-27,주안국가산단,730,376,354
2,2023-08-27,주안,9593,3918,5675
2,2023-08-27,시민공원(문화창작지대),10505,5427,5078
2,2023-08-27,석바위시장,4998,2448,2550
2,2023-08-27,인천시청,3451,1624,1827
2,2023-08-27,석천사거리,4667,2467,2200
2,2023-08-27,모래내시장,9960,4826,5134
2,2023-08-27,만수,5918,3007,2911
2,2023-08-27,남동구청,4468,2370,2098
2,2023-08-27,인천대공원,6193,3123,3070
2,2023-08-27,운연(서창),1366,726,640
2,2023-08-28,검단오류(검단산업단지),5550,2705,2845
2,2023-08-28,왕길,4960,2481,2479
2,2023-08-28,검단사거리,15817,8338,7479
2,2023-08-28,마전,8384,4039,4345
2,2023-08-28,완정,14652,7554,7098
2,2023-08-28,독정,8375,4196,4179
2,2023-08-28,검암,6654,3588,3066
2,2023-08-28,검바위,6847,3344,3503
2,2023-08-28,아시아드경기장(공촌사거리),8875,4729,4146
2,2023-08-28,서구청,15903,7959,7944
2,2023-08-28,가정(루원시티),21947,11198,10749
2,2023-08-28,가정중앙시장,11257,5485,5772
2,2023-08-28,석남(거북시장),5745,2809,2936
2,2023-08-28,서부여성회관,7470,3860,3610
2,2023-08-28,인천가좌,8016,4049,3967
2,2023-08-28,가재울,7290,3671,3619
2,2023-08-28,주안국가산단,5536,2736,2800
2,2023-08-28,주안,15223,6637,8586
2,2023-08-28,시민공원(문화창작지대),18188,9341,8847
2,2023-08-28,석바위시장,8663,4203,4460
2,2023-08-28,인천시청,6241,2975,3266
2,2023-08-28,석천사거리,8730,4528,4202
2,2023-08-28,모래내시장,14305,6912,7393
2,2023-08-28,만수,9488,4901,4587
2,2023-08-28,남동구청,8654,4532,4122
2,2023-08-28,인천대공원,3226,1621,1605
2,2023-08-28,운연(서창),2267,1212,1055
2,2023-08-29,검단오류(검단산업단지),5600,2736,2864
2,2023-08-29,왕길,4920,2426,2494
2,2023-08-29,검단사거리,15234,7974,7260
2,2023-08-29,마전,8330,4035,4295
2,2023-08-29,완정,14506,7531,6975
2,2023-08-29,독정,8203,4050,4153
2,2023-08-29,검암,6709,3633,3076
2,2023-08-29,검바위,6740,3271,3469
2,2023-08-29,아시아드경기장(공촌사거리),8729,4641,4088
2,2023-08-29,서구청,15525,7708,7817
2,2023-08-29,가정(루원시티),21659,11012,10647
2,2023-08-29,가정중앙시장,11060,5377,5683
2,2023-08-29,석남(거북시장),5716,2797,2919
2,2023-08-29,서부여성회관,7454,3820,3634
2,2023-08-29,인천가좌,7943,4018,3925
2,2023-08-29,가재울,7055,3604,3451
2,2023-08-29,주안국가산단,5516,2731,2785
2,2023-08-29,주안,15100,6429,8671
2,2023-08-29,시민공원(문화창작지대),18176,9322,8854
2,2023-08-29,석바위시장,8336,4045,4291
2,2023-08-29,인천시청,6120,2934,3186
2,2023-08-29,석천사거리,8800,4556,4244
2,2023-08-29,모래내시장,13428,6563,6865
2,2023-08-29,만수,9339,4824,4515
2,2023-08-29,남동구청,8331,4359,3972
2,2023-08-29,인천대공원,3145,1601,1544
2,2023-08-29,운연(서창),2275,1207,1068
2,2023-08-30,검단오류(검단산업단지),5874,2915,2959
2,2023-08-30,왕길,5216,2604,2612
2,2023-08-30,검단사거리,16713,8736,7977
2,2023-08-30,마전,8950,4378,4572
2,2023-08-30,완정,15540,7995,7545
2,2023-08-30,독정,8923,4516,4407
2,2023-08-30,검암,7036,3746,3290
2,2023-08-30,검바위,7264,3584,3680
2,2023-08-30,아시아드경기장(공촌사거리),9601,5116,4485
2,2023-08-30,서구청,16622,8164,8458
2,2023-08-30,가정(루원시티),23269,11973,11296
2,2023-08-30,가정중앙시장,12358,5930,6428
2,2023-08-30,석남(거북시장),6289,3089,3200
2,2023-08-30,서부여성회관,8470,4301,4169
2,2023-08-30,인천가좌,8369,4199,4170
2,2023-08-30,가재울,7472,3823,3649
2,2023-08-30,주안국가산단,5693,2759,2934
2,2023-08-30,주안,16821,7121,9700
2,2023-08-30,시민공원(문화창작지대),19716,10100,9616
2,2023-08-30,석바위시장,9152,4456,4696
2,2023-08-30,인천시청,6990,3313,3677
2,2023-08-30,석천사거리,9305,4810,4495
2,2023-08-30,모래내시장,15647,7638,8009
2,2023-08-30,만수,10366,5381,4985
2,2023-08-30,남동구청,9123,4776,4347
2,2023-08-30,인천대공원,4640,2331,2309
2,2023-08-30,운연(서창),2570,1364,1206
2,2023-08-31,검단오류(검단산업단지),5851,2867,2984
2,2023-08-31,왕길,5115,2569,2546
2,2023-08-31,검단사거리,16576,8675,7901
2,2023-08-31,마전,8877,4311,4566
2,2023-08-31,완정,15480,8013,7467
2,2023-08-31,독정,8921,4592,4329
2,2023-08-31,검암,7086,3792,3294
2,2023-08-31,검바위,7158,3502,3656
2,2023-08-31,아시아드경기장(공촌사거리),9364,4984,4380
2,2023-08-31,서구청,16675,8200,8475
2,2023-08-31,가정(루원시티),23365,12034,11331
2,2023-08-31,가정중앙시장,12098,5836,6262
2,2023-08-31,석남(거북시장),6228,3013,3215
2,2023-08-31,서부여성회관,8462,4258,4204
2,2023-08-31,인천가좌,8549,4366,4183
2,2023-08-31,가재울,7607,3881,3726
2,2023-08-31,주안국가산단,5483,2643,2840
2,2023-08-31,주안,16324,7011,9313
2,2023-08-31,시민공원(문화창작지대),19898,10177,9721
2,2023-08-31,석바위시장,9212,4450,4762
2,2023-08-31,인천시청,6742,3282,3460
2,2023-08-31,석천사거리,9411,4823,4588
2,2023-08-31,모래내시장,15996,7811,8185
2,2023-08-31,만수,10355,5341,5014
2,2023-08-31,남동구청,8923,4711,4212
2,2023-08-31,인천대공원,5544,2819,2725
2,2023-08-31,운연(서창),2604,1387,1217
2,2023-09-01,검단오류(검단산업단지),5885,2898,2987
2,2023-09-01,왕길,5195,2660,2535
2,2023-09-01,검단사거리,17590,9212,8378
2,2023-09-01,마전,9118,4436,4682
2,2023-09-01,완정,16438,8435,8003
2,2023-09-01,독정,9458,4735,4723
2,2023-09-01,검암,7474,4074,3400
2,2023-09-01,검바위,7317,3593,3724
2,2023-09-01,아시아드경기장(공촌사거리),9664,5149,4515
2,2023-09-01,서구청,17559,8665,8894
2,2023-09-01,가정(루원시티),24441,12562,11879
2,2023-09-01,가정중앙시장,13052,6352,6700
2,2023-09-01,석남(거북시장),6497,3157,3340
2,2023-09-01,서부여성회관,8914,4566,4348
2,2023-09-01,인천가좌,8618,4315,4303
2,2023-09-01,가재울,7855,3980,3875
2,2023-09-01,주안국가산단,5668,2770,2898
2,2023-09-01,주안,16752,7092,9660
2,2023-09-01,시민공원(문화창작지대),19844,10273,9571
2,2023-09-01,석바위시장,9359,4482,4877
2,2023-09-01,인천시청,6859,3302,3557
2,2023-09-01,석천사거리,9594,5049,4545
2,2023-09-01,모래내시장,16590,8056,8534
2,2023-09-01,만수,10916,5682,5234
2,2023-09-01,남동구청,9472,4917,4555
2,2023-09-01,인천대공원,5655,2861,2794
2,2023-09-01,운연(서창),2746,1462,1284
2,2023-09-02,검단오류(검단산업단지),2382,1298,1084
2,2023-09-02,왕길,3172,1622,1550
2,2023-09-02,검단사거리,14122,7289,6833
2,2023-09-02,마전,6178,3140,3038
2,2023-09-02,완정,10617,5571,5046
2,2023-09-02,독정,6095,3088,3007
2,2023-09-02,검암,5729,3026,2703
2,2023-09-02,검바위,4004,1967,2037
2,2023-09-02,아시아드경기장(공촌사거리),6874,3534,3340
2,2023-09-02,서구청,11355,5590,5765
2,2023-09-02,가정(루원시티),15304,8007,7297
2,2023-09-02,가정중앙시장,10296,5095,5201
2,2023-09-02,석남(거북시장),4697,2232,2465
2,2023-09-02,서부여성회관,6471,3315,3156
2,2023-09-02,인천가좌,4926,2475,2451
2,2023-09-02,가재울,4603,2326,2277
2,2023-09-02,주안국가산단,1529,752,777
2,2023-09-02,주안,13451,5430,8021
2,2023-09-02,시민공원(문화창작지대),13791,7072,6719
2,2023-09-02,석바위시장,6698,3281,3417
2,2023-09-02,인천시청,4795,2256,2539
2,2023-09-02,석천사거리,6691,3543,3148
2,2023-09-02,모래내시장,13376,6559,6817
2,2023-09-02,만수,7977,4075,3902
2,2023-09-02,남동구청,5930,3128,2802
2,2023-09-02,인천대공원,7162,3585,3577
2,2023-09-02,운연(서창),1881,971,910
2,2023-09-03,검단오류(검단산업단지),1643,805,838
2,2023-09-03,왕길,2073,1045,1028
2,2023-09-03,검단사거리,9587,4840,4747
2,2023-09-03,마전,4100,2031,2069
2,2023-09-03,완정,7029,3601,3428
2,2023-09-03,독정,4193,2076,2117
2,2023-09-03,검암,3886,2028,1858
2,2023-09-03,검바위,2840,1311,1529
2,2023-09-03,아시아드경기장(공촌사거리),5061,2662,2399
2,2023-09-03,서구청,7657,3857,3800
2,2023-09-03,가정(루원시티),10180,5160,5020
2,2023-09-03,가정중앙시장,7261,3556,3705
2,2023-09-03,석남(거북시장),3319,1581,1738
2,2023-09-03,서부여성회관,4828,2433,2395
2,2023-09-03,인천가좌,3283,1651,1632
2,2023-09-03,가재울,3052,1526,1526
2,2023-09-03,주안국가산단,774,390,384
2,2023-09-03,주안,9343,3888,5455
2,2023-09-03,시민공원(문화창작지대),10423,5404,5019
2,2023-09-03,석바위시장,4743,2289,2454
2,2023-09-03,인천시청,3408,1578,1830
2,2023-09-03,석천사거리,4622,2434,2188
2,2023-09-03,모래내시장,9648,4769,4879
2,2023-09-03,만수,5700,2905,2795
2,2023-09-03,남동구청,4228,2163,2065
2,2023-09-03,인천대공원,5672,2826,2846
2,2023-09-03,운연(서창),1374,719,655
2,2023-09-04,검단오류(검단산업단지),5756,2788,2968
2,2023-09-04,왕길,5295,2690,2605
2,2023-09-04,검단사거리,16481,8709,7772
2,2023-09-04,마전,8847,4295,4552
2,2023-09-04,완정,15308,7892,7416
2,2023-09-04,독정,8792,4474,4318
2,2023-09-04,검암,7268,3937,3331
2,2023-09-04,검바위,7405,3569,3836
2,2023-09-04,아시아드경기장(공촌사거리),9763,5179,4584
2,2023-09-04,서구청,16797,8408,8389
2,2023-09-04,가정(루원시티),23182,11925,11257
2,2023-09-04,가정중앙시장,12243,5998,6245
2,2023-09-04,석남(거북시장),6406,3079,3327
2,2023-09-04,서부여성회관,8060,4117,3943
2,2023-09-04,인천가좌,8549,4304,4245
2,2023-09-04,가재울,7660,3891,3769
2,2023-09-04,주안국가산단,5701,2796,2905
2,2023-09-04,주안,16027,6836,9191
2,2023-09-04,시민공원(문화창작지대),19366,9922,9444
2,2023-09-04,석바위시장,8951,4358,4593
2,2023-09-04,인천시청,6567,3147,3420
2,2023-09-04,석천사거리,9310,4835,4475
2,2023-09-04,모래내시장,15592,7528,8064
2,2023-09-04,만수,10103,5234,4869
2,2023-09-04,남동구청,9008,4698,4310
2,2023-09-04,인천대공원,5053,2565,2488
2,2023-09-04,운연(서창),2533,1369,1164
2,2023-09-05,검단오류(검단산업단지),5920,2911,3009
2,2023-09-05,왕길,5250,2618,2632
2,2023-09-05,검단사거리,16574,8756,7818
2,2023-09-05,마전,9178,4477,4701
2,2023-09-05,완정,15640,8119,7521
2,2023-09-05,독정,9036,4470,4566
2,2023-09-05,검암,7456,4024,3432
2,2023-09-05,검바위,7552,3577,3975
2,2023-09-05,아시아드경기장(공촌사거리),9707,5154,4553
2,2023-09-05,서구청,16998,8499,8499
2,2023-09-05,가정(루원시티),23618,12112,11506
2,2023-09-05,가정중앙시장,11999,5766,6233
2,2023-09-05,석남(거북시장),6227,3013,3214
2,2023-09-05,서부여성회관,8103,4184,3919
2,2023-09-05,인천가좌,8661,4371,4290
2,2023-09-05,가재울,7748,3915,3833
2,2023-09-05,주안국가산단,5778,2831,2947
2,2023-09-05,주안,16015,6869,9146
2,2023-09-05,시민공원(문화창작지대),19722,10102,9620
2,2023-09-05,석바위시장,9050,4378,4672
2,2023-09-05,인천시청,6642,3155,3487
2,2023-09-05,석천사거리,9577,4962,4615
2,2023-09-05,모래내시장,15367,7434,7933
2,2023-09-05,만수,10056,5260,4796
2,2023-09-05,남동구청,9135,4766,4369
2,2023-09-05,인천대공원,5335,2695,2640
2,2023-09-05,운연(서창),2649,1424,1225
2,2023-09-06,검단오류(검단산업단지),6026,2960,3066
2,2023-09-06,왕길,5410,2711,2699
2,2023-09-06,검단사거리,16808,8845,7963
2,2023-09-06,마전,9114,4387,4727
2,2023-09-06,완정,15827,8177,7650
2,2023-09-06,독정,9185,4628,4557
2,2023-09-06,검암,7329,3949,3380
2,2023-09-06,검바위,7509,3591,3918
2,2023-09-06,아시아드경기장(공촌사거리),10035,5345,4690
2,2023-09-06,서구청,17697,8735,8962
2,2023-09-06,가정(루원시티),24005,12251,11754
2,2023-09-06,가정중앙시장,12331,5993,6338
2,2023-09-06,석남(거북시장),6362,3096,3266
2,2023-09-06,서부여성회관,8395,4271,4124
2,2023-09-06,인천가좌,8723,4428,4295
2,2023-09-06,가재울,7841,3967,3874
2,2023-09-06,주안국가산단,5836,2847,2989
2,2023-09-06,주안,16417,7058,9359
2,2023-09-06,시민공원(문화창작지대),20086,10327,9759
2,2023-09-06,석바위시장,9165,4431,4734
2,2023-09-06,인천시청,6853,3244,3609
2,2023-09-06,석천사거리,9732,5141,4591
2,2023-09-06,모래내시장,15656,7606,8050
2,2023-09-06,만수,10350,5355,4995
2,2023-09-06,남동구청,9410,4897,4513
2,2023-09-06,인천대공원,5085,2575,2510
2,2023-09-06,운연(서창),2596,1402,1194
2,2023-09-07,검단오류(검단산업단지),5922,2895,3027
2,2023-09-07,왕길,5435,2706,2729
2,2023-09-07,검단사거리,16816,8825,7991
2,2023-09-07,마전,9109,4444,4665
2,2023-09-07,완정,15609,8057,7552
2,2023-09-07,독정,9123,4586,4537
2,2023-09-07,검암,7535,4026,3509
2,2023-09-07,검바위,7454,3579,3875
2,2023-09-07,아시아드경기장(공촌사거리),9735,5115,4620
2,2023-09-07,서구청,17640,8746,8894
2,2023-09-07,가정(루원시티),24337,12438,11899
2,2023-09-07,가정중앙시장,12434,6064,6370
2,2023-09-07,석남(거북시장),6233,3015,3218
2,2023-09-07,서부여성회관,8612,4356,4256
2,2023-09-07,인천가좌,8708,4427,4281
2,2023-09-07,가재울,7829,3985,3844
2,2023-09-07,주안국가산단,5759,2791,2968
2,2023-09-07,주안,16557,7116,9441
2,2023-09-07,시민공원(문화창작지대),19906,10215,9691
2,2023-09-07,석바위시장,8777,4257,4520
2,2023-09-07,인천시청,6929,3269,3660
2,2023-09-07,석천사거리,9588,5015,4573
2,2023-09-07,모래내시장,15861,7709,8152
2,2023-09-07,만수,10382,5393,4989
2,2023-09-07,남동구청,9321,4872,4449
2,2023-09-07,인천대공원,5575,2812,2763
2,2023-09-07,운연(서창),2688,1440,1248
2,2023-09-08,검단오류(검단산업단지),5866,2879,2987
2,2023-09-08,왕길,5473,2763,2710
2,2023-09-08,검단사거리,17568,9246,8322
2,2023-09-08,마전,9241,4501,4740
2,2023-09-08,완정,15929,8210,7719
2,2023-09-08,독정,9167,4619,4548
2,2023-09-08,검암,7596,4112,3484
2,2023-09-08,검바위,7724,3737,3987
2,2023-09-08,아시아드경기장(공촌사거리),9774,5202,4572
2,2023-09-08,서구청,18252,8941,9311
2,2023-09-08,가정(루원시티),25039,12866,12173
2,2023-09-08,가정중앙시장,12987,6246,6741
2,2023-09-08,석남(거북시장),6537,3158,3379
2,2023-09-08,서부여성회관,8732,4461,4271
2,2023-09-08,인천가좌,8746,4476,4270
2,2023-09-08,가재울,8089,4084,4005
2,2023-09-08,주안국가산단,5790,2815,2975
2,2023-09-08,주안,16819,7114,9705
2,2023-09-08,시민공원(문화창작지대),19980,10312,9668
2,2023-09-08,석바위시장,9240,4521,4719
2,2023-09-08,인천시청,6697,3230,3467
2,2023-09-08,석천사거리,9707,5076,4631
2,2023-09-08,모래내시장,16562,8018,8544
2,2023-09-08,만수,10588,5467,5121
2,2023-09-08,남동구청,9265,4840,4425
2,2023-09-08,인천대공원,5605,2830,2775
2,2023-09-08,운연(서창),2573,1420,1153
2,2023-09-09,검단오류(검단산업단지),2151,1162,989
2,2023-09-09,왕길,3184,1638,1546
2,2023-09-09,검단사거리,13774,7144,6630
2,2023-09-09,마전,6286,3126,3160
2,2023-09-09,완정,10697,5576,5121
2,2023-09-09,독정,6232,3169,3063
2,2023-09-09,검암,5835,3079,2756
2,2023-09-09,검바위,3889,1921,1968
2,2023-09-09,아시아드경기장(공촌사거리),6910,3486,3424
2,2023-09-09,서구청,11829,5930,5899
2,2023-09-09,가정(루원시티),15207,7856,7351
2,2023-09-09,가정중앙시장,10336,5100,5236
2,2023-09-09,석남(거북시장),4726,2237,2489
2,2023-09-09,서부여성회관,6474,3283,3191
2,2023-09-09,인천가좌,4958,2528,2430
2,2023-09-09,가재울,4412,2235,2177
2,2023-09-09,주안국가산단,1641,803,838
2,2023-09-09,주안,13761,5653,8108
2,2023-09-09,시민공원(문화창작지대),13769,7076,6693
2,2023-09-09,석바위시장,6646,3252,3394
2,2023-09-09,인천시청,4656,2186,2470
2,2023-09-09,석천사거리,6672,3527,3145
2,2023-09-09,모래내시장,13141,6400,6741
2,2023-09-09,만수,7964,4111,3853
2,2023-09-09,남동구청,6496,3445,3051
2,2023-09-09,인천대공원,6968,3498,3470
2,2023-09-09,운연(서창),1839,958,881
2,2023-09-10,검단오류(검단산업단지),1544,766,778
2,2023-09-10,왕길,2109,1065,1044
2,2023-09-10,검단사거리,9856,4897,4959
2,2023-09-10,마전,4198,2102,2096
2,2023-09-10,완정,7297,3637,3660
2,2023-09-10,독정,3833,1892,1941
2,2023-09-10,검암,4094,2141,1953
2,2023-09-10,검바위,3040,1428,1612
2,2023-09-10,아시아드경기장(공촌사거리),5064,2628,2436
2,2023-09-10,서구청,7752,3962,3790
2,2023-09-10,가정(루원시티),10482,5354,5128
2,2023-09-10,가정중앙시장,7369,3568,3801
2,2023-09-10,석남(거북시장),3426,1607,1819
2,2023-09-10,서부여성회관,5013,2575,2438
2,2023-09-10,인천가좌,3284,1634,1650
2,2023-09-10,가재울,3426,1749,1677
2,2023-09-10,주안국가산단,736,370,366
2,2023-09-10,주안,9745,3933,5812
2,2023-09-10,시민공원(문화창작지대),10414,5356,5058
2,2023-09-10,석바위시장,5115,2474,2641
2,2023-09-10,인천시청,3708,1763,1945
2,2023-09-10,석천사거리,4542,2371,2171
2,2023-09-10,모래내시장,10019,4884,5135
2,2023-09-10,만수,5890,3007,2883
2,2023-09-10,남동구청,4296,2251,2045
2,2023-09-10,인천대공원,6378,3231,3147
2,2023-09-10,운연(서창),1475,769,706
2,2023-09-11,검단오류(검단산업단지),5838,2832,3006
2,2023-09-11,왕길,5401,2749,2652
2,2023-09-11,검단사거리,17142,9037,8105
2,2023-09-11,마전,9115,4468,4647
2,2023-09-11,완정,15889,8272,7617
2,2023-09-11,독정,9422,4767,4655
2,2023-09-11,검암,7479,4036,3443
2,2023-09-11,검바위,7501,3582,3919
2,2023-09-11,아시아드경기장(공촌사거리),9718,5153,4565
2,2023-09-11,서구청,17357,8668,8689
2,2023-09-11,가정(루원시티),23983,12341,11642
2,2023-09-11,가정중앙시장,12412,6048,6364
2,2023-09-11,석남(거북시장),6568,3174,3394
2,2023-09-11,서부여성회관,8358,4294,4064
2,2023-09-11,인천가좌,8725,4422,4303
2,2023-09-11,가재울,7940,4095,3845
2,2023-09-11,주안국가산단,5722,2778,2944
2,2023-09-11,주안,16233,6956,9277
2,2023-09-11,시민공원(문화창작지대),19798,10123,9675
2,2023-09-11,석바위시장,9103,4416,4687
2,2023-09-11,인천시청,6500,3093,3407
2,2023-09-11,석천사거리,9474,4958,4516
2,2023-09-11,모래내시장,15865,7728,8137
2,2023-09-11,만수,9974,5143,4831
2,2023-09-11,남동구청,9143,4808,4335
2,2023-09-11,인천대공원,5276,2664,2612
2,2023-09-11,운연(서창),2523,1365,1158
2,2023-09-12,검단오류(검단산업단지),5901,2910,2991
2,2023-09-12,왕길,5367,2711,2656
2,2023-09-12,검단사거리,16930,8869,8061
2,2023-09-12,마전,9125,4483,4642
2,2023-09-12,완정,15920,8187,7733
2,2023-09-12,독정,9388,4665,4723
2,2023-09-12,검암,7550,4126,3424
2,2023-09-12,검바위,7631,3690,3941
2,2023-09-12,아시아드경기장(공촌사거리),9810,5319,4491
2,2023-09-12,서구청,17242,8514,8728
2,2023-09-12,가정(루원시티),24067,12314,11753
2,2023-09-12,가정중앙시장,12724,6170,6554
2,2023-09-12,석남(거북시장),6422,3116,3306
2,2023-09-12,서부여성회관,8264,4201,4063
2,2023-09-12,인천가좌,8812,4473,4339
2,2023-09-12,가재울,8133,4116,4017
2,2023-09-12,주안국가산단,5842,2893,2949
2,2023-09-12,주안,16442,7065,9377
2,2023-09-12,시민공원(문화창작지대),20155,10363,9792
2,2023-09-12,석바위시장,9107,4411,4696
2,2023-09-12,인천시청,6840,3289,3551
2,2023-09-12,석천사거리,9725,5034,4691
2,2023-09-12,모래내시장,16128,7830,8298
2,2023-09-12,만수,10418,5396,5022
2,2023-09-12,남동구청,9284,4812,4472
2,2023-09-12,인천대공원,6018,3054,2964
2,2023-09-12,운연(서창),2605,1414,1191
2,2023-09-13,검단오류(검단산업단지),5761,2826,2935
2,2023-09-13,왕길,5317,2691,2626
2,2023-09-13,검단사거리,16084,8502,7582
2,2023-09-13,마전,8954,4343,4611
2,2023-09-13,완정,15524,8011,7513
2,2023-09-13,독정,8881,4469,4412
2,2023-09-13,검암,7191,3793,3398
2,2023-09-13,검바위,7389,3597,3792
2,2023-09-13,아시아드경기장(공촌사거리),9544,5143,4401
2,2023-09-13,서구청,17065,8352,8713
2,2023-09-13,가정(루원시티),23616,12041,11575
2,2023-09-13,가정중앙시장,11716,5730,5986
2,2023-09-13,석남(거북시장),6218,3013,3205
2,2023-09-13,서부여성회관,8195,4138,4057
2,2023-09-13,인천가좌,8554,4312,4242
2,2023-09-13,가재울,7857,3973,3884
2,2023-09-13,주안국가산단,5864,2881,2983
2,2023-09-13,주안,15800,6819,8981
2,2023-09-13,시민공원(문화창작지대),19755,10160,9595
2,2023-09-13,석바위시장,8842,4270,4572
2,2023-09-13,인천시청,6599,3136,3463
2,2023-09-13,석천사거리,9372,4827,4545
2,2023-09-13,모래내시장,14745,7299,7446
2,2023-09-13,만수,10099,5176,4923
2,2023-09-13,남동구청,9146,4773,4373
2,2023-09-13,인천대공원,4034,2009,2025
2,2023-09-13,운연(서창),2505,1370,1135
2,2023-09-14,검단오류(검단산업단지),5824,2845,2979
2,2023-09-14,왕길,5506,2769,2737
2,2023-09-14,검단사거리,16800,8805,7995
2,2023-09-14,마전,9121,4455,4666
2,2023-09-14,완정,15962,8260,7702
2,2023-09-14,독정,9432,4731,4701
2,2023-09-14,검암,7440,4029,3411
2,2023-09-14,검바위,7695,3717,3978
2,2023-09-14,아시아드경기장(공촌사거리),10013,5385,4628
2,2023-09-14,서구청,17493,8583,8910
2,2023-09-14,가정(루원시티),24268,12478,11790
2,2023-09-14,가정중앙시장,13033,6302,6731
2,2023-09-14,석남(거북시장),6553,3205,3348
2,2023-09-14,서부여성회관,8438,4260,4178
2,2023-09-14,인천가좌,8691,4424,4267
2,2023-09-14,가재울,8000,4077,3923
2,2023-09-14,주안국가산단,5844,2830,3014
2,2023-09-14,주안,16705,7233,9472
2,2023-09-14,시민공원(문화창작지대),20034,10240,9794
2,2023-09-14,석바위시장,9164,4466,4698
2,2023-09-14,인천시청,6713,3227,3486
2,2023-09-14,석천사거리,9597,4996,4601
2,2023-09-14,모래내시장,16401,8010,8391
2,2023-09-14,만수,10513,5453,5060
2,2023-09-14,남동구청,9478,4899,4579
2,2023-09-14,인천대공원,6055,3112,2943
2,2023-09-14,운연(서창),2606,1415,1191
2,2023-09-15,검단오류(검단산업단지),5764,2816,2948
2,2023-09-15,왕길,5452,2774,2678
2,2023-09-15,검단사거리,17409,9117,8292
2,2023-09-15,마전,9084,4492,4592
2,2023-09-15,완정,15949,8273,7676
2,2023-09-15,독정,9163,4615,4548
2,2023-09-15,검암,7504,4022,3482
2,2023-09-15,검바위,7567,3674,3893
2,2023-09-15,아시아드경기장(공촌사거리),9924,5361,4563
2,2023-09-15,서구청,17874,8735,9139
2,2023-09-15,가정(루원시티),24315,12372,11943
2,2023-09-15,가정중앙시장,12787,6154,6633
2,2023-09-15,석남(거북시장),6414,3096,3318
2,2023-09-15,서부여성회관,8655,4442,4213
2,2023-09-15,인천가좌,8470,4302,4168
2,2023-09-15,가재울,7948,4045,3903
2,2023-09-15,주안국가산단,5795,2813,2982
2,2023-09-15,주안,16932,7256,9676
2,2023-09-15,시민공원(문화창작지대),19901,10265,9636
2,2023-09-15,석바위시장,9027,4382,4645
2,2023-09-15,인천시청,6759,3236,3523
2,2023-09-15,석천사거리,9618,5066,4552
2,2023-09-15,모래내시장,15918,7795,8123
2,2023-09-15,만수,10609,5451,5158
2,2023-09-15,남동구청,9437,4879,4558
2,2023-09-15,인천대공원,4310,2204,2106
2,2023-09-15,운연(서창),2563,1383,1180
2,2023-09-16,검단오류(검단산업단지),2212,1214,998
2,2023-09-16,왕길,3002,1541,1461
2,2023-09-16,검단사거리,12935,6700,6235
2,2023-09-16,마전,5917,2925,2992
2,2023-09-16,완정,10128,5234,4894
2,2023-09-16,독정,6169,3099,3070
2,2023-09-16,검암,5529,2896,2633
2,2023-09-16,검바위,3767,1798,1969
2,2023-09-16,아시아드경기장(공촌사거리),6961,3568,3393
2,2023-09-16,서구청,11065,5518,5547
2,2023-09-16,가정(루원시티),14752,7688,7064
2,2023-09-16,가정중앙시장,9928,4831,5097
2,2023-09-16,석남(거북시장),4379,2022,2357
2,2023-09-16,서부여성회관,6109,3124,2985
2,2023-09-16,인천가좌,4690,2368,2322
2,2023-09-16,가재울,4417,2220,2197
2,2023-09-16,주안국가산단,1697,838,859
2,2023-09-16,주안,12638,5097,7541
2,2023-09-16,시민공원(문화창작지대),13561,6965,6596
2,2023-09-16,석바위시장,6591,3203,3388
2,2023-09-16,인천시청,4403,2100,2303
2,2023-09-16,석천사거리,6275,3270,3005
2,2023-09-16,모래내시장,12833,6300,6533
2,2023-09-16,만수,7632,3948,3684
2,2023-09-16,남동구청,5630,2945,2685
2,2023-09-16,인천대공원,5776,2908,2868
2,2023-09-16,운연(서창),1708,916,792
2,2023-09-17,검단오류(검단산업단지),1503,739,764
2,2023-09-17,왕길,2132,1054,1078
2,2023-09-17,검단사거리,9944,5004,4940
2,2023-09-17,마전,4257,2096,2161
2,2023-09-17,완정,7097,3696,3401
2,2023-09-17,독정,4473,2220,2253
2,2023-09-17,검암,3928,2027,1901
2,2023-09-17,검바위,2783,1301,1482
2,2023-09-17,아시아드경기장(공촌사거리),5069,2628,2441
2,2023-09-17,서구청,7839,3994,3845
2,2023-09-17,가정(루원시티),10222,5256,4966
2,2023-09-17,가정중앙시장,7510,3696,3814
2,2023-09-17,석남(거북시장),3314,1527,1787
2,2023-09-17,서부여성회관,5068,2588,2480
2,2023-09-17,인천가좌,3226,1602,1624
2,2023-09-17,가재울,3366,1702,1664
2,2023-09-17,주안국가산단,847,405,442
2,2023-09-17,주안,9684,3969,5715
2,2023-09-17,시민공원(문화창작지대),10665,5446,5219
2,2023-09-17,석바위시장,5114,2473,2641
2,2023-09-17,인천시청,3610,1724,1886
2,2023-09-17,석천사거리,4883,2578,2305
2,2023-09-17,모래내시장,10248,5000,5248
2,2023-09-17,만수,6222,3193,3029
2,2023-09-17,남동구청,4304,2231,2073
2,2023-09-17,인천대공원,5764,2953,2811
2,2023-09-17,운연(서창),1368,707,661
2,2023-09-18,검단오류(검단산업단지),5892,2893,2999
2,2023-09-18,왕길,5368,2723,2645
2,2023-09-18,검단사거리,16812,8793,8019
2,2023-09-18,마전,9053,4421,4632
2,2023-09-18,완정,15646,8130,7516
2,2023-09-18,독정,9142,4595,4547
2,2023-09-18,검암,7511,4070,3441
2,2023-09-18,검바위,7431,3610,3821
2,2023-09-18,아시아드경기장(공촌사거리),9420,5049,4371
2,2023-09-18,서구청,17017,8521,8496
2,2023-09-18,가정(루원시티),23624,12147,11477
2,2023-09-18,가정중앙시장,12470,6029,6441
2,2023-09-18,석남(거북시장),6409,3099,3310
2,2023-09-18,서부여성회관,8187,4185,4002
2,2023-09-18,인천가좌,8784,4433,4351
2,2023-09-18,가재울,8038,4101,3937
2,2023-09-18,주안국가산단,5792,2812,2980
2,2023-09-18,주안,16520,7199,9321
2,2023-09-18,시민공원(문화창작지대),19908,10179,9729
2,2023-09-18,석바위시장,9185,4390,4795
2,2023-09-18,인천시청,6570,3142,3428
2,2023-09-18,석천사거리,9461,4891,4570
2,2023-09-18,모래내시장,16006,7784,8222
2,2023-09-18,만수,10140,5240,4900
2,2023-09-18,남동구청,9334,4910,4424
2,2023-09-18,인천대공원,5511,2778,2733
2,2023-09-18,운연(서창),2573,1414,1159
2,2023-09-19,검단오류(검단산업단지),6034,2966,3068
2,2023-09-19,왕길,5387,2698,2689
2,2023-09-19,검단사거리,16678,8770,7908
2,2023-09-19,마전,8907,4358,4549
2,2023-09-19,완정,15694,8118,7576
2,2023-09-19,독정,9634,4768,4866
2,2023-09-19,검암,7597,4099,3498
2,2023-09-19,검바위,7564,3663,3901
2,2023-09-19,아시아드경기장(공촌사거리),9837,5219,4618
2,2023-09-19,서구청,17272,8538,8734
2,2023-09-19,가정(루원시티),23866,12318,11548
2,2023-09-19,가정중앙시장,12757,6133,6624
2,2023-09-19,석남(거북시장),6536,3147,3389
2,2023-09-19,서부여성회관,8158,4190,3968
2,2023-09-19,인천가좌,8803,4447,4356
2,2023-09-19,가재울,8200,4199,4001
2,2023-09-19,주안국가산단,5878,2856,3022
2,2023-09-19,주안,16561,7143,9418
2,2023-09-19,시민공원(문화창작지대),20001,10299,9702
2,2023-09-19,석바위시장,9069,4380,4689
2,2023-09-19,인천시청,6730,3226,3504
2,2023-09-19,석천사거리,9742,5116,4626
2,2023-09-19,모래내시장,16147,7821,8326
2,2023-09-19,만수,10326,5358,4968
2,2023-09-19,남동구청,9496,4934,4562
2,2023-09-19,인천대공원,5805,2954,2851
2,2023-09-19,운연(서창),2709,1475,1234
2,2023-09-20,검단오류(검단산업단지),5751,2823,2928
2,2023-09-20,왕길,5211,2593,2618
2,2023-09-20,검단사거리,16070,8453,7617
2,2023-09-20,마전,8795,4313,4482
2,2023-09-20,완정,15395,8012,7383
2,2023-09-20,독정,8759,4382,4377
2,2023-09-20,검암,7182,3871,3311
2,2023-09-20,검바위,7289,3553,3736
2,2023-09-20,아시아드경기장(공촌사거리),9410,5022,4388
2,2023-09-20,서구청,16579,8219,8360
2,2023-09-20,가정(루원시티),23247,11899,11348
2,2023-09-20,가정중앙시장,11663,5663,6000
2,2023-09-20,석남(거북시장),6089,2933,3156
2,2023-09-20,서부여성회관,7819,3954,3865
2,2023-09-20,인천가좌,8399,4249,4150
2,2023-09-20,가재울,7724,3887,3837
2,2023-09-20,주안국가산단,5857,2896,2961
2,2023-09-20,주안,15429,6575,8854
2,2023-09-20,시민공원(문화창작지대),19130,9811,9319
2,2023-09-20,석바위시장,8479,4082,4397
2,2023-09-20,인천시청,6479,3143,3336
2,2023-09-20,석천사거리,9297,4789,4508
2,2023-09-20,모래내시장,14151,6862,7289
2,2023-09-20,만수,9753,5002,4751
2,2023-09-20,남동구청,9039,4730,4309
2,2023-09-20,인천대공원,3222,1638,1584
2,2023-09-20,운연(서창),2330,1245,1085
2,2023-09-21,검단오류(검단산업단지),6042,2970,3072
2,2023-09-21,왕길,5574,2795,2779
2,2023-09-21,검단사거리,17249,9021,8228
2,2023-09-21,마전,9182,4480,4702
2,2023-09-21,완정,16303,8447,7856
2,2023-09-21,독정,9676,4879,4797
2,2023-09-21,검암,7678,4198,3480
2,2023-09-21,검바위,7684,3676,4008
2,2023-09-21,아시아드경기장(공촌사거리),9870,5253,4617
2,2023-09-21,서구청,17851,8811,9040
2,2023-09-21,가정(루원시티),24333,12423,11910
2,2023-09-21,가정중앙시장,13242,6409,6833
2,2023-09-21,석남(거북시장),6596,3186,3410
2,2023-09-21,서부여성회관,8671,4427,4244
2,2023-09-21,인천가좌,8969,4585,4384
2,2023-09-21,가재울,8362,4265,4097
2,2023-09-21,주안국가산단,5936,2873,3063
2,2023-09-21,주안,17013,7319,9694
2,2023-09-21,시민공원(문화창작지대),20056,10360,9696
2,2023-09-21,석바위시장,9043,4327,4716
2,2023-09-21,인천시청,7079,3394,3685
2,2023-09-21,석천사거리,9733,5102,4631
2,2023-09-21,모래내시장,16823,8241,8582
2,2023-09-21,만수,10494,5376,5118
2,2023-09-21,남동구청,9921,5166,4755
2,2023-09-21,인천대공원,5982,3055,2927
2,2023-09-21,운연(서창),3007,1603,1404
2,2023-09-22,검단오류(검단산업단지),5946,2891,3055
2,2023-09-22,왕길,5642,2824,2818
2,2023-09-22,검단사거리,18326,9663,8663
2,2023-09-22,마전,9446,4623,4823
2,2023-09-22,완정,16669,8667,8002
2,2023-09-22,독정,9895,5067,4828
2,2023-09-22,검암,8118,4366,3752
2,2023-09-22,검바위,7646,3673,3973
2,2023-09-22,아시아드경기장(공촌사거리),10102,5402,4700
2,2023-09-22,서구청,18395,9064,9331
2,2023-09-22,가정(루원시티),25295,13017,12278
2,2023-09-22,가정중앙시장,13641,6615,7026
2,2023-09-22,석남(거북시장),6777,3232,3545
2,2023-09-22,서부여성회관,9126,4645,4481
2,2023-09-22,인천가좌,8844,4458,4386
2,2023-09-22,가재울,8460,4330,4130
2,2023-09-22,주안국가산단,5821,2830,2991
2,2023-09-22,주안,17493,7442,10051
2,2023-09-22,시민공원(문화창작지대),20196,10383,9813
2,2023-09-22,석바위시장,9434,4561,4873
2,2023-09-22,인천시청,7259,3452,3807
2,2023-09-22,석천사거리,9899,5207,4692
2,2023-09-22,모래내시장,17646,8566,9080
2,2023-09-22,만수,10975,5704,5271
2,2023-09-22,남동구청,10158,5289,4869
2,2023-09-22,인천대공원,5948,3043,2905
2,2023-09-22,운연(서창),2806,1508,1298
2,2023-09-23,검단오류(검단산업단지),2448,1295,1153
2,2023-09-23,왕길,3324,1702,1622
2,2023-09-23,검단사거리,13725,7054,6671
2,2023-09-23,마전,6133,3057,3076
2,2023-09-23,완정,11197,5888,5309
2,2023-09-23,독정,6636,3308,3328
2,2023-09-23,검암,6091,3218,2873
2,2023-09-23,검바위,4512,2199,2313
2,2023-09-23,아시아드경기장(공촌사거리),7196,3688,3508
2,2023-09-23,서구청,11463,5827,5636
2,2023-09-23,가정(루원시티),15518,8006,7512
2,2023-09-23,가정중앙시장,10901,5353,5548
2,2023-09-23,석남(거북시장),4925,2337,2588
2,2023-09-23,서부여성회관,6578,3363,3215
2,2023-09-23,인천가좌,5188,2642,2546
2,2023-09-23,가재울,4796,2432,2364
2,2023-09-23,주안국가산단,1858,877,981
2,2023-09-23,주안,13519,5485,8034
2,2023-09-23,시민공원(문화창작지대),14094,7246,6848
2,2023-09-23,석바위시장,6497,3145,3352
2,2023-09-23,인천시청,5000,2313,2687
2,2023-09-23,석천사거리,6724,3560,3164
2,2023-09-23,모래내시장,14353,6951,7402
2,2023-09-23,만수,7881,4112,3769
2,2023-09-23,남동구청,6089,3239,2850
2,2023-09-23,인천대공원,7133,3612,3521
2,2023-09-23,운연(서창),1797,957,840
2,2023-09-24,검단오류(검단산업단지),1531,729,802
2,2023-09-24,왕길,2164,1131,1033
2,2023-09-24,검단사거리,10318,5131,5187
2,2023-09-24,마전,4375,2144,2231
2,2023-09-24,완정,7275,3730,3545
2,2023-09-24,독정,4230,2136,2094
2,2023-09-24,검암,4272,2236,2036
2,2023-09-24,검바위,3013,1438,1575
2,2023-09-24,아시아드경기장(공촌사거리),5349,2799,2550
2,2023-09-24,서구청,7913,4007,3906
2,2023-09-24,가정(루원시티),10708,5454,5254
2,2023-09-24,가정중앙시장,8264,4090,4174
2,2023-09-24,석남(거북시장),3425,1619,1806
2,2023-09-24,서부여성회관,5081,2607,2474
2,2023-09-24,인천가좌,3404,1705,1699
2,2023-09-24,가재울,3489,1748,1741
2,2023-09-24,주안국가산단,815,399,416
2,2023-09-24,주안,9964,4118,5846
2,2023-09-24,시민공원(문화창작지대),10628,5457,5171
2,2023-09-24,석바위시장,5135,2504,2631
2,2023-09-24,인천시청,3725,1759,1966
2,2023-09-24,석천사거리,4827,2540,2287
2,2023-09-24,모래내시장,11015,5372,5643
2,2023-09-24,만수,6313,3213,3100
2,2023-09-24,남동구청,4482,2328,2154
2,2023-09-24,인천대공원,7344,3638,3706
2,2023-09-24,운연(서창),1500,802,698
2,2023-09-25,검단오류(검단산업단지),5791,2793,2998
2,2023-09-25,왕길,5538,2816,2722
2,2023-09-25,검단사거리,17143,9039,8104
2,2023-09-25,마전,8995,4380,4615
2,2023-09-25,완정,16191,8417,7774
2,2023-09-25,독정,9771,4839,4932
2,2023-09-25,검암,7580,4154,3426
2,2023-09-25,검바위,7531,3647,3884
2,2023-09-25,아시아드경기장(공촌사거리),9781,5211,4570
2,2023-09-25,서구청,17909,8937,8972
2,2023-09-25,가정(루원시티),23841,12375,11466
2,2023-09-25,가정중앙시장,13579,6621,6958
2,2023-09-25,석남(거북시장),6478,3123,3355
2,2023-09-25,서부여성회관,8067,4177,3890
2,2023-09-25,인천가좌,8569,4312,4257
2,2023-09-25,가재울,8138,4134,4004
2,2023-09-25,주안국가산단,5830,2881,2949
2,2023-09-25,주안,16382,7118,9264
2,2023-09-25,시민공원(문화창작지대),19774,10098,9676
2,2023-09-25,석바위시장,9429,4521,4908
2,2023-09-25,인천시청,6677,3183,3494
2,2023-09-25,석천사거리,9789,5071,4718
2,2023-09-25,모래내시장,17344,8443,8901
2,2023-09-25,만수,10349,5408,4941
2,2023-09-25,남동구청,9707,5093,4614
2,2023-09-25,인천대공원,4963,2526,2437
2,2023-09-25,운연(서창),2626,1391,1235
2,2023-09-26,검단오류(검단산업단지),5609,2743,2866
2,2023-09-26,왕길,5219,2617,2602
2,2023-09-26,검단사거리,16302,8525,7777
2,2023-09-26,마전,8874,4292,4582
2,2023-09-26,완정,15282,7936,7346
2,2023-09-26,독정,9113,4594,4519
2,2023-09-26,검암,7349,3925,3424
2,2023-09-26,검바위,7420,3591,3829
2,2023-09-26,아시아드경기장(공촌사거리),9387,4992,4395
2,2023-09-26,서구청,16739,8276,8463
2,2023-09-26,가정(루원시티),23156,11898,11258
2,2023-09-26,가정중앙시장,12828,6200,6628
2,2023-09-26,석남(거북시장),6066,2932,3134
2,2023-09-26,서부여성회관,7804,3994,3810
2,2023-09-26,인천가좌,8387,4222,4165
2,2023-09-26,가재울,7908,3942,3966
2,2023-09-26,주안국가산단,5825,2805,3020
2,2023-09-26,주안,15807,6824,8983
2,2023-09-26,시민공원(문화창작지대),18982,9732,9250
2,2023-09-26,석바위시장,8800,4263,4537
2,2023-09-26,인천시청,6644,3212,3432
2,2023-09-26,석천사거리,9344,4849,4495
2,2023-09-26,모래내시장,15419,7502,7917
2,2023-09-26,만수,9560,5000,4560
2,2023-09-26,남동구청,8975,4719,4256
2,2023-09-26,인천대공원,3125,1581,1544
2,2023-09-26,운연(서창),2320,1260,1060
2,2023-09-27,검단오류(검단산업단지),5293,2602,2691
2,2023-09-27,왕길,5184,2562,2622
2,2023-09-27,검단사거리,17812,9251,8561
2,2023-09-27,마전,8860,4307,4553
2,2023-09-27,완정,15834,8247,7587
2,2023-09-27,독정,9834,4954,4880
2,2023-09-27,검암,7416,4092,3324
2,2023-09-27,검바위,7620,3721,3899
2,2023-09-27,아시아드경기장(공촌사거리),9648,5164,4484
2,2023-09-27,서구청,17390,8574,8816
2,2023-09-27,가정(루원시티),23489,12058,11431
2,2023-09-27,가정중앙시장,15145,7284,7861
2,2023-09-27,석남(거북시장),6471,3097,3374
2,2023-09-27,서부여성회관,8461,4344,4117
2,2023-09-27,인천가좌,8444,4259,4185
2,2023-09-27,가재울,8054,4110,3944
2,2023-09-27,주안국가산단,5633,2725,2908
2,2023-09-27,주안,16795,7148,9647
2,2023-09-27,시민공원(문화창작지대),19775,10193,9582
2,2023-09-27,석바위시장,9124,4400,4724
2,2023-09-27,인천시청,6811,3242,3569
2,2023-09-27,석천사거리,9726,5033,4693
2,2023-09-27,모래내시장,18151,8694,9457
2,2023-09-27,만수,10360,5452,4908
2,2023-09-27,남동구청,9390,4939,4451
2,2023-09-27,인천대공원,4500,2275,2225
2,2023-09-27,운연(서창),2541,1382,1159
2,2023-09-28,검단오류(검단산업단지),1682,948,734
2,2023-09-28,왕길,1725,864,861
2,2023-09-28,검단사거리,9843,5069,4774
2,2023-09-28,마전,3748,1812,1936
2,2023-09-28,완정,6072,3175,2897
2,2023-09-28,독정,4484,2263,2221
2,2023-09-28,검암,3473,1828,1645
2,2023-09-28,검바위,2725,1351,1374
2,2023-09-28,아시아드경기장(공촌사거리),4552,2492,2060
2,2023-09-28,서구청,7025,3481,3544
2,2023-09-28,가정(루원시티),8322,4336,3986
2,2023-09-28,가정중앙시장,9446,4577,4869
2,2023-09-28,석남(거북시장),3021,1451,1570
2,2023-09-28,서부여성회관,4650,2400,2250
2,2023-09-28,인천가좌,3054,1527,1527
2,2023-09-28,가재울,2564,1298,1266
2,2023-09-28,주안국가산단,648,347,301
2,2023-09-28,주안,8681,3702,4979
2,2023-09-28,시민공원(문화창작지대),7792,3998,3794
2,2023-09-28,석바위시장,4171,1978,2193
2,2023-09-28,인천시청,2898,1373,1525
2,2023-09-28,석천사거리,3701,1911,1790
2,2023-09-28,모래내시장,11175,5376,5799
2,2023-09-28,만수,5132,2664,2468
2,2023-09-28,남동구청,3751,1942,1809
2,2023-09-28,인천대공원,4480,2216,2264
2,2023-09-28,운연(서창),1127,603,524
2,2023-09-29,검단오류(검단산업단지),1674,1008,666
2,2023-09-29,왕길,1220,636,584
2,2023-09-29,검단사거리,8504,4368,4136
2,2023-09-29,마전,2863,1407,1456
2,2023-09-29,완정,4653,2422,2231
2,2023-09-29,독정,3468,1765,1703
2,2023-09-29,검암,2865,1571,1294
2,2023-09-29,검바위,2116,1091,1025
2,2023-09-29,아시아드경기장(공촌사거리),3643,1957,1686
2,2023-09-29,서구청,5239,2614,2625
2,2023-09-29,가정(루원시티),6481,3386,3095
2,2023-09-29,가정중앙시장,5208,2570,2638
2,2023-09-29,석남(거북시장),2633,1245,1388
2,2023-09-29,서부여성회관,4128,2084,2044
2,2023-09-29,인천가좌,2812,1418,1394
2,2023-09-29,가재울,2329,1183,1146
2,2023-09-29,주안국가산단,379,193,186
2,2023-09-29,주안,8128,3298,4830
2,2023-09-29,시민공원(문화창작지대),6473,3316,3157
2,2023-09-29,석바위시장,2663,1323,1340
2,2023-09-29,인천시청,2128,931,1197
2,2023-09-29,석천사거리,3013,1565,1448
2,2023-09-29,모래내시장,5943,2894,3049
2,2023-09-29,만수,4301,2232,2069
2,2023-09-29,남동구청,2897,1481,1416
2,2023-09-29,인천대공원,5036,2564,2472
2,2023-09-29,운연(서창),1027,536,491
2,2023-09-30,검단오류(검단산업단지),1498,773,725
2,2023-09-30,왕길,1674,866,808
2,2023-09-30,검단사거리,9451,4667,4784
2,2023-09-30,마전,3436,1701,1735
2,2023-09-30,완정,5981,3076,2905
2,2023-09-30,독정,3798,1912,1886
2,2023-09-30,검암,3522,1948,1574
2,2023-09-30,검바위,2363,1165,1198
2,2023-09-30,아시아드경기장(공촌사거리),3956,2137,1819
2,2023-09-30,서구청,6448,3113,3335
2,2023-09-30,가정(루원시티),8289,4263,4026
2,2023-09-30,가정중앙시장,5823,2943,2880
2,2023-09-30,석남(거북시장),2989,1418,1571
2,2023-09-30,서부여성회관,4436,2252,2184
2,2023-09-30,인천가좌,2896,1517,1379
2,2023-09-30,가재울,2638,1346,1292
2,2023-09-30,주안국가산단,445,209,236
2,2023-09-30,주안,8552,3402,5150
2,2023-09-30,시민공원(문화창작지대),7681,4000,3681
2,2023-09-30,석바위시장,3142,1608,1534
2,2023-09-30,인천시청,2614,1240,1374
2,2023-09-30,석천사거리,3729,1986,1743
2,2023-09-30,모래내시장,7101,3487,3614
2,2023-09-30,만수,4799,2518,2281
2,2023-09-30,남동구청,3304,1721,1583
2,2023-09-30,인천대공원,5385,2682,2703
2,2023-09-30,운연(서창),1149,611,538
2,2023-10-01,검단오류(검단산업단지),1699,854,845
2,2023-10-01,왕길,2068,1077,991
2,2023-10-01,검단사거리,10575,5333,5242
2,2023-10-01,마전,4156,2116,2040
2,2023-10-01,완정,7287,3677,3610
2,2023-10-01,독정,4462,2217,2245
2,2023-10-01,검암,4350,2326,2024
2,2023-10-01,검바위,2904,1412,1492
2,2023-10-01,아시아드경기장(공촌사거리),4582,2475,2107
2,2023-10-01,서구청,7316,3604,3712
2,2023-10-01,가정(루원시티),10206,5244,4962
2,2023-10-01,가정중앙시장,6953,3425,3528
2,2023-10-01,석남(거북시장),3544,1695,1849
2,2023-10-01,서부여성회관,5155,2660,2495
2,2023-10-01,인천가좌,3406,1751,1655
2,2023-10-01,가재울,3420,1709,1711
2,2023-10-01,주안국가산단,566,288,278
2,2023-10-01,주안,9816,4032,5784
2,2023-10-01,시민공원(문화창작지대),10241,5156,5085
2,2023-10-01,석바위시장,4335,2103,2232
2,2023-10-01,인천시청,3333,1553,1780
2,2023-10-01,석천사거리,4634,2523,2111
2,2023-10-01,모래내시장,9747,4805,4942
2,2023-10-01,만수,5984,3041,2943
2,2023-10-01,남동구청,4133,2137,1996
2,2023-10-01,인천대공원,9512,4744,4768
2,2023-10-01,운연(서창),1506,792,714
2,2023-10-02,검단오류(검단산업단지),1768,872,896
2,2023-10-02,왕길,2410,1241,1169
2,2023-10-02,검단사거리,11873,5984,5889
2,2023-10-02,마전,4586,2286,2300
2,2023-10-02,완정,8672,4452,4220
2,2023-10-02,독정,5176,2589,2587
2,2023-10-02,검암,5075,2768,2307
2,2023-10-02,검바위,3193,1506,1687
2,2023-10-02,아시아드경기장(공촌사거리),5248,2823,2425
2,2023-10-02,서구청,9178,4599,4579
2,2023-10-02,가정(루원시티),11674,5977,5697
2,2023-10-02,가정중앙시장,8462,4197,4265
2,2023-10-02,석남(거북시장),4004,1875,2129
2,2023-10-02,서부여성회관,5160,2660,2500
2,2023-10-02,인천가좌,4416,2272,2144
2,2023-10-02,가재울,3871,1944,1927
2,2023-10-02,주안국가산단,1022,477,545
2,2023-10-02,주안,10687,4400,6287
2,2023-10-02,시민공원(문화창작지대),11915,6154,5761
2,2023-10-02,석바위시장,5214,2541,2673
2,2023-10-02,인천시청,3776,1771,2005
2,2023-10-02,석천사거리,5438,2911,2527
2,2023-10-02,모래내시장,11466,5671,5795
2,2023-10-02,만수,6742,3541,3201
2,2023-10-02,남동구청,4926,2551,2375
2,2023-10-02,인천대공원,9801,4864,4937
2,2023-10-02,운연(서창),1646,849,797
2,2023-10-03,검단오류(검단산업단지),1610,763,847
2,2023-10-03,왕길,2304,1173,1131
2,2023-10-03,검단사거리,9959,5030,4929
2,2023-10-03,마전,4207,2111,2096
2,2023-10-03,완정,7649,3895,3754
2,2023-10-03,독정,4595,2322,2273
2,2023-10-03,검암,4698,2468,2230
2,2023-10-03,검바위,2944,1403,1541
2,2023-10-03,아시아드경기장(공촌사거리),5001,2716,2285
2,2023-10-03,서구청,7982,3963,4019
2,2023-10-03,가정(루원시티),10506,5398,5108
2,2023-10-03,가정중앙시장,7546,3718,3828
2,2023-10-03,석남(거북시장),3670,1712,1958
2,2023-10-03,서부여성회관,4615,2372,2243
2,2023-10-03,인천가좌,3479,1744,1735
2,2023-10-03,가재울,3679,1895,1784
2,2023-10-03,주안국가산단,1140,537,603
2,2023-10-03,주안,9821,4140,5681
2,2023-10-03,시민공원(문화창작지대),10087,5179,4908
2,2023-10-03,석바위시장,4732,2326,2406
2,2023-10-03,인천시청,3428,1623,1805
2,2023-10-03,석천사거리,4910,2628,2282
2,2023-10-03,모래내시장,10730,5234,5496
2,2023-10-03,만수,6018,3095,2923
2,2023-10-03,남동구청,4644,2460,2184
2,2023-10-03,인천대공원,9524,4724,4800
2,2023-10-03,운연(서창),1481,773,708
2,2023-10-04,검단오류(검단산업단지),5788,2872,2916
2,2023-10-04,왕길,5347,2687,2660
2,2023-10-04,검단사거리,16684,8756,7928
2,2023-10-04,마전,8954,4374,4580
2,2023-10-04,완정,15920,8221,7699
2,2023-10-04,독정,9358,4734,4624
2,2023-10-04,검암,7748,4258,3490
2,2023-10-04,검바위,7382,3563,3819
2,2023-10-04,아시아드경기장(공촌사거리),9483,4979,4504
2,2023-10-04,서구청,16878,8379,8499
2,2023-10-04,가정(루원시티),23431,12009,11422
2,2023-10-04,가정중앙시장,12265,5977,6288
2,2023-10-04,석남(거북시장),6496,3142,3354
2,2023-10-04,서부여성회관,8114,4170,3944
2,2023-10-04,인천가좌,8584,4353,4231
2,2023-10-04,가재울,8235,4188,4047
2,2023-10-04,주안국가산단,5772,2830,2942
2,2023-10-04,주안,16107,6992,9115
2,2023-10-04,시민공원(문화창작지대),19889,10154,9735
2,2023-10-04,석바위시장,9098,4353,4745
2,2023-10-04,인천시청,6856,3299,3557
2,2023-10-04,석천사거리,9533,4939,4594
2,2023-10-04,모래내시장,15653,7589,8064
2,2023-10-04,만수,10305,5319,4986
2,2023-10-04,남동구청,9310,4840,4470
2,2023-10-04,인천대공원,5519,2797,2722
2,2023-10-04,운연(서창),2534,1340,1194
2,2023-10-05,검단오류(검단산업단지),5828,2871,2957
2,2023-10-05,왕길,5433,2742,2691
2,2023-10-05,검단사거리,16826,8792,8034
2,2023-10-05,마전,9085,4411,4674
2,2023-10-05,완정,16069,8298,7771
2,2023-10-05,독정,9409,4737,4672
2,2023-10-05,검암,8450,4642,3808
2,2023-10-05,검바위,7588,3658,3930
2,2023-10-05,아시아드경기장(공촌사거리),9815,5151,4664
2,2023-10-05,서구청,17423,8671,8752
2,2023-10-05,가정(루원시티),24298,12359,11939
2,2023-10-05,가정중앙시장,12754,6190,6564
2,2023-10-05,석남(거북시장),6357,3068,3289
2,2023-10-05,서부여성회관,8354,4269,4085
2,2023-10-05,인천가좌,8741,4444,4297
2,2023-10-05,가재울,8288,4254,4034
2,2023-10-05,주안국가산단,5842,2872,2970
2,2023-10-05,주안,16612,7139,9473
2,2023-10-05,시민공원(문화창작지대),19959,10207,9752
2,2023-10-05,석바위시장,9050,4381,4669
2,2023-10-05,인천시청,6968,3339,3629
2,2023-10-05,석천사거리,9750,5045,4705
2,2023-10-05,모래내시장,16174,7862,8312
2,2023-10-05,만수,10359,5374,4985
2,2023-10-05,남동구청,9675,5048,4627
2,2023-10-05,인천대공원,6013,3077,2936
2,2023-10-05,운연(서창),2697,1457,1240
2,2023-10-06,검단오류(검단산업단지),5876,2898,2978
2,2023-10-06,왕길,5436,2751,2685
2,2023-10-06,검단사거리,18220,9545,8675
2,2023-10-06,마전,9061,4482,4579
2,2023-10-06,완정,16463,8515,7948
2,2023-10-06,독정,9477,4784,4693
2,2023-10-06,검암,8579,4731,3848
2,2023-10-06,검바위,7560,3661,3899
2,2023-10-06,아시아드경기장(공촌사거리),9680,5163,4517
2,2023-10-06,서구청,18507,9114,9393
2,2023-10-06,가정(루원시티),24993,12792,12201
2,2023-10-06,가정중앙시장,13311,6522,6789
2,2023-10-06,석남(거북시장),6595,3141,3454
2,2023-10-06,서부여성회관,8870,4499,4371
2,2023-10-06,인천가좌,8912,4526,4386
2,2023-10-06,가재울,8616,4430,4186
2,2023-10-06,주안국가산단,5938,2907,3031
2,2023-10-06,주안,17186,7331,9855
2,2023-10-06,시민공원(문화창작지대),20314,10406,9908
2,2023-10-06,석바위시장,9255,4497,4758
2,2023-10-06,인천시청,7285,3472,3813
2,2023-10-06,석천사거리,9873,5154,4719
2,2023-10-06,모래내시장,17113,8339,8774
2,2023-10-06,만수,10902,5620,5282
2,2023-10-06,남동구청,9793,5191,4602
2,2023-10-06,인천대공원,6744,3409,3335
2,2023-10-06,운연(서창),2757,1475,1282
2,2023-10-07,검단오류(검단산업단지),2413,1280,1133
2,2023-10-07,왕길,3250,1670,1580
2,2023-10-07,검단사거리,13979,7222,6757
2,2023-10-07,마전,5903,2936,2967
2,2023-10-07,완정,10548,5508,5040
2,2023-10-07,독정,6194,3120,3074
2,2023-10-07,검암,6062,3201,2861
2,2023-10-07,검바위,3980,1994,1986
2,2023-10-07,아시아드경기장(공촌사거리),7138,3654,3484
2,2023-10-07,서구청,11153,5639,5514
2,2023-10-07,가정(루원시티),15199,7894,7305
2,2023-10-07,가정중앙시장,10113,5023,5090
2,2023-10-07,석남(거북시장),4947,2375,2572
2,2023-10-07,서부여성회관,6364,3277,3087
2,2023-10-07,인천가좌,5225,2671,2554
2,2023-10-07,가재울,4726,2412,2314
2,2023-10-07,주안국가산단,1675,820,855
2,2023-10-07,주안,13610,5584,8026
2,2023-10-07,시민공원(문화창작지대),14140,7246,6894
2,2023-10-07,석바위시장,6475,3154,3321
2,2023-10-07,인천시청,4856,2295,2561
2,2023-10-07,석천사거리,6335,3328,3007
2,2023-10-07,모래내시장,13810,6768,7042
2,2023-10-07,만수,7803,4090,3713
2,2023-10-07,남동구청,5866,3096,2770
2,2023-10-07,인천대공원,8016,3988,4028
2,2023-10-07,운연(서창),1782,953,829
2,2023-10-08,검단오류(검단산업단지),1519,780,739
2,2023-10-08,왕길,2152,1118,1034
2,2023-10-08,검단사거리,10183,5077,5106
2,2023-10-08,마전,4182,2017,2165
2,2023-10-08,완정,7685,3988,3697
2,2023-10-08,독정,4239,2142,2097
2,2023-10-08,검암,4477,2293,2184
2,2023-10-08,검바위,3071,1499,1572
2,2023-10-08,아시아드경기장(공촌사거리),5303,2747,2556
2,2023-10-08,서구청,8558,4234,4324
2,2023-10-08,가정(루원시티),10882,5493,5389
2,2023-10-08,가정중앙시장,7688,3825,3863
2,2023-10-08,석남(거북시장),3484,1687,1797
2,2023-10-08,서부여성회관,5213,2717,2496
2,2023-10-08,인천가좌,3564,1784,1780
2,2023-10-08,가재울,3580,1859,1721
2,2023-10-08,주안국가산단,736,377,359
2,2023-10-08,주안,10619,4342,6277
2,2023-10-08,시민공원(문화창작지대),10853,5544,5309
2,2023-10-08,석바위시장,5149,2573,2576
2,2023-10-08,인천시청,3762,1769,1993
2,2023-10-08,석천사거리,4887,2574,2313
2,2023-10-08,모래내시장,10546,5190,5356
2,2023-10-08,만수,6275,3236,3039
2,2023-10-08,남동구청,4641,2441,2200
2,2023-10-08,인천대공원,7580,3742,3838
2,2023-10-08,운연(서창),1447,765,682
2,2023-10-09,검단오류(검단산업단지),1868,889,979
2,2023-10-09,왕길,2366,1239,1127
2,2023-10-09,검단사거리,10189,5135,5054
2,2023-10-09,마전,4220,2046,2174
2,2023-10-09,완정,7726,3962,3764
2,2023-10-09,독정,4839,2427,2412
2,2023-10-09,검암,4650,2426,2224
2,2023-10-09,검바위,3086,1464,1622
2,2023-10-09,아시아드경기장(공촌사거리),5046,2677,2369
2,2023-10-09,서구청,8889,4478,4411
2,2023-10-09,가정(루원시티),10866,5547,5319
2,2023-10-09,가정중앙시장,8248,4039,4209
2,2023-10-09,석남(거북시장),3812,1828,1984
2,2023-10-09,서부여성회관,4712,2410,2302
2,2023-10-09,인천가좌,3734,1869,1865
2,2023-10-09,가재울,3901,1970,1931
2,2023-10-09,주안국가산단,1355,630,725
2,2023-10-09,주안,10097,4175,5922
2,2023-10-09,시민공원(문화창작지대),10752,5556,5196
2,2023-10-09,석바위시장,5193,2559,2634
2,2023-10-09,인천시청,3615,1714,1901
2,2023-10-09,석천사거리,4903,2569,2334
2,2023-10-09,모래내시장,11387,5512,5875
2,2023-10-09,만수,6129,3204,2925
2,2023-10-09,남동구청,4734,2463,2271
2,2023-10-09,인천대공원,8565,4259,4306
2,2023-10-09,운연(서창),1546,815,731
2,2023-10-10,검단오류(검단산업단지),5970,2941,3029
2,2023-10-10,왕길,5462,2747,2715
2,2023-10-10,검단사거리,17616,9284,8332
2,2023-10-10,마전,9175,4449,4726
2,2023-10-10,완정,16455,8576,7879
2,2023-10-10,독정,9825,4904,4921
2,2023-10-10,검암,8594,4706,3888
2,2023-10-10,검바위,7621,3634,3987
2,2023-10-10,아시아드경기장(공촌사거리),9708,5149,4559
2,2023-10-10,서구청,18133,9044,9089
2,2023-10-10,가정(루원시티),24693,12644,12049
2,2023-10-10,가정중앙시장,12784,6219,6565
2,2023-10-10,석남(거북시장),6330,3077,3253
2,2023-10-10,서부여성회관,8528,4373,4155
2,2023-10-10,인천가좌,8807,4445,4362
2,2023-10-10,가재울,8503,4284,4219
2,2023-10-10,주안국가산단,5900,2883,3017
2,2023-10-10,주안,16810,7197,9613
2,2023-10-10,시민공원(문화창작지대),20333,10427,9906
2,2023-10-10,석바위시장,9253,4523,4730
2,2023-10-10,인천시청,7092,3389,3703
2,2023-10-10,석천사거리,9922,5109,4813
2,2023-10-10,모래내시장,16551,8021,8530
2,2023-10-10,만수,10477,5455,5022
2,2023-10-10,남동구청,10280,5331,4949
2,2023-10-10,인천대공원,6308,3185,3123
2,2023-10-10,운연(서창),2661,1406,1255
2,2023-10-11,검단오류(검단산업단지),6162,3054,3108
2,2023-10-11,왕길,5625,2819,2806
2,2023-10-11,검단사거리,17684,9168,8516
2,2023-10-11,마전,9220,4516,4704
2,2023-10-11,완정,16575,8599,7976
2,2023-10-11,독정,9841,4945,4896
2,2023-10-11,검암,8719,4769,3950
2,2023-10-11,검바위,7561,3622,3939
2,2023-10-11,아시아드경기장(공촌사거리),10167,5369,4798
2,2023-10-11,서구청,18019,8948,9071
2,2023-10-11,가정(루원시티),25086,12881,12205
2,2023-10-11,가정중앙시장,12924,6312,6612
2,2023-10-11,석남(거북시장),6532,3193,3339
2,2023-10-11,서부여성회관,8660,4417,4243
2,2023-10-11,인천가좌,9061,4580,4481
2,2023-10-11,가재울,8718,4396,4322
2,2023-10-11,주안국가산단,6091,2989,3102
2,2023-10-11,주안,16838,7303,9535
2,2023-10-11,시민공원(문화창작지대),20384,10429,9955
2,2023-10-11,석바위시장,9182,4397,4785
2,2023-10-11,인천시청,7115,3391,3724
2,2023-10-11,석천사거리,9958,5158,4800
2,2023-10-11,모래내시장,16499,8068,8431
2,2023-10-11,만수,10527,5411,5116
2,2023-10-11,남동구청,9955,5185,4770
2,2023-10-11,인천대공원,5907,3014,2893
2,2023-10-11,운연(서창),2727,1478,1249
2,2023-10-12,검단오류(검단산업단지),6078,2999,3079
2,2023-10-12,왕길,5400,2713,2687
2,2023-10-12,검단사거리,17293,9088,8205
2,2023-10-12,마전,9039,4395,4644
2,2023-10-12,완정,16269,8365,7904
2,2023-10-12,독정,9668,4844,4824
2,2023-10-12,검암,8732,4748,3984
2,2023-10-12,검바위,7461,3588,3873
2,2023-10-12,아시아드경기장(공촌사거리),9921,5268,4653
2,2023-10-12,서구청,17354,8558,8796
2,2023-10-12,가정(루원시티),24708,12660,12048
2,2023-10-12,가정중앙시장,13059,6303,6756
2,2023-10-12,석남(거북시장),6336,3077,3259
2,2023-10-12,서부여성회관,8648,4375,4273
2,2023-10-12,인천가좌,9164,4677,4487
2,2023-10-12,가재울,8524,4316,4208
2,2023-10-12,주안국가산단,6040,2959,3081
2,2023-10-12,주안,16860,7366,9494
2,2023-10-12,시민공원(문화창작지대),20268,10353,9915
2,2023-10-12,석바위시장,9156,4399,4757
2,2023-10-12,인천시청,7217,3474,3743
2,2023-10-12,석천사거리,9895,5130,4765
2,2023-10-12,모래내시장,16472,8047,8425
2,2023-10-12,만수,10735,5552,5183
2,2023-10-12,남동구청,9712,5074,4638
2,2023-10-12,인천대공원,6723,3397,3326
2,2023-10-12,운연(서창),2792,1520,1272
2,2023-10-13,검단오류(검단산업단지),6027,2976,3051
2,2023-10-13,왕길,5491,2753,2738
2,2023-10-13,검단사거리,18144,9470,8674
2,2023-10-13,마전,9228,4555,4673
2,2023-10-13,완정,16656,8627,8029
2,2023-10-13,독정,9912,5009,4903
2,2023-10-13,검암,9007,4907,4100
2,2023-10-13,검바위,7672,3764,3908
2,2023-10-13,아시아드경기장(공촌사거리),10060,5419,4641
2,2023-10-13,서구청,18348,9086,9262
2,2023-10-13,가정(루원시티),25603,13101,12502
2,2023-10-13,가정중앙시장,13513,6599,6914
2,2023-10-13,석남(거북시장),6583,3199,3384
2,2023-10-13,서부여성회관,8892,4541,4351
2,2023-10-13,인천가좌,9007,4596,4411
2,2023-10-13,가재울,9002,4601,4401
2,2023-10-13,주안국가산단,6020,2952,3068
2,2023-10-13,주안,17680,7498,10182
2,2023-10-13,시민공원(문화창작지대),20475,10535,9940
2,2023-10-13,석바위시장,9376,4500,4876
2,2023-10-13,인천시청,7309,3468,3841
2,2023-10-13,석천사거리,10072,5261,4811
2,2023-10-13,모래내시장,17130,8354,8776
2,2023-10-13,만수,11100,5706,5394
2,2023-10-13,남동구청,10145,5344,4801
2,2023-10-13,인천대공원,6220,3151,3069
2,2023-10-13,운연(서창),2786,1519,1267
2,2023-10-14,검단오류(검단산업단지),2080,1128,952
2,2023-10-14,왕길,3179,1615,1564
2,2023-10-14,검단사거리,12767,6597,6170
2,2023-10-14,마전,5597,2791,2806
2,2023-10-14,완정,10737,5600,5137
2,2023-10-14,독정,5978,2985,2993
2,2023-10-14,검암,5521,2958,2563
2,2023-10-14,검바위,3780,1889,1891
2,2023-10-14,아시아드경기장(공촌사거리),6797,3480,3317
2,2023-10-14,서구청,11418,5733,5685
2,2023-10-14,가정(루원시티),14711,7566,7145
2,2023-10-14,가정중앙시장,9629,4696,4933
2,2023-10-14,석남(거북시장),4719,2237,2482
2,2023-10-14,서부여성회관,6077,3115,2962
2,2023-10-14,인천가좌,4827,2468,2359
2,2023-10-14,가재울,4610,2340,2270
2,2023-10-14,주안국가산단,1649,803,846
2,2023-10-14,주안,13655,5594,8061
2,2023-10-14,시민공원(문화창작지대),13346,6863,6483
2,2023-10-14,석바위시장,6174,2977,3197
2,2023-10-14,인천시청,4571,2175,2396
2,2023-10-14,석천사거리,6224,3296,2928
2,2023-10-14,모래내시장,12168,5967,6201
2,2023-10-14,만수,7641,3900,3741
2,2023-10-14,남동구청,5725,3025,2700
2,2023-10-14,인천대공원,4518,2214,2304
2,2023-10-14,운연(서창),1723,902,821
2,2023-10-15,검단오류(검단산업단지),1555,748,807
2,2023-10-15,왕길,2084,1060,1024
2,2023-10-15,검단사거리,10459,5272,5187
2,2023-10-15,마전,4319,2072,2247
2,2023-10-15,완정,7532,3833,3699
2,2023-10-15,독정,4727,2396,2331
2,2023-10-15,검암,4693,2408,2285
2,2023-10-15,검바위,3091,1489,1602
2,2023-10-15,아시아드경기장(공촌사거리),5730,2940,2790
2,2023-10-15,서구청,8452,4288,4164
2,2023-10-15,가정(루원시티),10973,5578,5395
2,2023-10-15,가정중앙시장,7694,3786,3908
2,2023-10-15,석남(거북시장),3676,1734,1942
2,2023-10-15,서부여성회관,5327,2745,2582
2,2023-10-15,인천가좌,3752,1875,1877
2,2023-10-15,가재울,3759,1899,1860
2,2023-10-15,주안국가산단,816,398,418
2,2023-10-15,주안,10347,4295,6052
2,2023-10-15,시민공원(문화창작지대),11331,5820,5511
2,2023-10-15,석바위시장,5295,2552,2743
2,2023-10-15,인천시청,4107,1941,2166
2,2023-10-15,석천사거리,4981,2602,2379
2,2023-10-15,모래내시장,10995,5364,5631
2,2023-10-15,만수,6406,3267,3139
2,2023-10-15,남동구청,4714,2475,2239
2,2023-10-15,인천대공원,8834,4375,4459
2,2023-10-15,운연(서창),1577,854,723
2,2023-10-16,검단오류(검단산업단지),5829,2849,2980
2,2023-10-16,왕길,5478,2761,2717
2,2023-10-16,검단사거리,17073,8965,8108
2,2023-10-16,마전,8953,4356,4597
2,2023-10-16,완정,16140,8347,7793
2,2023-10-16,독정,9611,4839,4772
2,2023-10-16,검암,8521,4671,3850
2,2023-10-16,검바위,7575,3651,3924
2,2023-10-16,아시아드경기장(공촌사거리),9971,5256,4715
2,2023-10-16,서구청,17681,8814,8867
2,2023-10-16,가정(루원시티),24559,12559,12000
2,2023-10-16,가정중앙시장,12693,6229,6464
2,2023-10-16,석남(거북시장),6353,3069,3284
2,2023-10-16,서부여성회관,8518,4366,4152
2,2023-10-16,인천가좌,9005,4562,4443
2,2023-10-16,가재울,8551,4366,4185
2,2023-10-16,주안국가산단,5871,2869,3002
2,2023-10-16,주안,16525,7170,9355
2,2023-10-16,시민공원(문화창작지대),19951,10244,9707
2,2023-10-16,석바위시장,9195,4453,4742
2,2023-10-16,인천시청,7016,3319,3697
2,2023-10-16,석천사거리,9695,5040,4655
2,2023-10-16,모래내시장,16403,7953,8450
2,2023-10-16,만수,10313,5326,4987
2,2023-10-16,남동구청,9521,4935,4586
2,2023-10-16,인천대공원,6141,3095,3046
2,2023-10-16,운연(서창),2676,1425,1251
2,2023-10-17,검단오류(검단산업단지),6038,3004,3034
2,2023-10-17,왕길,5530,2775,2755
2,2023-10-17,검단사거리,17401,9187,8214
2,2023-10-17,마전,9158,4470,4688
2,2023-10-17,완정,16611,8593,8018
2,2023-10-17,독정,9684,4830,4854
2,2023-10-17,검암,8980,4887,4093
2,2023-10-17,검바위,7683,3719,3964
2,2023-10-17,아시아드경기장(공촌사거리),10066,5333,4733
2,2023-10-17,서구청,17927,8930,8997
2,2023-10-17,가정(루원시티),25074,12727,12347
2,2023-10-17,가정중앙시장,13066,6370,6696
2,2023-10-17,석남(거북시장),6379,3111,3268
2,2023-10-17,서부여성회관,8633,4411,4222
2,2023-10-17,인천가좌,8998,4494,4504
2,2023-10-17,가재울,8643,4411,4232
2,2023-10-17,주안국가산단,6031,2961,3070
2,2023-10-17,주안,16735,7321,9414
2,2023-10-17,시민공원(문화창작지대),20367,10538,9829
2,2023-10-17,석바위시장,9172,4432,4740
2,2023-10-17,인천시청,7284,3477,3807
2,2023-10-17,석천사거리,10402,5438,4964
2,2023-10-17,모래내시장,16364,7974,8390
2,2023-10-17,만수,10508,5423,5085
2,2023-10-17,남동구청,9809,5143,4666
2,2023-10-17,인천대공원,6715,3406,3309
2,2023-10-17,운연(서창),2858,1519,1339
2,2023-10-18,검단오류(검단산업단지),6096,3043,3053
2,2023-10-18,왕길,5668,2866,2802
2,2023-10-18,검단사거리,17537,9245,8292
2,2023-10-18,마전,9136,4422,4714
2,2023-10-18,완정,16520,8516,8004
2,2023-10-18,독정,9849,4954,4895
2,2023-10-18,검암,8977,4882,4095
2,2023-10-18,검바위,7742,3747,3995
2,2023-10-18,아시아드경기장(공촌사거리),10261,5439,4822
2,2023-10-18,서구청,17900,8915,8985
2,2023-10-18,가정(루원시티),24888,12669,12219
2,2023-10-18,가정중앙시장,13006,6330,6676
2,2023-10-18,석남(거북시장),6349,3068,3281
2,2023-10-18,서부여성회관,8625,4426,4199
2,2023-10-18,인천가좌,9031,4557,4474
2,2023-10-18,가재울,8755,4434,4321
2,2023-10-18,주안국가산단,6062,2967,3095
2,2023-10-18,주안,16618,7150,9468
2,2023-10-18,시민공원(문화창작지대),20480,10428,10052
2,2023-10-18,석바위시장,9251,4512,4739
2,2023-10-18,인천시청,7289,3502,3787
2,2023-10-18,석천사거리,10014,5178,4836
2,2023-10-18,모래내시장,16729,8110,8619
2,2023-10-18,만수,10740,5584,5156
2,2023-10-18,남동구청,9729,5105,4624
2,2023-10-18,인천대공원,6250,3144,3106
2,2023-10-18,운연(서창),2740,1440,1300
2,2023-10-19,검단오류(검단산업단지),5791,2871,2920
2,2023-10-19,왕길,5364,2687,2677
2,2023-10-19,검단사거리,16687,8665,8022
2,2023-10-19,마전,8952,4359,4593
2,2023-10-19,완정,15908,8188,7720
2,2023-10-19,독정,9281,4641,4640
2,2023-10-19,검암,8646,4820,3826
2,2023-10-19,검바위,7519,3618,3901
2,2023-10-19,아시아드경기장(공촌사거리),9604,5153,4451
2,2023-10-19,서구청,16911,8311,8600
2,2023-10-19,가정(루원시티),24092,12310,11782
2,2023-10-19,가정중앙시장,12296,6015,6281
2,2023-10-19,석남(거북시장),6118,2931,3187
2,2023-10-19,서부여성회관,8315,4234,4081
2,2023-10-19,인천가좌,8878,4488,4390
2,2023-10-19,가재울,8257,4187,4070
2,2023-10-19,주안국가산단,6084,2926,3158
2,2023-10-19,주안,16043,6980,9063
2,2023-10-19,시민공원(문화창작지대),19587,10043,9544
2,2023-10-19,석바위시장,8389,4057,4332
2,2023-10-19,인천시청,6796,3212,3584
2,2023-10-19,석천사거리,9331,4806,4525
2,2023-10-19,모래내시장,15020,7382,7638
2,2023-10-19,만수,9939,5137,4802
2,2023-10-19,남동구청,9014,4697,4317
2,2023-10-19,인천대공원,4132,2086,2046
2,2023-10-19,운연(서창),2508,1341,1167
2,2023-10-20,검단오류(검단산업단지),5940,2934,3006
2,2023-10-20,왕길,5441,2759,2682
2,2023-10-20,검단사거리,18244,9563,8681
2,2023-10-20,마전,9219,4556,4663
2,2023-10-20,완정,17301,9009,8292
2,2023-10-20,독정,9841,4855,4986
2,2023-10-20,검암,9404,5190,4214
2,2023-10-20,검바위,6732,3264,3468
2,2023-10-20,아시아드경기장(공촌사거리),9930,5246,4684
2,2023-10-20,서구청,18586,9193,9393
2,2023-10-20,가정(루원시티),25552,13051,12501
2,2023-10-20,가정중앙시장,13529,6556,6973
2,2023-10-20,석남(거북시장),6725,3282,3443
2,2023-10-20,서부여성회관,8807,4507,4300
2,2023-10-20,인천가좌,8948,4491,4457
2,2023-10-20,가재울,8672,4426,4246
2,2023-10-20,주안국가산단,5886,2906,2980
2,2023-10-20,주안,17304,7223,10081
2,2023-10-20,시민공원(문화창작지대),20366,10506,9860
2,2023-10-20,석바위시장,9930,4785,5145
2,2023-10-20,인천시청,7078,3379,3699
2,2023-10-20,석천사거리,10128,5282,4846
2,2023-10-20,모래내시장,16986,8246,8740
2,2023-10-20,만수,11063,5756,5307
2,2023-10-20,남동구청,9881,5182,4699
2,2023-10-20,인천대공원,6107,3047,3060
2,2023-10-20,운연(서창),2750,1480,1270
2,2023-10-21,검단오류(검단산업단지),2227,1184,1043
2,2023-10-21,왕길,3123,1618,1505
2,2023-10-21,검단사거리,14005,7276,6729
2,2023-10-21,마전,5960,2872,3088
2,2023-10-21,완정,10680,5651,5029
2,2023-10-21,독정,6338,3194,3144
2,2023-10-21,검암,6044,3152,2892
2,2023-10-21,검바위,3923,1938,1985
2,2023-10-21,아시아드경기장(공촌사거리),7064,3563,3501
2,2023-10-21,서구청,11531,5798,5733
2,2023-10-21,가정(루원시티),15547,7994,7553
2,2023-10-21,가정중앙시장,10438,5111,5327
2,2023-10-21,석남(거북시장),4997,2349,2648
2,2023-10-21,서부여성회관,6510,3390,3120
2,2023-10-21,인천가좌,5109,2590,2519
2,2023-10-21,가재울,4879,2514,2365
2,2023-10-21,주안국가산단,1596,777,819
2,2023-10-21,주안,14498,5878,8620
2,2023-10-21,시민공원(문화창작지대),14279,7364,6915
2,2023-10-21,석바위시장,6979,3364,3615
2,2023-10-21,인천시청,5098,2334,2764
2,2023-10-21,석천사거리,6946,3618,3328
2,2023-10-21,모래내시장,13458,6692,6766
2,2023-10-21,만수,8091,4164,3927
2,2023-10-21,남동구청,6427,3333,3094
2,2023-10-21,인천대공원,7922,3960,3962
2,2023-10-21,운연(서창),1904,981,923
2,2023-10-22,검단오류(검단산업단지),1622,800,822
2,2023-10-22,왕길,2190,1094,1096
2,2023-10-22,검단사거리,10575,5287,5288
2,2023-10-22,마전,4087,1999,2088
2,2023-10-22,완정,7317,3692,3625
2,2023-10-22,독정,4156,2081,2075
2,2023-10-22,검암,4483,2364,2119
2,2023-10-22,검바위,3024,1439,1585
2,2023-10-22,아시아드경기장(공촌사거리),5555,2870,2685
2,2023-10-22,서구청,8400,4233,4167
2,2023-10-22,가정(루원시티),11449,5882,5567
2,2023-10-22,가정중앙시장,7790,3830,3960
2,2023-10-22,석남(거북시장),3599,1686,1913
2,2023-10-22,서부여성회관,5123,2677,2446
2,2023-10-22,인천가좌,3537,1773,1764
2,2023-10-22,가재울,3788,1926,1862
2,2023-10-22,주안국가산단,798,387,411
2,2023-10-22,주안,10783,4367,6416
2,2023-10-22,시민공원(문화창작지대),11204,5762,5442
2,2023-10-22,석바위시장,5522,2670,2852
2,2023-10-22,인천시청,4022,1935,2087
2,2023-10-22,석천사거리,5305,2768,2537
2,2023-10-22,모래내시장,10759,5234,5525
2,2023-10-22,만수,6127,3148,2979
2,2023-10-22,남동구청,4742,2504,2238
2,2023-10-22,인천대공원,8834,4418,4416
2,2023-10-22,운연(서창),1597,800,797
2,2023-10-23,검단오류(검단산업단지),5991,2938,3053
2,2023-10-23,왕길,5414,2745,2669
2,2023-10-23,검단사거리,16976,8917,8059
2,2023-10-23,마전,8895,4266,4629
2,2023-10-23,완정,15770,8171,7599
2,2023-10-23,독정,9645,4822,4823
2,2023-10-23,검암,8581,4749,3832
2,2023-10-23,검바위,6900,3293,3607
2,2023-10-23,아시아드경기장(공촌사거리),9642,5124,4518
2,2023-10-23,서구청,17456,8637,8819
2,2023-10-23,가정(루원시티),24522,12581,11941
2,2023-10-23,가정중앙시장,12717,6208,6509
2,2023-10-23,석남(거북시장),6294,3018,3276
2,2023-10-23,서부여성회관,8463,4318,4145
2,2023-10-23,인천가좌,8816,4478,4338
2,2023-10-23,가재울,8547,4391,4156
2,2023-10-23,주안국가산단,5999,2956,3043
2,2023-10-23,주안,16640,7263,9377
2,2023-10-23,시민공원(문화창작지대),19861,10184,9677
2,2023-10-23,석바위시장,9211,4490,4721
2,2023-10-23,인천시청,6985,3337,3648
2,2023-10-23,석천사거리,9797,5089,4708
2,2023-10-23,모래내시장,16381,7975,8406
2,2023-10-23,만수,10348,5317,5031
2,2023-10-23,남동구청,9564,4966,4598
2,2023-10-23,인천대공원,6439,3235,3204
2,2023-10-23,운연(서창),2684,1441,1243
2,2023-10-24,검단오류(검단산업단지),6113,3010,3103
2,2023-10-24,왕길,5487,2787,2700
2,2023-10-24,검단사거리,16821,8790,8031
2,2023-10-24,마전,8948,4353,4595
2,2023-10-24,완정,15821,8165,7656
2,2023-10-24,독정,9568,4809,4759
2,2023-10-24,검암,8665,4752,3913
2,2023-10-24,검바위,7450,3580,3870
2,2023-10-24,아시아드경기장(공촌사거리),9584,5068,4516
2,2023-10-24,서구청,17595,8664,8931
2,2023-10-24,가정(루원시티),24721,12633,12088
2,2023-10-24,가정중앙시장,12643,6188,6455
2,2023-10-24,석남(거북시장),6126,2998,3128
2,2023-10-24,서부여성회관,8341,4289,4052
2,2023-10-24,인천가좌,8769,4425,4344
2,2023-10-24,가재울,8744,4484,4260
2,2023-10-24,주안국가산단,6015,2941,3074
2,2023-10-24,주안,16405,7146,9259
2,2023-10-24,시민공원(문화창작지대),20230,10387,9843
2,2023-10-24,석바위시장,9087,4386,4701
2,2023-10-24,인천시청,7031,3349,3682
2,2023-10-24,석천사거리,9723,5040,4683
2,2023-10-24,모래내시장,16282,7906,8376
2,2023-10-24,만수,10248,5323,4925
2,2023-10-24,남동구청,9524,4911,4613
2,2023-10-24,인천대공원,6269,3169,3100
2,2023-10-24,운연(서창),2797,1507,1290
2,2023-10-25,검단오류(검단산업단지),6200,3089,3111
2,2023-10-25,왕길,5474,2755,2719
2,2023-10-25,검단사거리,17664,9321,8343
2,2023-10-25,마전,9012,4444,4568
2,2023-10-25,완정,16419,8442,7977
2,2023-10-25,독정,10202,5102,5100
2,2023-10-25,검암,8835,4829,4006
2,2023-10-25,검바위,7745,3748,3997
2,2023-10-25,아시아드경기장(공촌사거리),9779,5169,4610
2,2023-10-25,서구청,17774,8740,9034
2,2023-10-25,가정(루원시티),25535,13158,12377
2,2023-10-25,가정중앙시장,13032,6316,6716
2,2023-10-25,석남(거북시장),6549,3121,3428
2,2023-10-25,서부여성회관,8690,4424,4266
2,2023-10-25,인천가좌,9109,4601,4508
2,2023-10-25,가재울,8897,4526,4371
2,2023-10-25,주안국가산단,6098,2950,3148
2,2023-10-25,주안,17037,7295,9742
2,2023-10-25,시민공원(문화창작지대),20716,10646,10070
2,2023-10-25,석바위시장,9390,4476,4914
2,2023-10-25,인천시청,7595,3646,3949
2,2023-10-25,석천사거리,10075,5203,4872
2,2023-10-25,모래내시장,16756,8192,8564
2,2023-10-25,만수,10643,5478,5165
2,2023-10-25,남동구청,9952,5200,4752
2,2023-10-25,인천대공원,6797,3407,3390
2,2023-10-25,운연(서창),2861,1551,1310
2,2023-10-26,검단오류(검단산업단지),6089,2971,3118
2,2023-10-26,왕길,5391,2716,2675
2,2023-10-26,검단사거리,17174,8982,8192
2,2023-10-26,마전,8955,4358,4597
2,2023-10-26,완정,15932,8139,7793
2,2023-10-26,독정,9674,4827,4847
2,2023-10-26,검암,8583,4682,3901
2,2023-10-26,검바위,7311,3528,3783
2,2023-10-26,아시아드경기장(공촌사거리),9532,5160,4372
2,2023-10-26,서구청,17348,8656,8692
2,2023-10-26,가정(루원시티),24624,12556,12068
2,2023-10-26,가정중앙시장,12724,6206,6518
2,2023-10-26,석남(거북시장),6345,3032,3313
2,2023-10-26,서부여성회관,8457,4323,4134
2,2023-10-26,인천가좌,8960,4524,4436
2,2023-10-26,가재울,8438,4284,4154
2,2023-10-26,주안국가산단,5996,2919,3077
2,2023-10-26,주안,16606,7125,9481
2,2023-10-26,시민공원(문화창작지대),20367,10380,9987
2,2023-10-26,석바위시장,9128,4373,4755
2,2023-10-26,인천시청,7043,3405,3638
2,2023-10-26,석천사거리,9706,5035,4671
2,2023-10-26,모래내시장,16199,7871,8328
2,2023-10-26,만수,10258,5286,4972
2,2023-10-26,남동구청,9557,5004,4553
2,2023-10-26,인천대공원,6393,3224,3169
2,2023-10-26,운연(서창),2711,1481,1230
2,2023-10-27,검단오류(검단산업단지),5924,2924,3000
2,2023-10-27,왕길,5551,2786,2765
2,2023-10-27,검단사거리,18577,9717,8860
2,2023-10-27,마전,9284,4562,4722
2,2023-10-27,완정,16458,8518,7940
2,2023-10-27,독정,9597,4783,4814
2,2023-10-27,검암,8938,4898,4040
2,2023-10-27,검바위,7580,3752,3828
2,2023-10-27,아시아드경기장(공촌사거리),12376,6625,5751
2,2023-10-27,서구청,22499,11154,11345
2,2023-10-27,가정(루원시티),26010,13272,12738
2,2023-10-27,가정중앙시장,13349,6452,6897
2,2023-10-27,석남(거북시장),6923,3376,3547
2,2023-10-27,서부여성회관,8945,4561,4384
2,2023-10-27,인천가좌,9385,4829,4556
2,2023-10-27,가재울,8807,4505,4302
2,2023-10-27,주안국가산단,5962,2908,3054
2,2023-10-27,주안,17620,7432,10188
2,2023-10-27,시민공원(문화창작지대),20755,10635,10120
2,2023-10-27,석바위시장,9377,4484,4893
2,2023-10-27,인천시청,7431,3554,3877
2,2023-10-27,석천사거리,9854,5120,4734
2,2023-10-27,모래내시장,17561,8437,9124
2,2023-10-27,만수,11012,5737,5275
2,2023-10-27,남동구청,10085,5261,4824
2,2023-10-27,인천대공원,7145,3616,3529
2,2023-10-27,운연(서창),2965,1598,1367
2,2023-10-28,검단오류(검단산업단지),2282,1244,1038
2,2023-10-28,왕길,3366,1726,1640
2,2023-10-28,검단사거리,14390,7486,6904
2,2023-10-28,마전,6181,3050,3131
2,2023-10-28,완정,11479,5965,5514
2,2023-10-28,독정,6900,3492,3408
2,2023-10-28,검암,6365,3381,2984
2,2023-10-28,검바위,4483,2244,2239
2,2023-10-28,아시아드경기장(공촌사거리),10166,5271,4895
2,2023-10-28,서구청,17404,8710,8694
2,2023-10-28,가정(루원시티),16495,8509,7986
2,2023-10-28,가정중앙시장,10543,5161,5382
2,2023-10-28,석남(거북시장),5008,2417,2591
2,2023-10-28,서부여성회관,6929,3578,3351
2,2023-10-28,인천가좌,5243,2721,2522
2,2023-10-28,가재울,5290,2677,2613
2,2023-10-28,주안국가산단,1554,755,799
2,2023-10-28,주안,15086,6151,8935
2,2023-10-28,시민공원(문화창작지대),14943,7749,7194
2,2023-10-28,석바위시장,6764,3280,3484
2,2023-10-28,인천시청,5666,2665,3001
2,2023-10-28,석천사거리,7171,3801,3370
2,2023-10-28,모래내시장,14127,6913,7214
2,2023-10-28,만수,8731,4517,4214
2,2023-10-28,남동구청,6813,3537,3276
2,2023-10-28,인천대공원,11503,5682,5821
2,2023-10-28,운연(서창),2199,1155,1044
2,2023-10-29,검단오류(검단산업단지),1721,830,891
2,2023-10-29,왕길,2191,1109,1082
2,2023-10-29,검단사거리,10345,5196,5149
2,2023-10-29,마전,4332,2165,2167
2,2023-10-29,완정,7597,3868,3729
2,2023-10-29,독정,4800,2384,2416
2,2023-10-29,검암,4674,2432,2242
2,2023-10-29,검바위,3187,1529,1658
2,2023-10-29,아시아드경기장(공촌사거리),5481,2838,2643
2,2023-10-29,서구청,8207,4156,4051
2,2023-10-29,가정(루원시티),11355,5751,5604
2,2023-10-29,가정중앙시장,7894,3815,4079
2,2023-10-29,석남(거북시장),3705,1694,2011
2,2023-10-29,서부여성회관,5309,2734,2575
2,2023-10-29,인천가좌,3570,1823,1747
2,2023-10-29,가재울,3826,1899,1927
2,2023-10-29,주안국가산단,801,386,415
2,2023-10-29,주안,10299,4174,6125
2,2023-10-29,시민공원(문화창작지대),11558,5923,5635
2,2023-10-29,석바위시장,5375,2593,2782
2,2023-10-29,인천시청,4056,1908,2148
2,2023-10-29,석천사거리,4997,2641,2356
2,2023-10-29,모래내시장,11183,5423,5760
2,2023-10-29,만수,6407,3273,3134
2,2023-10-29,남동구청,4741,2472,2269
2,2023-10-29,인천대공원,13142,6596,6546
2,2023-10-29,운연(서창),1572,845,727
2,2023-10-30,검단오류(검단산업단지),5923,2888,3035
2,2023-10-30,왕길,5359,2699,2660
2,2023-10-30,검단사거리,17110,8965,8145
2,2023-10-30,마전,8885,4391,4494
2,2023-10-30,완정,15645,8146,7499
2,2023-10-30,독정,9605,4873,4732
2,2023-10-30,검암,8455,4584,3871
2,2023-10-30,검바위,7246,3497,3749
2,2023-10-30,아시아드경기장(공촌사거리),9340,4926,4414
2,2023-10-30,서구청,17359,8645,8714
2,2023-10-30,가정(루원시티),24157,12335,11822
2,2023-10-30,가정중앙시장,12362,6029,6333
2,2023-10-30,석남(거북시장),6304,3026,3278
2,2023-10-30,서부여성회관,8433,4302,4131
2,2023-10-30,인천가좌,8882,4508,4374
2,2023-10-30,가재울,8537,4371,4166
2,2023-10-30,주안국가산단,5932,2893,3039
2,2023-10-30,주안,16604,7111,9493
2,2023-10-30,시민공원(문화창작지대),20137,10351,9786
2,2023-10-30,석바위시장,9186,4432,4754
2,2023-10-30,인천시청,6847,3297,3550
2,2023-10-30,석천사거리,9605,5024,4581
2,2023-10-30,모래내시장,16344,7946,8398
2,2023-10-30,만수,10265,5346,4919
2,2023-10-30,남동구청,9413,4920,4493
2,2023-10-30,인천대공원,7581,3789,3792
2,2023-10-30,운연(서창),2682,1452,1230
2,2023-10-31,검단오류(검단산업단지),6164,3021,3143
2,2023-10-31,왕길,5410,2667,2743
2,2023-10-31,검단사거리,17314,9131,8183
2,2023-10-31,마전,8912,4315,4597
2,2023-10-31,완정,15890,8248,7642
2,2023-10-31,독정,9802,4917,4885
2,2023-10-31,검암,8596,4659,3937
2,2023-10-31,검바위,7258,3515,3743
2,2023-10-31,아시아드경기장(공촌사거리),9566,5146,4420
2,2023-10-31,서구청,17596,8723,8873
2,2023-10-31,가정(루원시티),24807,12731,12076
2,2023-10-31,가정중앙시장,12795,6212,6583
2,2023-10-31,석남(거북시장),6207,3034,3173
2,2023-10-31,서부여성회관,8394,4306,4088
2,2023-10-31,인천가좌,8960,4509,4451
2,2023-10-31,가재울,8834,4547,4287
2,2023-10-31,주안국가산단,6008,2932,3076
2,2023-10-31,주안,16668,7130,9538
2,2023-10-31,시민공원(문화창작지대),20406,10477,9929
2,2023-10-31,석바위시장,9124,4370,4754
2,2023-10-31,인천시청,7079,3392,3687
2,2023-10-31,석천사거리,9866,5105,4761
2,2023-10-31,모래내시장,16476,8045,8431
2,2023-10-31,만수,10376,5324,5052
2,2023-10-31,남동구청,9758,5089,4669
2,2023-10-31,인천대공원,7624,3810,3814
2,2023-10-31,운연(서창),2767,1500,1267
2,2023-11-01,검단오류(검단산업단지),6176,3058,3118
2,2023-11-01,왕길,5370,2687,2683
2,2023-11-01,검단사거리,16781,8764,8017
2,2023-11-01,마전,8615,4202,4413
2,2023-11-01,완정,15789,8182,7607
2,2023-11-01,독정,9611,4825,4786
2,2023-11-01,검암,8518,4705,3813
2,2023-11-01,검바위,7399,3611,3788
2,2023-11-01,아시아드경기장(공촌사거리),9886,5257,4629
2,2023-11-01,서구청,17320,8598,8722
2,2023-11-01,가정(루원시티),24351,12372,11979
2,2023-11-01,가정중앙시장,12518,6111,6407
2,2023-11-01,석남(거북시장),6226,2995,3231
2,2023-11-01,서부여성회관,8520,4376,4144
2,2023-11-01,인천가좌,8779,4426,4353
2,2023-11-01,가재울,8412,4279,4133
2,2023-11-01,주안국가산단,5965,2885,3080
2,2023-11-01,주안,16578,7124,9454
2,2023-11-01,시민공원(문화창작지대),20266,10400,9866
2,2023-11-01,석바위시장,8955,4290,4665
2,2023-11-01,인천시청,6844,3300,3544
2,2023-11-01,석천사거리,9697,5096,4601
2,2023-11-01,모래내시장,15751,7652,8099
2,2023-11-01,만수,10470,5397,5073
2,2023-11-01,남동구청,9434,4927,4507
2,2023-11-01,인천대공원,5399,2679,2720
2,2023-11-01,운연(서창),2675,1419,1256
2,2023-11-02,검단오류(검단산업단지),6128,3039,3089
2,2023-11-02,왕길,5430,2689,2741
2,2023-11-02,검단사거리,17202,9009,8193
2,2023-11-02,마전,9083,4427,4656
2,2023-11-02,완정,16154,8314,7840
2,2023-11-02,독정,9867,4958,4909
2,2023-11-02,검암,8913,4891,4022
2,2023-11-02,검바위,7446,3593,3853
2,2023-11-02,아시아드경기장(공촌사거리),9720,5118,4602
2,2023-11-02,서구청,17450,8629,8821
2,2023-11-02,가정(루원시티),24827,12663,12164
2,2023-11-02,가정중앙시장,13034,6354,6680
2,2023-11-02,석남(거북시장),6173,2976,3197
2,2023-11-02,서부여성회관,8687,4367,4320
2,2023-11-02,인천가좌,8863,4492,4371
2,2023-11-02,가재울,8525,4333,4192
2,2023-11-02,주안국가산단,5865,2847,3018
2,2023-11-02,주안,16958,7312,9646
2,2023-11-02,시민공원(문화창작지대),20682,10631,10051
2,2023-11-02,석바위시장,8891,4327,4564
2,2023-11-02,인천시청,7220,3499,3721
2,2023-11-02,석천사거리,9798,5089,4709
2,2023-11-02,모래내시장,16652,8084,8568
2,2023-11-02,만수,10377,5350,5027
2,2023-11-02,남동구청,9777,5079,4698
2,2023-11-02,인천대공원,7617,3851,3766
2,2023-11-02,운연(서창),2752,1477,1275
2,2023-11-03,검단오류(검단산업단지),5940,2931,3009
2,2023-11-03,왕길,5387,2674,2713
2,2023-11-03,검단사거리,17399,9149,8250
2,2023-11-03,마전,8839,4343,4496
2,2023-11-03,완정,16115,8277,7838
2,2023-11-03,독정,9199,4627,4572
2,2023-11-03,검암,8626,4691,3935
2,2023-11-03,검바위,7295,3537,3758
2,2023-11-03,아시아드경기장(공촌사거리),9605,5071,4534
2,2023-11-03,서구청,17791,8798,8993
2,2023-11-03,가정(루원시티),24674,12597,12077
2,2023-11-03,가정중앙시장,12527,6066,6461
2,2023-11-03,석남(거북시장),6320,3065,3255
2,2023-11-03,서부여성회관,8690,4456,4234
2,2023-11-03,인천가좌,8645,4400,4245
2,2023-11-03,가재울,8532,4288,4244
2,2023-11-03,주안국가산단,5904,2908,2996
2,2023-11-03,주안,16850,7129,9721
2,2023-11-03,시민공원(문화창작지대),20234,10436,9798
2,2023-11-03,석바위시장,8876,4299,4577
2,2023-11-03,인천시청,7081,3420,3661
2,2023-11-03,석천사거리,9671,5115,4556
2,2023-11-03,모래내시장,16342,7951,8391
2,2023-11-03,만수,10488,5372,5116
2,2023-11-03,남동구청,9599,4971,4628
2,2023-11-03,인천대공원,5946,2992,2954
2,2023-11-03,운연(서창),2640,1425,1215
2,2023-11-04,검단오류(검단산업단지),2264,1207,1057
2,2023-11-04,왕길,3180,1671,1509
2,2023-11-04,검단사거리,13686,7075,6611
2,2023-11-04,마전,5974,2975,2999
2,2023-11-04,완정,10745,5639,5106
2,2023-11-04,독정,6341,3244,3097
2,2023-11-04,검암,6156,3257,2899
2,2023-11-04,검바위,3869,1917,1952
2,2023-11-04,아시아드경기장(공촌사거리),7188,3630,3558
2,2023-11-04,서구청,11598,5837,5761
2,2023-11-04,가정(루원시티),15348,7975,7373
2,2023-11-04,가정중앙시장,10465,5174,5291
2,2023-11-04,석남(거북시장),4930,2289,2641
2,2023-11-04,서부여성회관,6353,3289,3064
2,2023-11-04,인천가좌,5162,2638,2524
2,2023-11-04,가재울,4959,2546,2413
2,2023-11-04,주안국가산단,1445,718,727
2,2023-11-04,주안,14053,5669,8384
2,2023-11-04,시민공원(문화창작지대),14349,7417,6932
2,2023-11-04,석바위시장,6716,3244,3472
2,2023-11-04,인천시청,5297,2448,2849
2,2023-11-04,석천사거리,6485,3415,3070
2,2023-11-04,모래내시장,14037,6814,7223
2,2023-11-04,만수,7803,4070,3733
2,2023-11-04,남동구청,6059,3186,2873
2,2023-11-04,인천대공원,12472,6188,6284
2,2023-11-04,운연(서창),1928,1032,896
2,2023-11-05,검단오류(검단산업단지),1285,617,668
2,2023-11-05,왕길,1798,946,852
2,2023-11-05,검단사거리,8861,4400,4461
2,2023-11-05,마전,3802,1870,1932
2,2023-11-05,완정,6586,3327,3259
2,2023-11-05,독정,4207,2062,2145
2,2023-11-05,검암,3456,1831,1625
2,2023-11-05,검바위,2667,1268,1399
2,2023-11-05,아시아드경기장(공촌사거리),4672,2425,2247
2,2023-11-05,서구청,7214,3606,3608
2,2023-11-05,가정(루원시티),9630,4875,4755
2,2023-11-05,가정중앙시장,6419,3129,3290
2,2023-11-05,석남(거북시장),3089,1459,1630
2,2023-11-05,서부여성회관,4542,2307,2235
2,2023-11-05,인천가좌,2955,1470,1485
2,2023-11-05,가재울,3166,1548,1618
2,2023-11-05,주안국가산단,723,340,383
2,2023-11-05,주안,9134,3664,5470
2,2023-11-05,시민공원(문화창작지대),9814,5082,4732
2,2023-11-05,석바위시장,4529,2182,2347
2,2023-11-05,인천시청,3160,1484,1676
2,2023-11-05,석천사거리,3975,2088,1887
2,2023-11-05,모래내시장,8241,4069,4172
2,2023-11-05,만수,5141,2626,2515
2,2023-11-05,남동구청,3746,1948,1798
2,2023-11-05,인천대공원,3551,1761,1790
2,2023-11-05,운연(서창),1124,588,536
2,2023-11-06,검단오류(검단산업단지),5732,2797,2935
2,2023-11-06,왕길,4953,2469,2484
2,2023-11-06,검단사거리,15754,8339,7415
2,2023-11-06,마전,8545,4190,4355
2,2023-11-06,완정,14883,7689,7194
2,2023-11-06,독정,8964,4544,4420
2,2023-11-06,검암,8378,4692,3686
2,2023-11-06,검바위,6851,3303,3548
2,2023-11-06,아시아드경기장(공촌사거리),9061,4799,4262
2,2023-11-06,서구청,16576,8260,8316
2,2023-11-06,가정(루원시티),22689,11647,11042
2,2023-11-06,가정중앙시장,11448,5567,5881
2,2023-11-06,석남(거북시장),5960,2909,3051
2,2023-11-06,서부여성회관,7799,4023,3776
2,2023-11-06,인천가좌,8342,4183,4159
2,2023-11-06,가재울,7859,4039,3820
2,2023-11-06,주안국가산단,5800,2829,2971
2,2023-11-06,주안,15288,6448,8840
2,2023-11-06,시민공원(문화창작지대),18879,9712,9167
2,2023-11-06,석바위시장,8333,4047,4286
2,2023-11-06,인천시청,6165,2938,3227
2,2023-11-06,석천사거리,9041,4677,4364
2,2023-11-06,모래내시장,14052,6856,7196
2,2023-11-06,만수,9479,4882,4597
2,2023-11-06,남동구청,8621,4491,4130
2,2023-11-06,인천대공원,3412,1730,1682
2,2023-11-06,운연(서창),2296,1202,1094
2,2023-11-07,검단오류(검단산업단지),6062,2991,3071
2,2023-11-07,왕길,5295,2638,2657
2,2023-11-07,검단사거리,16805,8845,7960
2,2023-11-07,마전,8887,4265,4622
2,2023-11-07,완정,15942,8227,7715
2,2023-11-07,독정,9288,4687,4601
2,2023-11-07,검암,8858,4778,4080
2,2023-11-07,검바위,7548,3633,3915
2,2023-11-07,아시아드경기장(공촌사거리),9671,5177,4494
2,2023-11-07,서구청,17499,8665,8834
2,2023-11-07,가정(루원시티),24220,12377,11843
2,2023-11-07,가정중앙시장,12634,6101,6533
2,2023-11-07,석남(거북시장),6238,3033,3205
2,2023-11-07,서부여성회관,8344,4292,4052
2,2023-11-07,인천가좌,8765,4407,4358
2,2023-11-07,가재울,8551,4368,4183
2,2023-11-07,주안국가산단,6006,2945,3061
2,2023-11-07,주안,16372,7054,9318
2,2023-11-07,시민공원(문화창작지대),20310,10437,9873
2,2023-11-07,석바위시장,9014,4331,4683
2,2023-11-07,인천시청,6945,3329,3616
2,2023-11-07,석천사거리,9801,5032,4769
2,2023-11-07,모래내시장,16016,7809,8207
2,2023-11-07,만수,10308,5318,4990
2,2023-11-07,남동구청,9468,4954,4514
2,2023-11-07,인천대공원,5409,2745,2664
2,2023-11-07,운연(서창),2514,1370,1144
2,2023-11-08,검단오류(검단산업단지),6112,3021,3091
2,2023-11-08,왕길,5435,2739,2696
2,2023-11-08,검단사거리,17393,9197,8196
2,2023-11-08,마전,9010,4396,4614
2,2023-11-08,완정,16134,8347,7787
2,2023-11-08,독정,9842,4944,4898
2,2023-11-08,검암,8682,4719,3963
2,2023-11-08,검바위,7558,3624,3934
2,2023-11-08,아시아드경기장(공촌사거리),10118,5355,4763
2,2023-11-08,서구청,17702,8773,8929
2,2023-11-08,가정(루원시티),24990,12740,12250
2,2023-11-08,가정중앙시장,12909,6295,6614
2,2023-11-08,석남(거북시장),6655,3206,3449
2,2023-11-08,서부여성회관,8502,4358,4144
2,2023-11-08,인천가좌,8805,4391,4414
2,2023-11-08,가재울,8724,4459,4265
2,2023-11-08,주안국가산단,6054,2968,3086
2,2023-11-08,주안,16878,7219,9659
2,2023-11-08,시민공원(문화창작지대),20813,10674,10139
2,2023-11-08,석바위시장,8946,4309,4637
2,2023-11-08,인천시청,7043,3368,3675
2,2023-11-08,석천사거리,9759,5019,4740
2,2023-11-08,모래내시장,16482,8041,8441
2,2023-11-08,만수,10453,5415,5038
2,2023-11-08,남동구청,9938,5156,4782
2,2023-11-08,인천대공원,5611,2841,2770
2,2023-11-08,운연(서창),2617,1395,1222
2,2023-11-09,검단오류(검단산업단지),6103,2997,3106
2,2023-11-09,왕길,5407,2680,2727
2,2023-11-09,검단사거리,16526,8665,7861
2,2023-11-09,마전,8831,4253,4578
2,2023-11-09,완정,15688,8130,7558
2,2023-11-09,독정,9257,4670,4587
2,2023-11-09,검암,8626,4607,4019
2,2023-11-09,검바위,7304,3587,3717
2,2023-11-09,아시아드경기장(공촌사거리),9582,5000,4582
2,2023-11-09,서구청,16921,8292,8629
2,2023-11-09,가정(루원시티),23976,12262,11714
2,2023-11-09,가정중앙시장,12413,6032,6381
2,2023-11-09,석남(거북시장),6295,3035,3260
2,2023-11-09,서부여성회관,8433,4259,4174
2,2023-11-09,인천가좌,8631,4360,4271
2,2023-11-09,가재울,8306,4221,4085
2,2023-11-09,주안국가산단,6000,2913,3087
2,2023-11-09,주안,16510,7127,9383
2,2023-11-09,시민공원(문화창작지대),20321,10410,9911
2,2023-11-09,석바위시장,8852,4306,4546
2,2023-11-09,인천시청,6697,3183,3514
2,2023-11-09,석천사거리,9563,4955,4608
2,2023-11-09,모래내시장,15808,7764,8044
2,2023-11-09,만수,9992,5173,4819
2,2023-11-09,남동구청,9339,4843,4496
2,2023-11-09,인천대공원,5392,2741,2651
2,2023-11-09,운연(서창),2611,1406,1205
2,2023-11-10,검단오류(검단산업단지),5943,2965,2978
2,2023-11-10,왕길,5506,2756,2750
2,2023-11-10,검단사거리,18084,9362,8722
2,2023-11-10,마전,9056,4415,4641
2,2023-11-10,완정,16503,8593,7910
2,2023-11-10,독정,9432,4712,4720
2,2023-11-10,검암,8765,4802,3963
2,2023-11-10,검바위,7622,3636,3986
2,2023-11-10,아시아드경기장(공촌사거리),9850,5246,4604
2,2023-11-10,서구청,17515,8659,8856
2,2023-11-10,가정(루원시티),24461,12561,11900
2,2023-11-10,가정중앙시장,12996,6280,6716
2,2023-11-10,석남(거북시장),6356,3097,3259
2,2023-11-10,서부여성회관,8812,4516,4296
2,2023-11-10,인천가좌,8650,4376,4274
2,2023-11-10,가재울,8584,4381,4203
2,2023-11-10,주안국가산단,5931,2921,3010
2,2023-11-10,주안,16832,7075,9757
2,2023-11-10,시민공원(문화창작지대),20666,10724,9942
2,2023-11-10,석바위시장,9177,4404,4773
2,2023-11-10,인천시청,6898,3253,3645
2,2023-11-10,석천사거리,9733,5026,4707
2,2023-11-10,모래내시장,16347,7919,8428
2,2023-11-10,만수,10493,5454,5039
2,2023-11-10,남동구청,9579,4983,4596
2,2023-11-10,인천대공원,4995,2535,2460
2,2023-11-10,운연(서창),2571,1407,1164
2,2023-11-11,검단오류(검단산업단지),1997,1107,890
2,2023-11-11,왕길,3267,1688,1579
2,2023-11-11,검단사거리,13312,6869,6443
2,2023-11-11,마전,6022,3012,3010
2,2023-11-11,완정,10385,5396,4989
2,2023-11-11,독정,6251,3152,3099
2,2023-11-11,검암,5655,3015,2640
2,2023-11-11,검바위,3895,1888,2007
2,2023-11-11,아시아드경기장(공촌사거리),6937,3514,3423
2,2023-11-11,서구청,11264,5706,5558
2,2023-11-11,가정(루원시티),14844,7574,7270
2,2023-11-11,가정중앙시장,9907,4848,5059
2,2023-11-11,석남(거북시장),4442,2087,2355
2,2023-11-11,서부여성회관,6034,3076,2958
2,2023-11-11,인천가좌,4738,2445,2293
2,2023-11-11,가재울,4916,2508,2408
2,2023-11-11,주안국가산단,1666,812,854
2,2023-11-11,주안,13912,5721,8191
2,2023-11-11,시민공원(문화창작지대),13664,7087,6577
2,2023-11-11,석바위시장,6438,3088,3350
2,2023-11-11,인천시청,4438,2138,2300
2,2023-11-11,석천사거리,6444,3417,3027
2,2023-11-11,모래내시장,12641,6183,6458
2,2023-11-11,만수,7455,3849,3606
2,2023-11-11,남동구청,6259,3276,2983
2,2023-11-11,인천대공원,5592,2806,2786
2,2023-11-11,운연(서창),1700,872,828
2,2023-11-12,검단오류(검단산업단지),1466,704,762
2,2023-11-12,왕길,2147,1070,1077
2,2023-11-12,검단사거리,9753,4878,4875
2,2023-11-12,마전,3856,1897,1959
2,2023-11-12,완정,7130,3632,3498
2,2023-11-12,독정,3797,1880,1917
2,2023-11-12,검암,3776,1949,1827
2,2023-11-12,검바위,2823,1321,1502
2,2023-11-12,아시아드경기장(공촌사거리),4818,2524,2294
2,2023-11-12,서구청,7859,3973,3886
2,2023-11-12,가정(루원시티),10568,5391,5177
2,2023-11-12,가정중앙시장,7354,3579,3775
2,2023-11-12,석남(거북시장),3236,1536,1700
2,2023-11-12,서부여성회관,4855,2455,2400
2,2023-11-12,인천가좌,3336,1692,1644
2,2023-11-12,가재울,3557,1761,1796
2,2023-11-12,주안국가산단,774,369,405
2,2023-11-12,주안,9846,4072,5774
2,2023-11-12,시민공원(문화창작지대),10437,5292,5145
2,2023-11-12,석바위시장,4680,2326,2354
2,2023-11-12,인천시청,3514,1651,1863
2,2023-11-12,석천사거리,4511,2352,2159
2,2023-11-12,모래내시장,9583,4677,4906
2,2023-11-12,만수,5546,2892,2654
2,2023-11-12,남동구청,4331,2282,2049
2,2023-11-12,인천대공원,5041,2512,2529
2,2023-11-12,운연(서창),1287,669,618
2,2023-11-13,검단오류(검단산업단지),5988,2944,3044
2,2023-11-13,왕길,5336,2653,2683
2,2023-11-13,검단사거리,16508,8734,7774
2,2023-11-13,마전,8730,4248,4482
2,2023-11-13,완정,15295,7920,7375
2,2023-11-13,독정,8961,4519,4442
2,2023-11-13,검암,8406,4583,3823
2,2023-11-13,검바위,7217,3472,3745
2,2023-11-13,아시아드경기장(공촌사거리),9264,4917,4347
2,2023-11-13,서구청,17165,8577,8588
2,2023-11-13,가정(루원시티),23361,11948,11413
2,2023-11-13,가정중앙시장,12024,5860,6164
2,2023-11-13,석남(거북시장),6145,2976,3169
2,2023-11-13,서부여성회관,8159,4203,3956
2,2023-11-13,인천가좌,8537,4311,4226
2,2023-11-13,가재울,8330,4235,4095
2,2023-11-13,주안국가산단,5862,2853,3009
2,2023-11-13,주안,15902,6803,9099
2,2023-11-13,시민공원(문화창작지대),19953,10250,9703
2,2023-11-13,석바위시장,8703,4227,4476
2,2023-11-13,인천시청,6254,3024,3230
2,2023-11-13,석천사거리,9296,4824,4472
2,2023-11-13,모래내시장,15187,7387,7800
2,2023-11-13,만수,9863,5116,4747
2,2023-11-13,남동구청,9223,4804,4419
2,2023-11-13,인천대공원,4186,2130,2056
2,2023-11-13,운연(서창),2445,1324,1121
2,2023-11-14,검단오류(검단산업단지),6103,3022,3081
2,2023-11-14,왕길,5428,2718,2710
2,2023-11-14,검단사거리,16774,8791,7983
2,2023-11-14,마전,8708,4194,4514
2,2023-11-14,완정,15907,8225,7682
2,2023-11-14,독정,9328,4644,4684
2,2023-11-14,검암,8627,4710,3917
2,2023-11-14,검바위,7479,3567,3912
2,2023-11-14,아시아드경기장(공촌사거리),9649,5130,4519
2,2023-11-14,서구청,17495,8655,8840
2,2023-11-14,가정(루원시티),24178,12375,11803
2,2023-11-14,가정중앙시장,12424,6035,6389
2,2023-11-14,석남(거북시장),6172,2998,3174
2,2023-11-14,서부여성회관,8445,4293,4152
2,2023-11-14,인천가좌,8895,4467,4428
2,2023-11-14,가재울,8659,4429,4230
2,2023-11-14,주안국가산단,6014,2924,3090
2,2023-11-14,주안,16309,7038,9271
2,2023-11-14,시민공원(문화창작지대),20428,10492,9936
2,2023-11-14,석바위시장,8881,4302,4579
2,2023-11-14,인천시청,6857,3297,3560
2,2023-11-14,석천사거리,9487,4938,4549
2,2023-11-14,모래내시장,16340,7946,8394
2,2023-11-14,만수,10214,5275,4939
2,2023-11-14,남동구청,9678,5018,4660
2,2023-11-14,인천대공원,5013,2574,2439
2,2023-11-14,운연(서창),2607,1412,1195
2,2023-11-15,검단오류(검단산업단지),6327,3135,3192
2,2023-11-15,왕길,5686,2859,2827
2,2023-11-15,검단사거리,17864,9282,8582
2,2023-11-15,마전,9105,4437,4668
2,2023-11-15,완정,16467,8551,7916
2,2023-11-15,독정,9663,4823,4840
2,2023-11-15,검암,8954,4890,4064
2,2023-11-15,검바위,7906,3777,4129
2,2023-11-15,아시아드경기장(공촌사거리),10027,5306,4721
2,2023-11-15,서구청,18015,8896,9119
2,2023-11-15,가정(루원시티),25315,12929,12386
2,2023-11-15,가정중앙시장,13030,6323,6707
2,2023-11-15,석남(거북시장),6665,3238,3427
2,2023-11-15,서부여성회관,8652,4387,4265
2,2023-11-15,인천가좌,9134,4607,4527
2,2023-11-15,가재울,8647,4349,4298
2,2023-11-15,주안국가산단,6104,3009,3095
2,2023-11-15,주안,17051,7296,9755
2,2023-11-15,시민공원(문화창작지대),21092,10804,10288
2,2023-11-15,석바위시장,9017,4322,4695
2,2023-11-15,인천시청,7069,3383,3686
2,2023-11-15,석천사거리,9903,5169,4734
2,2023-11-15,모래내시장,17867,8743,9124
2,2023-11-15,만수,10799,5635,5164
2,2023-11-15,남동구청,9860,5154,4706
2,2023-11-15,인천대공원,5047,2540,2507
2,2023-11-15,운연(서창),2739,1451,1288
2,2023-11-16,검단오류(검단산업단지),5831,2873,2958
2,2023-11-16,왕길,4929,2479,2450
2,2023-11-16,검단사거리,15598,8140,7458
2,2023-11-16,마전,7925,3823,4102
2,2023-11-16,완정,14612,7533,7079
2,2023-11-16,독정,8068,4042,4026
2,2023-11-16,검암,8204,4433,3771
2,2023-11-16,검바위,5260,2589,2671
2,2023-11-16,아시아드경기장(공촌사거리),8317,4436,3881
2,2023-11-16,서구청,15415,7565,7850
2,2023-11-16,가정(루원시티),22499,11542,10957
2,2023-11-16,가정중앙시장,11345,5493,5852
2,2023-11-16,석남(거북시장),5733,2797,2936
2,2023-11-16,서부여성회관,7734,3929,3805
2,2023-11-16,인천가좌,8302,4174,4128
2,2023-11-16,가재울,7873,4050,3823
2,2023-11-16,주안국가산단,5845,2898,2947
2,2023-11-16,주안,15531,6587,8944
2,2023-11-16,시민공원(문화창작지대),19013,9754,9259
2,2023-11-16,석바위시장,7879,3803,4076
2,2023-11-16,인천시청,6153,2957,3196
2,2023-11-16,석천사거리,8822,4566,4256
2,2023-11-16,모래내시장,13404,6576,6828
2,2023-11-16,만수,9102,4636,4466
2,2023-11-16,남동구청,8348,4337,4011
2,2023-11-16,인천대공원,3010,1530,1480
2,2023-11-16,운연(서창),2188,1167,1021
2,2023-11-17,검단오류(검단산업단지),5800,2826,2974
2,2023-11-17,왕길,5360,2699,2661
2,2023-11-17,검단사거리,17841,9309,8532
2,2023-11-17,마전,8811,4320,4491
2,2023-11-17,완정,16330,8470,7860
2,2023-11-17,독정,9207,4616,4591
2,2023-11-17,검암,9185,5006,4179
2,2023-11-17,검바위,7260,3516,3744
2,2023-11-17,아시아드경기장(공촌사거리),9841,5239,4602
2,2023-11-17,서구청,17788,8780,9008
2,2023-11-17,가정(루원시티),24820,12635,12185
2,2023-11-17,가정중앙시장,13029,6330,6699
2,2023-11-17,석남(거북시장),6368,3106,3262
2,2023-11-17,서부여성회관,8681,4425,4256
2,2023-11-17,인천가좌,8412,4279,4133
2,2023-11-17,가재울,8573,4364,4209
2,2023-11-17,주안국가산단,5735,2824,2911
2,2023-11-17,주안,16679,7004,9675
2,2023-11-17,시민공원(문화창작지대),19896,10342,9554
2,2023-11-17,석바위시장,9082,4407,4675
2,2023-11-17,인천시청,6665,3180,3485
2,2023-11-17,석천사거리,9298,4799,4499
2,2023-11-17,모래내시장,15686,7655,8031
2,2023-11-17,만수,10258,5318,4940
2,2023-11-17,남동구청,9118,4772,4346
2,2023-11-17,인천대공원,4221,2137,2084
2,2023-11-17,운연(서창),2542,1344,1198
2,2023-11-18,검단오류(검단산업단지),2101,1133,968
2,2023-11-18,왕길,3256,1660,1596
2,2023-11-18,검단사거리,12792,6639,6153
2,2023-11-18,마전,5586,2822,2764
2,2023-11-18,완정,10266,5420,4846
2,2023-11-18,독정,6299,3152,3147
2,2023-11-18,검암,5349,2853,2496
2,2023-11-18,검바위,4002,1945,2057
2,2023-11-18,아시아드경기장(공촌사거리),6461,3315,3146
2,2023-11-18,서구청,10901,5520,5381
2,2023-11-18,가정(루원시티),14888,7650,7238
2,2023-11-18,가정중앙시장,9599,4746,4853
2,2023-11-18,석남(거북시장),4412,2058,2354
2,2023-11-18,서부여성회관,5689,2835,2854
2,2023-11-18,인천가좌,4675,2422,2253
2,2023-11-18,가재울,4533,2309,2224
2,2023-11-18,주안국가산단,1384,659,725
2,2023-11-18,주안,13044,5209,7835
2,2023-11-18,시민공원(문화창작지대),13432,6927,6505
2,2023-11-18,석바위시장,5922,2884,3038
2,2023-11-18,인천시청,4190,1979,2211
2,2023-11-18,석천사거리,5868,3062,2806
2,2023-11-18,모래내시장,12034,5869,6165
2,2023-11-18,만수,7550,3921,3629
2,2023-11-18,남동구청,5594,2883,2711
2,2023-11-18,인천대공원,4389,2187,2202
2,2023-11-18,운연(서창),1512,801,711
2,2023-11-19,검단오류(검단산업단지),1355,651,704
2,2023-11-19,왕길,2242,1156,1086
2,2023-11-19,검단사거리,9933,4970,4963
2,2023-11-19,마전,4259,2044,2215
2,2023-11-19,완정,7060,3581,3479
2,2023-11-19,독정,4839,2353,2486
2,2023-11-19,검암,3915,2069,1846
2,2023-11-19,검바위,2862,1382,1480
2,2023-11-19,아시아드경기장(공촌사거리),5074,2623,2451
2,2023-11-19,서구청,7746,3949,3797
2,2023-11-19,가정(루원시티),10550,5357,5193
2,2023-11-19,가정중앙시장,7275,3540,3735
2,2023-11-19,석남(거북시장),3387,1584,1803
2,2023-11-19,서부여성회관,4939,2541,2398
2,2023-11-19,인천가좌,3324,1691,1633
2,2023-11-19,가재울,3418,1716,1702
2,2023-11-19,주안국가산단,791,386,405
2,2023-11-19,주안,9861,4050,5811
2,2023-11-19,시민공원(문화창작지대),10334,5271,5063
2,2023-11-19,석바위시장,4901,2426,2475
2,2023-11-19,인천시청,3377,1560,1817
2,2023-11-19,석천사거리,4505,2371,2134
2,2023-11-19,모래내시장,9611,4708,4903
2,2023-11-19,만수,5696,2988,2708
2,2023-11-19,남동구청,4120,2190,1930
2,2023-11-19,인천대공원,4712,2343,2369
2,2023-11-19,운연(서창),1331,683,648
2,2023-11-20,검단오류(검단산업단지),5883,2891,2992
2,2023-11-20,왕길,5327,2671,2656
2,2023-11-20,검단사거리,16624,8725,7899
2,2023-11-20,마전,8625,4213,4412
2,2023-11-20,완정,15513,8070,7443
2,2023-11-20,독정,9234,4639,4595
2,2023-11-20,검암,8738,4727,4011
2,2023-11-20,검바위,7358,3535,3823
2,2023-11-20,아시아드경기장(공촌사거리),9680,5166,4514
2,2023-11-20,서구청,17066,8501,8565
2,2023-11-20,가정(루원시티),23820,12244,11576
2,2023-11-20,가정중앙시장,12416,6006,6410
2,2023-11-20,석남(거북시장),6303,3073,3230
2,2023-11-20,서부여성회관,8131,4190,3941
2,2023-11-20,인천가좌,8724,4417,4307
2,2023-11-20,가재울,8456,4312,4144
2,2023-11-20,주안국가산단,5863,2888,2975
2,2023-11-20,주안,16177,6974,9203
2,2023-11-20,시민공원(문화창작지대),20093,10323,9770
2,2023-11-20,석바위시장,8918,4294,4624
2,2023-11-20,인천시청,6662,3237,3425
2,2023-11-20,석천사거리,9381,4864,4517
2,2023-11-20,모래내시장,16215,7848,8367
2,2023-11-20,만수,10180,5305,4875
2,2023-11-20,남동구청,10080,5231,4849
2,2023-11-20,인천대공원,4578,2320,2258
2,2023-11-20,운연(서창),2458,1306,1152
2,2023-11-21,검단오류(검단산업단지),6035,2959,3076
2,2023-11-21,왕길,5392,2720,2672
2,2023-11-21,검단사거리,16790,8805,7985
2,2023-11-21,마전,8848,4339,4509
2,2023-11-21,완정,15995,8232,7763
2,2023-11-21,독정,9373,4708,4665
2,2023-11-21,검암,8777,4765,4012
2,2023-11-21,검바위,7640,3684,3956
2,2023-11-21,아시아드경기장(공촌사거리),9708,5152,4556
2,2023-11-21,서구청,17946,8804,9142
2,2023-11-21,가정(루원시티),24311,12489,11822
2,2023-11-21,가정중앙시장,12687,6150,6537
2,2023-11-21,석남(거북시장),6287,3052,3235
2,2023-11-21,서부여성회관,8290,4222,4068
2,2023-11-21,인천가좌,8852,4469,4383
2,2023-11-21,가재울,8725,4451,4274
2,2023-11-21,주안국가산단,6007,2946,3061
2,2023-11-21,주안,16663,7168,9495
2,2023-11-21,시민공원(문화창작지대),20726,10669,10057
2,2023-11-21,석바위시장,9044,4404,4640
2,2023-11-21,인천시청,7129,3400,3729
2,2023-11-21,석천사거리,9712,5057,4655
2,2023-11-21,모래내시장,16484,8059,8425
2,2023-11-21,만수,10372,5383,4989
2,2023-11-21,남동구청,9677,5033,4644
2,2023-11-21,인천대공원,5275,2648,2627
2,2023-11-21,운연(서창),2723,1459,1264
2,2023-11-22,검단오류(검단산업단지),6250,3106,3144
2,2023-11-22,왕길,5447,2734,2713
2,2023-11-22,검단사거리,16957,8876,8081
2,2023-11-22,마전,8896,4317,4579
2,2023-11-22,완정,15961,8272,7689
2,2023-11-22,독정,9403,4733,4670
2,2023-11-22,검암,8818,4772,4046
2,2023-11-22,검바위,7428,3583,3845
2,2023-11-22,아시아드경기장(공촌사거리),9898,5257,4641
2,2023-11-22,서구청,17523,8676,8847
2,2023-11-22,가정(루원시티),24585,12575,12010
2,2023-11-22,가정중앙시장,12504,6032,6472
2,2023-11-22,석남(거북시장),6563,3170,3393
2,2023-11-22,서부여성회관,8365,4292,4073
2,2023-11-22,인천가좌,8936,4461,4475
2,2023-11-22,가재울,8707,4473,4234
2,2023-11-22,주안국가산단,5988,2920,3068
2,2023-11-22,주안,16841,7127,9714
2,2023-11-22,시민공원(문화창작지대),20707,10637,10070
2,2023-11-22,석바위시장,9050,4398,4652
2,2023-11-22,인천시청,7015,3395,3620
2,2023-11-22,석천사거리,9613,4970,4643
2,2023-11-22,모래내시장,16105,7816,8289
2,2023-11-22,만수,10452,5387,5065
2,2023-11-22,남동구청,10056,5236,4820
2,2023-11-22,인천대공원,4905,2484,2421
2,2023-11-22,운연(서창),2621,1393,1228
2,2023-11-23,검단오류(검단산업단지),6090,2987,3103
2,2023-11-23,왕길,5524,2740,2784
2,2023-11-23,검단사거리,16765,8792,7973
2,2023-11-23,마전,8841,4300,4541
2,2023-11-23,완정,15987,8259,7728
2,2023-11-23,독정,9377,4668,4709
2,2023-11-23,검암,8785,4801,3984
2,2023-11-23,검바위,7675,3671,4004
2,2023-11-23,아시아드경기장(공촌사거리),9682,5134,4548
2,2023-11-23,서구청,17378,8607,8771
2,2023-11-23,가정(루원시티),24420,12434,11986
2,2023-11-23,가정중앙시장,12774,6208,6566
2,2023-11-23,석남(거북시장),6451,3079,3372
2,2023-11-23,서부여성회관,8425,4297,4128
2,2023-11-23,인천가좌,8773,4396,4377
2,2023-11-23,가재울,8606,4359,4247
2,2023-11-23,주안국가산단,5876,2893,2983
2,2023-11-23,주안,16602,7148,9454
2,2023-11-23,시민공원(문화창작지대),20278,10383,9895
2,2023-11-23,석바위시장,8816,4289,4527
2,2023-11-23,인천시청,7083,3387,3696
2,2023-11-23,석천사거리,9650,4994,4656
2,2023-11-23,모래내시장,16055,7811,8244
2,2023-11-23,만수,10262,5300,4962
2,2023-11-23,남동구청,9653,5028,4625
2,2023-11-23,인천대공원,4906,2476,2430
2,2023-11-23,운연(서창),2604,1409,1195
2,2023-11-24,검단오류(검단산업단지),5874,2880,2994
2,2023-11-24,왕길,5538,2799,2739
2,2023-11-24,검단사거리,17455,9134,8321
2,2023-11-24,마전,8872,4356,4516
2,2023-11-24,완정,16195,8332,7863
2,2023-11-24,독정,9290,4619,4671
2,2023-11-24,검암,8824,4852,3972
2,2023-11-24,검바위,7360,3583,3777
2,2023-11-24,아시아드경기장(공촌사거리),9610,5120,4490
2,2023-11-24,서구청,18083,8951,9132
2,2023-11-24,가정(루원시티),24518,12558,11960
2,2023-11-24,가정중앙시장,12567,6107,6460
2,2023-11-24,석남(거북시장),6441,3102,3339
2,2023-11-24,서부여성회관,8432,4291,4141
2,2023-11-24,인천가좌,8633,4390,4243
2,2023-11-24,가재울,8515,4410,4105
2,2023-11-24,주안국가산단,5687,2794,2893
2,2023-11-24,주안,16595,6932,9663
2,2023-11-24,시민공원(문화창작지대),19961,10371,9590
2,2023-11-24,석바위시장,9029,4317,4712
2,2023-11-24,인천시청,6846,3308,3538
2,2023-11-24,석천사거리,9545,4943,4602
2,2023-11-24,모래내시장,15718,7705,8013
2,2023-11-24,만수,10245,5293,4952
2,2023-11-24,남동구청,9259,4800,4459
2,2023-11-24,인천대공원,3808,1920,1888
2,2023-11-24,운연(서창),2458,1337,1121
2,2023-11-25,검단오류(검단산업단지),2016,1082,934
2,2023-11-25,왕길,3111,1567,1544
2,2023-11-25,검단사거리,12606,6507,6099
2,2023-11-25,마전,5724,2834,2890
2,2023-11-25,완정,9756,5126,4630
2,2023-11-25,독정,5848,2950,2898
2,2023-11-25,검암,5092,2708,2384
2,2023-11-25,검바위,4085,2043,2042
2,2023-11-25,아시아드경기장(공촌사거리),6635,3343,3292
2,2023-11-25,서구청,10977,5478,5499
2,2023-11-25,가정(루원시티),14630,7516,7114
2,2023-11-25,가정중앙시장,9187,4538,4649
2,2023-11-25,석남(거북시장),4362,2087,2275
2,2023-11-25,서부여성회관,5859,2996,2863
2,2023-11-25,인천가좌,4609,2381,2228
2,2023-11-25,가재울,4468,2254,2214
2,2023-11-25,주안국가산단,1472,713,759
2,2023-11-25,주안,13146,5279,7867
2,2023-11-25,시민공원(문화창작지대),13552,6940,6612
2,2023-11-25,석바위시장,5842,2851,2991
2,2023-11-25,인천시청,4320,2013,2307
2,2023-11-25,석천사거리,5688,3029,2659
2,2023-11-25,모래내시장,11920,5877,6043
2,2023-11-25,만수,6899,3499,3400
2,2023-11-25,남동구청,5304,2775,2529
2,2023-11-25,인천대공원,3967,2054,1913
2,2023-11-25,운연(서창),1512,765,747
2,2023-11-26,검단오류(검단산업단지),1346,634,712
2,2023-11-26,왕길,2139,1100,1039
2,2023-11-26,검단사거리,9345,4672,4673
2,2023-11-26,마전,4076,2024,2052
2,2023-11-26,완정,6847,3432,3415
2,2023-11-26,독정,3995,1982,2013
2,2023-11-26,검암,3456,1809,1647
2,2023-11-26,검바위,2815,1299,1516
2,2023-11-26,아시아드경기장(공촌사거리),5237,2730,2507
2,2023-11-26,서구청,7786,3981,3805
2,2023-11-26,가정(루원시티),10027,5122,4905
2,2023-11-26,가정중앙시장,7108,3524,3584
2,2023-11-26,석남(거북시장),3331,1555,1776
2,2023-11-26,서부여성회관,4736,2401,2335
2,2023-11-26,인천가좌,3267,1652,1615
2,2023-11-26,가재울,3310,1665,1645
2,2023-11-26,주안국가산단,689,341,348
2,2023-11-26,주안,9357,3841,5516
2,2023-11-26,시민공원(문화창작지대),9863,5020,4843
2,2023-11-26,석바위시장,4631,2220,2411
2,2023-11-26,인천시청,3307,1537,1770
2,2023-11-26,석천사거리,4463,2347,2116
2,2023-11-26,모래내시장,9295,4601,4694
2,2023-11-26,만수,5644,2912,2732
2,2023-11-26,남동구청,4142,2135,2007
2,2023-11-26,인천대공원,4232,2112,2120
2,2023-11-26,운연(서창),1224,657,567
2,2023-11-27,검단오류(검단산업단지),5837,2862,2975
2,2023-11-27,왕길,5338,2662,2676
2,2023-11-27,검단사거리,16216,8510,7706
2,2023-11-27,마전,8673,4226,4447
2,2023-11-27,완정,15427,8014,7413
2,2023-11-27,독정,8945,4521,4424
2,2023-11-27,검암,8330,4573,3757
2,2023-11-27,검바위,7058,3426,3632
2,2023-11-27,아시아드경기장(공촌사거리),9096,4864,4232
2,2023-11-27,서구청,16544,8238,8306
2,2023-11-27,가정(루원시티),23153,11884,11269
2,2023-11-27,가정중앙시장,11484,5525,5959
2,2023-11-27,석남(거북시장),5951,2887,3064
2,2023-11-27,서부여성회관,7686,3924,3762
2,2023-11-27,인천가좌,8374,4222,4152
2,2023-11-27,가재울,8096,4127,3969
2,2023-11-27,주안국가산단,5792,2864,2928
2,2023-11-27,주안,15747,6807,8940
2,2023-11-27,시민공원(문화창작지대),19591,10082,9509
2,2023-11-27,석바위시장,8455,4119,4336
2,2023-11-27,인천시청,6279,3001,3278
2,2023-11-27,석천사거리,9092,4788,4304
2,2023-11-27,모래내시장,14778,7168,7610
2,2023-11-27,만수,9521,4887,4634
2,2023-11-27,남동구청,8784,4578,4206
2,2023-11-27,인천대공원,3033,1561,1472
2,2023-11-27,운연(서창),2310,1244,1066
2,2023-11-28,검단오류(검단산업단지),5998,2997,3001
2,2023-11-28,왕길,5329,2668,2661
2,2023-11-28,검단사거리,16642,8724,7918
2,2023-11-28,마전,8927,4398,4529
2,2023-11-28,완정,15647,8076,7571
2,2023-11-28,독정,9170,4610,4560
2,2023-11-28,검암,8461,4564,3897
2,2023-11-28,검바위,7302,3518,3784
2,2023-11-28,아시아드경기장(공촌사거리),9525,5033,4492
2,2023-11-28,서구청,17111,8555,8556
2,2023-11-28,가정(루원시티),24000,12227,11773
2,2023-11-28,가정중앙시장,11813,5727,6086
2,2023-11-28,석남(거북시장),6153,3013,3140
2,2023-11-28,서부여성회관,8153,4182,3971
2,2023-11-28,인천가좌,8793,4398,4395
2,2023-11-28,가재울,8581,4384,4197
2,2023-11-28,주안국가산단,5991,2930,3061
2,2023-11-28,주안,16287,7000,9287
2,2023-11-28,시민공원(문화창작지대),20204,10389,9815
2,2023-11-28,석바위시장,8931,4316,4615
2,2023-11-28,인천시청,6904,3286,3618
2,2023-11-28,석천사거리,9592,4996,4596
2,2023-11-28,모래내시장,15668,7694,7974
2,2023-11-28,만수,9988,5094,4894
2,2023-11-28,남동구청,9299,4800,4499
2,2023-11-28,인천대공원,4354,2199,2155
2,2023-11-28,운연(서창),2546,1386,1160
2,2023-11-29,검단오류(검단산업단지),6068,3014,3054
2,2023-11-29,왕길,5293,2675,2618
2,2023-11-29,검단사거리,16730,8731,7999
2,2023-11-29,마전,8900,4280,4620
2,2023-11-29,완정,15779,8134,7645
2,2023-11-29,독정,9269,4585,4684
2,2023-11-29,검암,8496,4614,3882
2,2023-11-29,검바위,7502,3629,3873
2,2023-11-29,아시아드경기장(공촌사거리),9697,5167,4530
2,2023-11-29,서구청,16903,8468,8435
2,2023-11-29,가정(루원시티),24152,12292,11860
2,2023-11-29,가정중앙시장,12047,5778,6269
2,2023-11-29,석남(거북시장),6184,2965,3219
2,2023-11-29,서부여성회관,8307,4242,4065
2,2023-11-29,인천가좌,8721,4369,4352
2,2023-11-29,가재울,8542,4366,4176
2,2023-11-29,주안국가산단,5889,2870,3019
2,2023-11-29,주안,16396,6992,9404
2,2023-11-29,시민공원(문화창작지대),20819,10652,10167
2,2023-11-29,석바위시장,9142,4438,4704
2,2023-11-29,인천시청,6794,3279,3515
2,2023-11-29,석천사거리,9663,5023,4640
2,2023-11-29,모래내시장,15577,7564,8013
2,2023-11-29,만수,10261,5314,4947
2,2023-11-29,남동구청,9212,4822,4390
2,2023-11-29,인천대공원,4152,2054,2098
2,2023-11-29,운연(서창),2574,1391,1183
2,2023-11-30,검단오류(검단산업단지),5836,2894,2942
2,2023-11-30,왕길,5257,2627,2630
2,2023-11-30,검단사거리,16209,8478,7731
2,2023-11-30,마전,8581,4161,4420
2,2023-11-30,완정,15143,7802,7341
2,2023-11-30,독정,8903,4492,4411
2,2023-11-30,검암,8257,4526,3731
2,2023-11-30,검바위,6845,3283,3562
2,2023-11-30,아시아드경기장(공촌사거리),9361,4951,4410
2,2023-11-30,서구청,16328,8143,8185
2,2023-11-30,가정(루원시티),23174,11770,11404
2,2023-11-30,가정중앙시장,11769,5697,6072
2,2023-11-30,석남(거북시장),5886,2869,3017
2,2023-11-30,서부여성회관,7895,4017,3878
2,2023-11-30,인천가좌,8388,4235,4153
2,2023-11-30,가재울,8164,4180,3984
2,2023-11-30,주안국가산단,5771,2821,2950
2,2023-11-30,주안,15559,6736,8823
2,2023-11-30,시민공원(문화창작지대),19743,10111,9632
2,2023-11-30,석바위시장,8243,3931,4312
2,2023-11-30,인천시청,6435,3080,3355
2,2023-11-30,석천사거리,9124,4688,4436
2,2023-11-30,모래내시장,14578,7132,7446
2,2023-11-30,만수,9757,5030,4727
2,2023-11-30,남동구청,8699,4450,4249
2,2023-11-30,인천대공원,3553,1794,1759
2,2023-11-30,운연(서창),2391,1285,1106
2,2023-12-01,검단오류(검단산업단지),5782,2890,2892
2,2023-12-01,왕길,5305,2665,2640
2,2023-12-01,검단사거리,17134,8975,8159
2,2023-12-01,마전,8636,4235,4401
2,2023-12-01,완정,15596,8134,7462
2,2023-12-01,독정,9200,4636,4564
2,2023-12-01,검암,8439,4611,3828
2,2023-12-01,검바위,6171,2945,3226
2,2023-12-01,아시아드경기장(공촌사거리),9447,5019,4428
2,2023-12-01,서구청,17227,8502,8725
2,2023-12-01,가정(루원시티),23827,12179,11648
2,2023-12-01,가정중앙시장,12371,5972,6399
2,2023-12-01,석남(거북시장),6165,2982,3183
2,2023-12-01,서부여성회관,8399,4246,4153
2,2023-12-01,인천가좌,8537,4338,4199
2,2023-12-01,가재울,8527,4422,4105
2,2023-12-01,주안국가산단,5714,2823,2891
2,2023-12-01,주안,16500,6964,9536
2,2023-12-01,시민공원(문화창작지대),19923,10274,9649
2,2023-12-01,석바위시장,9013,4365,4648
2,2023-12-01,인천시청,6795,3219,3576
2,2023-12-01,석천사거리,9329,4876,4453
2,2023-12-01,모래내시장,15802,7648,8154
2,2023-12-01,만수,10283,5316,4967
2,2023-12-01,남동구청,9195,4844,4351
2,2023-12-01,인천대공원,3868,1968,1900
2,2023-12-01,운연(서창),2449,1324,1125
2,2023-12-02,검단오류(검단산업단지),1897,1064,833
2,2023-12-02,왕길,3166,1653,1513
2,2023-12-02,검단사거리,12988,6741,6247
2,2023-12-02,마전,5729,2901,2828
2,2023-12-02,완정,10421,5413,5008
2,2023-12-02,독정,6197,3124,3073
2,2023-12-02,검암,5355,2897,2458
2,2023-12-02,검바위,3798,1856,1942
2,2023-12-02,아시아드경기장(공촌사거리),7037,3606,3431
2,2023-12-02,서구청,11569,5841,5728
2,2023-12-02,가정(루원시티),14898,7643,7255
2,2023-12-02,가정중앙시장,9863,4846,5017
2,2023-12-02,석남(거북시장),4524,2117,2407
2,2023-12-02,서부여성회관,5992,3052,2940
2,2023-12-02,인천가좌,4939,2517,2422
2,2023-12-02,가재울,4740,2401,2339
2,2023-12-02,주안국가산단,1356,683,673
2,2023-12-02,주안,14099,5710,8389
2,2023-12-02,시민공원(문화창작지대),13940,7194,6746
2,2023-12-02,석바위시장,6421,3126,3295
2,2023-12-02,인천시청,4589,2216,2373
2,2023-12-02,석천사거리,5914,3118,2796
2,2023-12-02,모래내시장,12546,6151,6395
2,2023-12-02,만수,7463,3870,3593
2,2023-12-02,남동구청,5767,3036,2731
2,2023-12-02,인천대공원,4487,2276,2211
2,2023-12-02,운연(서창),1679,870,809
2,2023-12-03,검단오류(검단산업단지),1324,630,694
2,2023-12-03,왕길,2159,1102,1057
2,2023-12-03,검단사거리,9798,4855,4943
2,2023-12-03,마전,4093,1971,2122
2,2023-12-03,완정,7108,3611,3497
2,2023-12-03,독정,4615,2300,2315
2,2023-12-03,검암,3861,2053,1808
2,2023-12-03,검바위,2978,1377,1601
2,2023-12-03,아시아드경기장(공촌사거리),5383,2802,2581
2,2023-12-03,서구청,7858,3943,3915
2,2023-12-03,가정(루원시티),10650,5407,5243
2,2023-12-03,가정중앙시장,7090,3524,3566
2,2023-12-03,석남(거북시장),3336,1537,1799
2,2023-12-03,서부여성회관,4955,2557,2398
2,2023-12-03,인천가좌,3267,1636,1631
2,2023-12-03,가재울,3481,1753,1728
2,2023-12-03,주안국가산단,740,359,381
2,2023-12-03,주안,9412,3814,5598
2,2023-12-03,시민공원(문화창작지대),10663,5495,5168
2,2023-12-03,석바위시장,4963,2377,2586
2,2023-12-03,인천시청,3546,1666,1880
2,2023-12-03,석천사거리,4480,2337,2143
2,2023-12-03,모래내시장,9773,4786,4987
2,2023-12-03,만수,5556,2821,2735
2,2023-12-03,남동구청,4252,2227,2025
2,2023-12-03,인천대공원,4601,2313,2288
2,2023-12-03,운연(서창),1322,700,622
2,2023-12-04,검단오류(검단산업단지),5904,2892,3012
2,2023-12-04,왕길,5314,2674,2640
2,2023-12-04,검단사거리,16581,8728,7853
2,2023-12-04,마전,8466,4146,4320
2,2023-12-04,완정,15409,7911,7498
2,2023-12-04,독정,9142,4577,4565
2,2023-12-04,검암,8569,4660,3909
2,2023-12-04,검바위,6884,3347,3537
2,2023-12-04,아시아드경기장(공촌사거리),9516,5016,4500
2,2023-12-04,서구청,16778,8335,8443
2,2023-12-04,가정(루원시티),23201,11923,11278
2,2023-12-04,가정중앙시장,12014,5859,6155
2,2023-12-04,석남(거북시장),6363,3040,3323
2,2023-12-04,서부여성회관,7934,4032,3902
2,2023-12-04,인천가좌,8562,4343,4219
2,2023-12-04,가재울,8420,4305,4115
2,2023-12-04,주안국가산단,5816,2862,2954
2,2023-12-04,주안,15662,6720,8942
2,2023-12-04,시민공원(문화창작지대),20114,10313,9801
2,2023-12-04,석바위시장,8890,4286,4604
2,2023-12-04,인천시청,6520,3112,3408
2,2023-12-04,석천사거리,9430,4933,4497
2,2023-12-04,모래내시장,15950,7682,8268
2,2023-12-04,만수,9961,5130,4831
2,2023-12-04,남동구청,9230,4820,4410
2,2023-12-04,인천대공원,4530,2295,2235
2,2023-12-04,운연(서창),2482,1296,1186
2,2023-12-05,검단오류(검단산업단지),6037,2993,3044
2,2023-12-05,왕길,5376,2710,2666
2,2023-12-05,검단사거리,16965,8857,8108
2,2023-12-05,마전,8682,4196,4486
2,2023-12-05,완정,15793,8121,7672
2,2023-12-05,독정,9070,4547,4523
2,2023-12-05,검암,8684,4675,4009
2,2023-12-05,검바위,7150,3449,3701
2,2023-12-05,아시아드경기장(공촌사거리),9734,5128,4606
2,2023-12-05,서구청,17389,8712,8677
2,2023-12-05,가정(루원시티),23944,12245,11699
2,2023-12-05,가정중앙시장,12684,6186,6498
2,2023-12-05,석남(거북시장),6320,3076,3244
2,2023-12-05,서부여성회관,8201,4179,4022
2,2023-12-05,인천가좌,8723,4391,4332
2,2023-12-05,가재울,8673,4465,4208
2,2023-12-05,주안국가산단,5967,2935,3032
2,2023-12-05,주안,16151,6944,9207
2,2023-12-05,시민공원(문화창작지대),20339,10437,9902
2,2023-12-05,석바위시장,9096,4421,4675
2,2023-12-05,인천시청,6788,3258,3530
2,2023-12-05,석천사거리,9603,5018,4585
2,2023-12-05,모래내시장,16317,7974,8343
2,2023-12-05,만수,10244,5262,4982
2,2023-12-05,남동구청,9417,4883,4534
2,2023-12-05,인천대공원,4926,2503,2423
2,2023-12-05,운연(서창),2544,1361,1183
2,2023-12-06,검단오류(검단산업단지),6075,2993,3082
2,2023-12-06,왕길,5188,2596,2592
2,2023-12-06,검단사거리,16407,8616,7791
2,2023-12-06,마전,8417,4138,4279
2,2023-12-06,완정,15692,8070,7622
2,2023-12-06,독정,8844,4456,4388
2,2023-12-06,검암,8374,4574,3800
2,2023-12-06,검바위,6946,3338,3608
2,2023-12-06,아시아드경기장(공촌사거리),9463,4981,4482
2,2023-12-06,서구청,16817,8360,8457
2,2023-12-06,가정(루원시티),23790,12197,11593
2,2023-12-06,가정중앙시장,11748,5714,6034
2,2023-12-06,석남(거북시장),6181,2986,3195
2,2023-12-06,서부여성회관,8169,4141,4028
2,2023-12-06,인천가좌,8484,4251,4233
2,2023-12-06,가재울,8583,4394,4189
2,2023-12-06,주안국가산단,5378,2634,2744
2,2023-12-06,주안,15693,6712,8981
2,2023-12-06,시민공원(문화창작지대),19892,10151,9741
2,2023-12-06,석바위시장,8906,4279,4627
2,2023-12-06,인천시청,6723,3245,3478
2,2023-12-06,석천사거리,9404,4863,4541
2,2023-12-06,모래내시장,15060,7381,7679
2,2023-12-06,만수,10122,5206,4916
2,2023-12-06,남동구청,9051,4747,4304
2,2023-12-06,인천대공원,3699,1835,1864
2,2023-12-06,운연(서창),2445,1331,1114
2,2023-12-07,검단오류(검단산업단지),6050,2969,3081
2,2023-12-07,왕길,5363,2671,2692
2,2023-12-07,검단사거리,16836,8832,8004
2,2023-12-07,마전,8943,4318,4625
2,2023-12-07,완정,15796,8162,7634
2,2023-12-07,독정,9126,4606,4520
2,2023-12-07,검암,8682,4697,3985
2,2023-12-07,검바위,7134,3441,3693
2,2023-12-07,아시아드경기장(공촌사거리),9514,5010,4504
2,2023-12-07,서구청,17687,8766,8921
2,2023-12-07,가정(루원시티),24044,12325,11719
2,2023-12-07,가정중앙시장,12456,6054,6402
2,2023-12-07,석남(거북시장),6439,3116,3323
2,2023-12-07,서부여성회관,8494,4341,4153
2,2023-12-07,인천가좌,8759,4421,4338
2,2023-12-07,가재울,8595,4382,4213
2,2023-12-07,주안국가산단,5801,2851,2950
2,2023-12-07,주안,16170,6847,9323
2,2023-12-07,시민공원(문화창작지대),20256,10398,9858
2,2023-12-07,석바위시장,9041,4395,4646
2,2023-12-07,인천시청,6939,3301,3638
2,2023-12-07,석천사거리,9464,4928,4536
2,2023-12-07,모래내시장,15880,7709,8171
2,2023-12-07,만수,10432,5380,5052
2,2023-12-07,남동구청,9392,4954,4438
2,2023-12-07,인천대공원,4683,2372,2311
2,2023-12-07,운연(서창),2578,1376,1202
2,2023-12-08,검단오류(검단산업단지),5937,2886,3051
2,2023-12-08,왕길,5381,2730,2651
2,2023-12-08,검단사거리,17851,9423,8428
2,2023-12-08,마전,8838,4347,4491
2,2023-12-08,완정,16321,8469,7852
2,2023-12-08,독정,9497,4801,4696
2,2023-12-08,검암,8908,4891,4017
2,2023-12-08,검바위,7551,3685,3866
2,2023-12-08,아시아드경기장(공촌사거리),9652,5105,4547
2,2023-12-08,서구청,19020,9355,9665
2,2023-12-08,가정(루원시티),24910,12919,11991
2,2023-12-08,가정중앙시장,13047,6373,6674
2,2023-12-08,석남(거북시장),6570,3171,3399
2,2023-12-08,서부여성회관,8785,4493,4292
2,2023-12-08,인천가좌,8800,4445,4355
2,2023-12-08,가재울,8667,4437,4230
2,2023-12-08,주안국가산단,5619,2703,2916
2,2023-12-08,주안,16906,7106,9800
2,2023-12-08,시민공원(문화창작지대),20623,10510,10113
2,2023-12-08,석바위시장,9462,4556,4906
2,2023-12-08,인천시청,7546,3559,3987
2,2023-12-08,석천사거리,9913,5192,4721
2,2023-12-08,모래내시장,16603,8100,8503
2,2023-12-08,만수,10679,5539,5140
2,2023-12-08,남동구청,9707,5087,4620
2,2023-12-08,인천대공원,5029,2549,2480
2,2023-12-08,운연(서창),2599,1389,1210
2,2023-12-09,검단오류(검단산업단지),2139,1140,999
2,2023-12-09,왕길,3233,1676,1557
2,2023-12-09,검단사거리,13826,7233,6593
2,2023-12-09,마전,5885,2996,2889
2,2023-12-09,완정,11043,5718,5325
2,2023-12-09,독정,6168,3110,3058
2,2023-12-09,검암,5627,3027,2600
2,2023-12-09,검바위,4026,2012,2014
2,2023-12-09,아시아드경기장(공촌사거리),6971,3634,3337
2,2023-12-09,서구청,12014,5977,6037
2,2023-12-09,가정(루원시티),15751,8088,7663
2,2023-12-09,가정중앙시장,10494,5172,5322
2,2023-12-09,석남(거북시장),4826,2346,2480
2,2023-12-09,서부여성회관,6373,3315,3058
2,2023-12-09,인천가좌,5017,2578,2439
2,2023-12-09,가재울,5041,2587,2454
2,2023-12-09,주안국가산단,1499,736,763
2,2023-12-09,주안,14100,5598,8502
2,2023-12-09,시민공원(문화창작지대),14951,7649,7302
2,2023-12-09,석바위시장,6662,3276,3386
2,2023-12-09,인천시청,4944,2350,2594
2,2023-12-09,석천사거리,6462,3474,2988
2,2023-12-09,모래내시장,13339,6491,6848
2,2023-12-09,만수,7709,3997,3712
2,2023-12-09,남동구청,6061,3178,2883
2,2023-12-09,인천대공원,5051,2538,2513
2,2023-12-09,운연(서창),1826,976,850
2,2023-12-10,검단오류(검단산업단지),1296,625,671
2,2023-12-10,왕길,1997,1026,971
2,2023-12-10,검단사거리,9805,4934,4871
2,2023-12-10,마전,3940,1907,2033
2,2023-12-10,완정,7351,3694,3657
2,2023-12-10,독정,4003,1970,2033
2,2023-12-10,검암,3983,2097,1886
2,2023-12-10,검바위,2832,1343,1489
2,2023-12-10,아시아드경기장(공촌사거리),5287,2697,2590
2,2023-12-10,서구청,8271,4179,4092
2,2023-12-10,가정(루원시티),10515,5350,5165
2,2023-12-10,가정중앙시장,7601,3763,3838
2,2023-12-10,석남(거북시장),3391,1543,1848
2,2023-12-10,서부여성회관,5283,2716,2567
2,2023-12-10,인천가좌,3391,1697,1694
2,2023-12-10,가재울,3592,1788,1804
2,2023-12-10,주안국가산단,781,392,389
2,2023-12-10,주안,9864,4054,5810
2,2023-12-10,시민공원(문화창작지대),10621,5463,5158
2,2023-12-10,석바위시장,5305,2545,2760
2,2023-12-10,인천시청,3815,1807,2008
2,2023-12-10,석천사거리,4617,2428,2189
2,2023-12-10,모래내시장,10032,4934,5098
2,2023-12-10,만수,5921,3060,2861
2,2023-12-10,남동구청,4711,2487,2224
2,2023-12-10,인천대공원,5775,2877,2898
2,2023-12-10,운연(서창),1357,681,676
2,2023-12-11,검단오류(검단산업단지),5597,2739,2858
2,2023-12-11,왕길,5016,2526,2490
2,2023-12-11,검단사거리,15519,8152,7367
2,2023-12-11,마전,8149,3927,4222
2,2023-12-11,완정,14717,7562,7155
2,2023-12-11,독정,8544,4323,4221
2,2023-12-11,검암,8242,4471,3771
2,2023-12-11,검바위,6584,3157,3427
2,2023-12-11,아시아드경기장(공촌사거리),8768,4648,4120
2,2023-12-11,서구청,16143,8004,8139
2,2023-12-11,가정(루원시티),22153,11338,10815
2,2023-12-11,가정중앙시장,10969,5324,5645
2,2023-12-11,석남(거북시장),5834,2806,3028
2,2023-12-11,서부여성회관,7494,3800,3694
2,2023-12-11,인천가좌,8048,4049,3999
2,2023-12-11,가재울,7879,4039,3840
2,2023-12-11,주안국가산단,5692,2795,2897
2,2023-12-11,주안,14259,5967,8292
2,2023-12-11,시민공원(문화창작지대),18908,9754,9154
2,2023-12-11,석바위시장,8382,4088,4294
2,2023-12-11,인천시청,6158,2965,3193
2,2023-12-11,석천사거리,9087,4700,4387
2,2023-12-11,모래내시장,13828,6720,7108
2,2023-12-11,만수,9501,4903,4598
2,2023-12-11,남동구청,8638,4511,4127
2,2023-12-11,인천대공원,2630,1319,1311
2,2023-12-11,운연(서창),2256,1221,1035
2,2023-12-12,검단오류(검단산업단지),6054,2980,3074
2,2023-12-12,왕길,5271,2648,2623
2,2023-12-12,검단사거리,16901,8855,8046
2,2023-12-12,마전,8757,4235,4522
2,2023-12-12,완정,15974,8204,7770
2,2023-12-12,독정,9023,4499,4524
2,2023-12-12,검암,8774,4772,4002
2,2023-12-12,검바위,7103,3429,3674
2,2023-12-12,아시아드경기장(공촌사거리),9294,4913,4381
2,2023-12-12,서구청,17517,8743,8774
2,2023-12-12,가정(루원시티),23713,12188,11525
2,2023-12-12,가정중앙시장,12314,5943,6371
2,2023-12-12,석남(거북시장),6191,2973,3218
2,2023-12-12,서부여성회관,8077,4133,3944
2,2023-12-12,인천가좌,8828,4482,4346
2,2023-12-12,가재울,8519,4417,4102
2,2023-12-12,주안국가산단,5924,2895,3029
2,2023-12-12,주안,15560,6683,8877
2,2023-12-12,시민공원(문화창작지대),19910,10170,9740
2,2023-12-12,석바위시장,9231,4479,4752
2,2023-12-12,인천시청,6691,3242,3449
2,2023-12-12,석천사거리,9778,5063,4715
2,2023-12-12,모래내시장,16221,7920,8301
2,2023-12-12,만수,10395,5360,5035
2,2023-12-12,남동구청,9520,4979,4541
2,2023-12-12,인천대공원,4249,2165,2084
2,2023-12-12,운연(서창),2649,1409,1240
2,2023-12-13,검단오류(검단산업단지),6129,3028,3101
2,2023-12-13,왕길,5311,2693,2618
2,2023-12-13,검단사거리,16908,8776,8132
2,2023-12-13,마전,8847,4342,4505
2,2023-12-13,완정,16299,8387,7912
2,2023-12-13,독정,9094,4525,4569
2,2023-12-13,검암,8830,4743,4087
2,2023-12-13,검바위,7356,3624,3732
2,2023-12-13,아시아드경기장(공촌사거리),9816,5206,4610
2,2023-12-13,서구청,17556,8683,8873
2,2023-12-13,가정(루원시티),24171,12328,11843
2,2023-12-13,가정중앙시장,12609,6163,6446
2,2023-12-13,석남(거북시장),6291,3064,3227
2,2023-12-13,서부여성회관,8236,4181,4055
2,2023-12-13,인천가좌,8880,4496,4384
2,2023-12-13,가재울,8567,4347,4220
2,2023-12-13,주안국가산단,5927,2906,3021
2,2023-12-13,주안,15901,6761,9140
2,2023-12-13,시민공원(문화창작지대),20677,10614,10063
2,2023-12-13,석바위시장,9341,4552,4789
2,2023-12-13,인천시청,7079,3347,3732
2,2023-12-13,석천사거리,9781,5010,4771
2,2023-12-13,모래내시장,16331,7936,8395
2,2023-12-13,만수,10558,5485,5073
2,2023-12-13,남동구청,9485,4933,4552
2,2023-12-13,인천대공원,4631,2342,2289
2,2023-12-13,운연(서창),2583,1413,1170
2,2023-12-14,검단오류(검단산업단지),5855,2845,3010
2,2023-12-14,왕길,4980,2457,2523
2,2023-12-14,검단사거리,15819,8341,7478
2,2023-12-14,마전,8479,4154,4325
2,2023-12-14,완정,15333,7868,7465
2,2023-12-14,독정,8620,4341,4279
2,2023-12-14,검암,8578,4662,3916
2,2023-12-14,검바위,6936,3369,3567
2,2023-12-14,아시아드경기장(공촌사거리),9061,4795,4266
2,2023-12-14,서구청,16143,8005,8138
2,2023-12-14,가정(루원시티),23287,11961,11326
2,2023-12-14,가정중앙시장,11250,5457,5793
2,2023-12-14,석남(거북시장),5776,2753,3023
2,2023-12-14,서부여성회관,7812,3919,3893
2,2023-12-14,인천가좌,8511,4258,4253
2,2023-12-14,가재울,8105,4161,3944
2,2023-12-14,주안국가산단,5807,2825,2982
2,2023-12-14,주안,14720,6199,8521
2,2023-12-14,시민공원(문화창작지대),19510,10052,9458
2,2023-12-14,석바위시장,8496,4133,4363
2,2023-12-14,인천시청,6272,2994,3278
2,2023-12-14,석천사거리,9207,4740,4467
2,2023-12-14,모래내시장,14149,6891,7258
2,2023-12-14,만수,9337,4833,4504
2,2023-12-14,남동구청,8451,4398,4053
2,2023-12-14,인천대공원,2830,1439,1391
2,2023-12-14,운연(서창),2331,1264,1067
2,2023-12-15,검단오류(검단산업단지),5584,2665,2919
2,2023-12-15,왕길,5204,2595,2609
2,2023-12-15,검단사거리,16927,8906,8021
2,2023-12-15,마전,8759,4331,4428
2,2023-12-15,완정,16237,8499,7738
2,2023-12-15,독정,8812,4389,4423
2,2023-12-15,검암,8638,4810,3828
2,2023-12-15,검바위,7057,3498,3559
2,2023-12-15,아시아드경기장(공촌사거리),8953,4677,4276
2,2023-12-15,서구청,17054,8423,8631
2,2023-12-15,가정(루원시티),23920,12324,11596
2,2023-12-15,가정중앙시장,11914,5786,6128
2,2023-12-15,석남(거북시장),5885,2868,3017
2,2023-12-15,서부여성회관,8149,4167,3982
2,2023-12-15,인천가좌,8337,4164,4173
2,2023-12-15,가재울,8215,4195,4020
2,2023-12-15,주안국가산단,5525,2622,2903
2,2023-12-15,주안,16010,6738,9272
2,2023-12-15,시민공원(문화창작지대),19589,10121,9468
2,2023-12-15,석바위시장,8733,4279,4454
2,2023-12-15,인천시청,6716,3191,3525
2,2023-12-15,석천사거리,9427,4973,4454
2,2023-12-15,모래내시장,14642,7143,7499
2,2023-12-15,만수,9669,5098,4571
2,2023-12-15,남동구청,8610,4461,4149
2,2023-12-15,인천대공원,2703,1374,1329
2,2023-12-15,운연(서창),2292,1233,1059
2,2023-12-16,검단오류(검단산업단지),2039,1101,938
2,2023-12-16,왕길,2925,1511,1414
2,2023-12-16,검단사거리,13613,7084,6529
2,2023-12-16,마전,6229,3114,3115
2,2023-12-16,완정,11131,5873,5258
2,2023-12-16,독정,6032,3053,2979
2,2023-12-16,검암,5744,3168,2576
2,2023-12-16,검바위,3947,1924,2023
2,2023-12-16,아시아드경기장(공촌사거리),6566,3319,3247
2,2023-12-16,서구청,11810,5888,5922
2,2023-12-16,가정(루원시티),15596,8052,7544
2,2023-12-16,가정중앙시장,10301,5102,5199
2,2023-12-16,석남(거북시장),4609,2207,2402
2,2023-12-16,서부여성회관,6113,3103,3010
2,2023-12-16,인천가좌,4808,2470,2338
2,2023-12-16,가재울,4792,2422,2370
2,2023-12-16,주안국가산단,1470,720,750
2,2023-12-16,주안,13819,5460,8359
2,2023-12-16,시민공원(문화창작지대),14781,7630,7151
2,2023-12-16,석바위시장,6710,3294,3416
2,2023-12-16,인천시청,4618,2124,2494
2,2023-12-16,석천사거리,6260,3219,3041
2,2023-12-16,모래내시장,12491,6119,6372
2,2023-12-16,만수,7492,3901,3591
2,2023-12-16,남동구청,5916,3028,2888
2,2023-12-16,인천대공원,3262,1664,1598
2,2023-12-16,운연(서창),1649,869,780
2,2023-12-17,검단오류(검단산업단지),1129,559,570
2,2023-12-17,왕길,1737,879,858
2,2023-12-17,검단사거리,9226,4561,4665
2,2023-12-17,마전,4073,1937,2136
2,2023-12-17,완정,6795,3477,3318
2,2023-12-17,독정,4054,1998,2056
2,2023-12-17,검암,3538,1830,1708
2,2023-12-17,검바위,2703,1293,1410
2,2023-12-17,아시아드경기장(공촌사거리),4736,2419,2317
2,2023-12-17,서구청,7423,3776,3647
2,2023-12-17,가정(루원시티),9491,4787,4704
2,2023-12-17,가정중앙시장,6572,3204,3368
2,2023-12-17,석남(거북시장),3148,1534,1614
2,2023-12-17,서부여성회관,4560,2353,2207
2,2023-12-17,인천가좌,3039,1520,1519
2,2023-12-17,가재울,3169,1606,1563
2,2023-12-17,주안국가산단,694,333,361
2,2023-12-17,주안,8643,3486,5157
2,2023-12-17,시민공원(문화창작지대),9528,4855,4673
2,2023-12-17,석바위시장,4799,2337,2462
2,2023-12-17,인천시청,2999,1439,1560
2,2023-12-17,석천사거리,4258,2181,2077
2,2023-12-17,모래내시장,8118,3976,4142
2,2023-12-17,만수,5164,2626,2538
2,2023-12-17,남동구청,3749,1925,1824
2,2023-12-17,인천대공원,2613,1311,1302
2,2023-12-17,운연(서창),1080,557,523
2,2023-12-18,검단오류(검단산업단지),5737,2773,2964
2,2023-12-18,왕길,4940,2483,2457
2,2023-12-18,검단사거리,15706,8230,7476
2,2023-12-18,마전,8291,3994,4297
2,2023-12-18,완정,14901,7705,7196
2,2023-12-18,독정,8216,4109,4107
2,2023-12-18,검암,8203,4503,3700
2,2023-12-18,검바위,6473,3128,3345
2,2023-12-18,아시아드경기장(공촌사거리),8794,4672,4122
2,2023-12-18,서구청,15549,7793,7756
2,2023-12-18,가정(루원시티),22225,11374,10851
2,2023-12-18,가정중앙시장,11135,5454,5681
2,2023-12-18,석남(거북시장),5648,2797,2851
2,2023-12-18,서부여성회관,7615,3850,3765
2,2023-12-18,인천가좌,8269,4218,4051
2,2023-12-18,가재울,7822,4004,3818
2,2023-12-18,주안국가산단,5787,2849,2938
2,2023-12-18,주안,14559,6214,8345
2,2023-12-18,시민공원(문화창작지대),19240,9850,9390
2,2023-12-18,석바위시장,8503,4106,4397
2,2023-12-18,인천시청,6152,2974,3178
2,2023-12-18,석천사거리,9104,4746,4358
2,2023-12-18,모래내시장,14524,7053,7471
2,2023-12-18,만수,9434,4938,4496
2,2023-12-18,남동구청,8234,4247,3987
2,2023-12-18,인천대공원,3311,1683,1628
2,2023-12-18,운연(서창),2218,1181,1037
2,2023-12-19,검단오류(검단산업단지),6028,2987,3041
2,2023-12-19,왕길,5207,2591,2616
2,2023-12-19,검단사거리,16473,8603,7870
2,2023-12-19,마전,8640,4193,4447
2,2023-12-19,완정,15638,8000,7638
2,2023-12-19,독정,8750,4353,4397
2,2023-12-19,검암,8610,4606,4004
2,2023-12-19,검바위,6882,3406,3476
2,2023-12-19,아시아드경기장(공촌사거리),9236,4875,4361
2,2023-12-19,서구청,16998,8374,8624
2,2023-12-19,가정(루원시티),23829,12168,11661
2,2023-12-19,가정중앙시장,12366,5998,6368
2,2023-12-19,석남(거북시장),5957,2908,3049
2,2023-12-19,서부여성회관,7943,4033,3910
2,2023-12-19,인천가좌,8556,4303,4253
2,2023-12-19,가재울,8283,4231,4052
2,2023-12-19,주안국가산단,5875,2915,2960
2,2023-12-19,주안,15243,6439,8804
2,2023-12-19,시민공원(문화창작지대),20140,10333,9807
2,2023-12-19,석바위시장,9024,4387,4637
2,2023-12-19,인천시청,6529,3128,3401
2,2023-12-19,석천사거리,9705,5014,4691
2,2023-12-19,모래내시장,15965,7738,8227
2,2023-12-19,만수,9992,5144,4848
2,2023-12-19,남동구청,8683,4495,4188
2,2023-12-19,인천대공원,3938,1980,1958
2,2023-12-19,운연(서창),2434,1306,1128
2,2023-12-20,검단오류(검단산업단지),6251,3044,3207
2,2023-12-20,왕길,5405,2698,2707
2,2023-12-20,검단사거리,17103,8982,8121
2,2023-12-20,마전,9052,4435,4617
2,2023-12-20,완정,16515,8574,7941
2,2023-12-20,독정,9235,4615,4620
2,2023-12-20,검암,9079,4948,4131
2,2023-12-20,검바위,7108,3413,3695
2,2023-12-20,아시아드경기장(공촌사거리),9510,5012,4498
2,2023-12-20,서구청,17549,8719,8830
2,2023-12-20,가정(루원시티),24860,12872,11988
2,2023-12-20,가정중앙시장,12356,6021,6335
2,2023-12-20,석남(거북시장),6145,2992,3153
2,2023-12-20,서부여성회관,8076,4157,3919
2,2023-12-20,인천가좌,8841,4396,4445
2,2023-12-20,가재울,8546,4333,4213
2,2023-12-20,주안국가산단,6249,3011,3238
2,2023-12-20,주안,15686,6608,9078
2,2023-12-20,시민공원(문화창작지대),20907,10688,10219
2,2023-12-20,석바위시장,9052,4420,4632
2,2023-12-20,인천시청,7070,3406,3664
2,2023-12-20,석천사거리,9977,5180,4797
2,2023-12-20,모래내시장,15407,7481,7926
2,2023-12-20,만수,10433,5446,4987
2,2023-12-20,남동구청,9204,4718,4486
2,2023-12-20,인천대공원,3420,1767,1653
2,2023-12-20,운연(서창),2470,1325,1145
2,2023-12-21,검단오류(검단산업단지),5818,2857,2961
2,2023-12-21,왕길,4922,2434,2488
2,2023-12-21,검단사거리,15784,8275,7509
2,2023-12-21,마전,8440,4119,4321
2,2023-12-21,완정,15007,7713,7294
2,2023-12-21,독정,8424,4225,4199
2,2023-12-21,검암,8273,4480,3793
2,2023-12-21,검바위,6573,3208,3365
2,2023-12-21,아시아드경기장(공촌사거리),8710,4631,4079
2,2023-12-21,서구청,15628,7746,7882
2,2023-12-21,가정(루원시티),22518,11512,11006
2,2023-12-21,가정중앙시장,11193,5441,5752
2,2023-12-21,석남(거북시장),5545,2703,2842
2,2023-12-21,서부여성회관,7678,3879,3799
2,2023-12-21,인천가좌,8152,4101,4051
2,2023-12-21,가재울,7874,4020,3854
2,2023-12-21,주안국가산단,5695,2736,2959
2,2023-12-21,주안,14695,6111,8584
2,2023-12-21,시민공원(문화창작지대),18767,9691,9076
2,2023-12-21,석바위시장,8224,4000,4224
2,2023-12-21,인천시청,6137,2957,3180
2,2023-12-21,석천사거리,8866,4576,4290
2,2023-12-21,모래내시장,13715,6739,6976
2,2023-12-21,만수,9366,4856,4510
2,2023-12-21,남동구청,7980,4068,3912
2,2023-12-21,인천대공원,2794,1428,1366
2,2023-12-21,운연(서창),2172,1152,1020
2,2023-12-22,검단오류(검단산업단지),5532,2700,2832
2,2023-12-22,왕길,4898,2463,2435
2,2023-12-22,검단사거리,17128,8947,8181
2,2023-12-22,마전,8642,4230,4412
2,2023-12-22,완정,15559,8091,7468
2,2023-12-22,독정,8868,4414,4454
2,2023-12-22,검암,8475,4590,3885
2,2023-12-22,검바위,6829,3351,3478
2,2023-12-22,아시아드경기장(공촌사거리),9022,4798,4224
2,2023-12-22,서구청,16621,8227,8394
2,2023-12-22,가정(루원시티),23355,12033,11322
2,2023-12-22,가정중앙시장,12213,5925,6288
2,2023-12-22,석남(거북시장),5859,2838,3021
2,2023-12-22,서부여성회관,8257,4148,4109
2,2023-12-22,인천가좌,8366,4173,4193
2,2023-12-22,가재울,8118,4187,3931
2,2023-12-22,주안국가산단,5512,2641,2871
2,2023-12-22,주안,16243,6817,9426
2,2023-12-22,시민공원(문화창작지대),19658,10106,9552
2,2023-12-22,석바위시장,9095,4450,4645
2,2023-12-22,인천시청,6313,3007,3306
2,2023-12-22,석천사거리,9181,4722,4459
2,2023-12-22,모래내시장,15339,7525,7814
2,2023-12-22,만수,9816,5066,4750
2,2023-12-22,남동구청,8341,4306,4035
2,2023-12-22,인천대공원,3016,1535,1481
2,2023-12-22,운연(서창),2298,1246,1052
2,2023-12-23,검단오류(검단산업단지),1984,1065,919
2,2023-12-23,왕길,2973,1551,1422
2,2023-12-23,검단사거리,13217,6869,6348
2,2023-12-23,마전,5772,2876,2896
2,2023-12-23,완정,10388,5438,4950
2,2023-12-23,독정,6246,3065,3181
2,2023-12-23,검암,5207,2771,2436
2,2023-12-23,검바위,3823,1894,1929
2,2023-12-23,아시아드경기장(공촌사거리),5958,3161,2797
2,2023-12-23,서구청,10827,5369,5458
2,2023-12-23,가정(루원시티),13927,7224,6703
2,2023-12-23,가정중앙시장,9573,4653,4920
2,2023-12-23,석남(거북시장),4384,2087,2297
2,2023-12-23,서부여성회관,5868,2936,2932
2,2023-12-23,인천가좌,4729,2460,2269
2,2023-12-23,가재울,4403,2298,2105
2,2023-12-23,주안국가산단,1468,724,744
2,2023-12-23,주안,12068,4868,7200
2,2023-12-23,시민공원(문화창작지대),13514,6942,6572
2,2023-12-23,석바위시장,6228,3042,3186
2,2023-12-23,인천시청,4059,1862,2197
2,2023-12-23,석천사거리,6190,3247,2943
2,2023-12-23,모래내시장,12112,5993,6119
2,2023-12-23,만수,7108,3661,3447
2,2023-12-23,남동구청,5775,3002,2773
2,2023-12-23,인천대공원,3150,1614,1536
2,2023-12-23,운연(서창),1508,807,701
2,2023-12-24,검단오류(검단산업단지),1315,713,602
2,2023-12-24,왕길,2110,1106,1004
2,2023-12-24,검단사거리,10632,5376,5256
2,2023-12-24,마전,4326,2197,2129
2,2023-12-24,완정,7793,4030,3763
2,2023-12-24,독정,4395,2218,2177
2,2023-12-24,검암,4072,2221,1851
2,2023-12-24,검바위,3103,1512,1591
2,2023-12-24,아시아드경기장(공촌사거리),5093,2670,2423
2,2023-12-24,서구청,8589,4274,4315
2,2023-12-24,가정(루원시티),11434,5807,5627
2,2023-12-24,가정중앙시장,7874,3927,3947
2,2023-12-24,석남(거북시장),3754,1783,1971
2,2023-12-24,서부여성회관,5362,2749,2613
2,2023-12-24,인천가좌,3665,1861,1804
2,2023-12-24,가재울,3708,1899,1809
2,2023-12-24,주안국가산단,762,381,381
2,2023-12-24,주안,10083,4025,6058
2,2023-12-24,시민공원(문화창작지대),11184,5733,5451
2,2023-12-24,석바위시장,5372,2659,2713
2,2023-12-24,인천시청,3557,1691,1866
2,2023-12-24,석천사거리,5038,2670,2368
2,2023-12-24,모래내시장,10208,5036,5172
2,2023-12-24,만수,6149,3201,2948
2,2023-12-24,남동구청,4546,2384,2162
2,2023-12-24,인천대공원,4327,2185,2142
2,2023-12-24,운연(서창),1211,632,579
2,2023-12-25,검단오류(검단산업단지),1334,647,687
2,2023-12-25,왕길,2350,1196,1154
2,2023-12-25,검단사거리,10843,5383,5460
2,2023-12-25,마전,4669,2326,2343
2,2023-12-25,완정,8041,4125,3916
2,2023-12-25,독정,4940,2459,2481
2,2023-12-25,검암,4146,2129,2017
2,2023-12-25,검바위,3001,1434,1567
2,2023-12-25,아시아드경기장(공촌사거리),4904,2596,2308
2,2023-12-25,서구청,8175,4120,4055
2,2023-12-25,가정(루원시티),11141,5666,5475
2,2023-12-25,가정중앙시장,7943,3929,4014
2,2023-12-25,석남(거북시장),3597,1675,1922
2,2023-12-25,서부여성회관,4995,2593,2402
2,2023-12-25,인천가좌,3624,1859,1765
2,2023-12-25,가재울,3609,1782,1827
2,2023-12-25,주안국가산단,972,435,537
2,2023-12-25,주안,9840,3934,5906
2,2023-12-25,시민공원(문화창작지대),10860,5589,5271
2,2023-12-25,석바위시장,4691,2305,2386
2,2023-12-25,인천시청,3384,1595,1789
2,2023-12-25,석천사거리,5121,2754,2367
2,2023-12-25,모래내시장,9707,4779,4928
2,2023-12-25,만수,5953,3107,2846
2,2023-12-25,남동구청,4292,2237,2055
2,2023-12-25,인천대공원,3893,1948,1945
2,2023-12-25,운연(서창),1104,591,513
2,2023-12-26,검단오류(검단산업단지),5754,2839,2915
2,2023-12-26,왕길,5180,2606,2574
2,2023-12-26,검단사거리,16301,8533,7768
2,2023-12-26,마전,8412,4051,4361
2,2023-12-26,완정,15314,7829,7485
2,2023-12-26,독정,8627,4324,4303
2,2023-12-26,검암,8282,4509,3773
2,2023-12-26,검바위,6791,3282,3509
2,2023-12-26,아시아드경기장(공촌사거리),8833,4646,4187
2,2023-12-26,서구청,16862,8418,8444
2,2023-12-26,가정(루원시티),22642,11593,11049
2,2023-12-26,가정중앙시장,11945,5822,6123
2,2023-12-26,석남(거북시장),5991,2909,3082
2,2023-12-26,서부여성회관,7729,3948,3781
2,2023-12-26,인천가좌,8551,4323,4228
2,2023-12-26,가재울,8048,4108,3940
2,2023-12-26,주안국가산단,5506,2701,2805
2,2023-12-26,주안,15189,6473,8716
2,2023-12-26,시민공원(문화창작지대),19807,10216,9591
2,2023-12-26,석바위시장,9111,4427,4684
2,2023-12-26,인천시청,6414,3054,3360
2,2023-12-26,석천사거리,9299,4776,4523
2,2023-12-26,모래내시장,15839,7754,8085
2,2023-12-26,만수,9971,5139,4832
2,2023-12-26,남동구청,8540,4414,4126
2,2023-12-26,인천대공원,4217,2133,2084
2,2023-12-26,운연(서창),2373,1241,1132
2,2023-12-27,검단오류(검단산업단지),5933,2924,3009
2,2023-12-27,왕길,5239,2649,2590
2,2023-12-27,검단사거리,16811,8778,8033
2,2023-12-27,마전,8576,4250,4326
2,2023-12-27,완정,15797,8128,7669
2,2023-12-27,독정,8787,4449,4338
2,2023-12-27,검암,8556,4613,3943
2,2023-12-27,검바위,6935,3402,3533
2,2023-12-27,아시아드경기장(공촌사거리),9451,5007,4444
2,2023-12-27,서구청,17577,8717,8860
2,2023-12-27,가정(루원시티),23768,12238,11530
2,2023-12-27,가정중앙시장,12560,6054,6506
2,2023-12-27,석남(거북시장),6119,2984,3135
2,2023-12-27,서부여성회관,8026,4113,3913
2,2023-12-27,인천가좌,8791,4406,4385
2,2023-12-27,가재울,8156,4186,3970
2,2023-12-27,주안국가산단,5679,2735,2944
2,2023-12-27,주안,15437,6462,8975
2,2023-12-27,시민공원(문화창작지대),20302,10297,10005
2,2023-12-27,석바위시장,9510,4663,4847
2,2023-12-27,인천시청,6926,3290,3636
2,2023-12-27,석천사거리,9446,4948,4498
2,2023-12-27,모래내시장,16005,7782,8223
2,2023-12-27,만수,10218,5288,4930
2,2023-12-27,남동구청,8719,4574,4145
2,2023-12-27,인천대공원,4197,2135,2062
2,2023-12-27,운연(서창),2374,1281,1093
2,2023-12-28,검단오류(검단산업단지),5759,2764,2995
2,2023-12-28,왕길,5220,2615,2605
2,2023-12-28,검단사거리,16577,8694,7883
2,2023-12-28,마전,8342,4079,4263
2,2023-12-28,완정,15679,8085,7594
2,2023-12-28,독정,8816,4451,4365
2,2023-12-28,검암,8521,4583,3938
2,2023-12-28,검바위,6896,3318,3578
2,2023-12-28,아시아드경기장(공촌사거리),9151,4831,4320
2,2023-12-28,서구청,17003,8419,8584
2,2023-12-28,가정(루원시티),23147,11945,11202
2,2023-12-28,가정중앙시장,12547,6051,6496
2,2023-12-28,석남(거북시장),5972,2914,3058
2,2023-12-28,서부여성회관,8184,4176,4008
2,2023-12-28,인천가좌,8437,4221,4216
2,2023-12-28,가재울,8004,4097,3907
2,2023-12-28,주안국가산단,5599,2700,2899
2,2023-12-28,주안,15465,6576,8889
2,2023-12-28,시민공원(문화창작지대),20219,10344,9875
2,2023-12-28,석바위시장,9086,4416,4670
2,2023-12-28,인천시청,6615,3171,3444
2,2023-12-28,석천사거리,9378,4883,4495
2,2023-12-28,모래내시장,15632,7625,8007
2,2023-12-28,만수,10116,5222,4894
2,2023-12-28,남동구청,8665,4485,4180
2,2023-12-28,인천대공원,4076,2083,1993
2,2023-12-28,운연(서창),2401,1302,1099
2,2023-12-29,검단오류(검단산업단지),5066,2445,2621
2,2023-12-29,왕길,5246,2697,2549
2,2023-12-29,검단사거리,17460,9106,8354
2,2023-12-29,마전,8500,4189,4311
2,2023-12-29,완정,15691,8195,7496
2,2023-12-29,독정,8838,4421,4417
2,2023-12-29,검암,8323,4579,3744
2,2023-12-29,검바위,7329,3635,3694
2,2023-12-29,아시아드경기장(공촌사거리),9117,4810,4307
2,2023-12-29,서구청,17675,8721,8954
2,2023-12-29,가정(루원시티),22810,11816,10994
2,2023-12-29,가정중앙시장,13294,6386,6908
2,2023-12-29,석남(거북시장),6219,2969,3250
2,2023-12-29,서부여성회관,8387,4315,4072
2,2023-12-29,인천가좌,8371,4136,4235
2,2023-12-29,가재울,8008,4130,3878
2,2023-12-29,주안국가산단,5094,2434,2660
2,2023-12-29,주안,15757,6659,9098
2,2023-12-29,시민공원(문화창작지대),19958,10235,9723
2,2023-12-29,석바위시장,9356,4562,4794
2,2023-12-29,인천시청,6327,3007,3320
2,2023-12-29,석천사거리,9213,4830,4383
2,2023-12-29,모래내시장,16129,7850,8279
2,2023-12-29,만수,10167,5271,4896
2,2023-12-29,남동구청,8729,4535,4194
2,2023-12-29,인천대공원,4298,2214,2084
2,2023-12-29,운연(서창),2404,1300,1104
2,2023-12-30,검단오류(검단산업단지),1611,884,727
2,2023-12-30,왕길,3133,1626,1507
2,2023-12-30,검단사거리,13170,6839,6331
2,2023-12-30,마전,6084,3079,3005
2,2023-12-30,완정,10472,5486,4986
2,2023-12-30,독정,5887,2981,2906
2,2023-12-30,검암,5478,2995,2483
2,2023-12-30,검바위,3532,1759,1773
2,2023-12-30,아시아드경기장(공촌사거리),5670,3063,2607
2,2023-12-30,서구청,10505,5152,5353
2,2023-12-30,가정(루원시티),13591,7025,6566
2,2023-12-30,가정중앙시장,9311,4524,4787
2,2023-12-30,석남(거북시장),4121,1982,2139
2,2023-12-30,서부여성회관,5546,2745,2801
2,2023-12-30,인천가좌,4336,2181,2155
2,2023-12-30,가재울,4284,2201,2083
2,2023-12-30,주안국가산단,1261,609,652
2,2023-12-30,주안,11040,4438,6602
2,2023-12-30,시민공원(문화창작지대),12957,6586,6371
2,2023-12-30,석바위시장,5907,2922,2985
2,2023-12-30,인천시청,3830,1835,1995
2,2023-12-30,석천사거리,5957,3074,2883
2,2023-12-30,모래내시장,11007,5398,5609
2,2023-12-30,만수,6794,3479,3315
2,2023-12-30,남동구청,4889,2544,2345
2,2023-12-30,인천대공원,2829,1429,1400
2,2023-12-30,운연(서창),1406,741,665
2,2023-12-31,검단오류(검단산업단지),1285,701,584
2,2023-12-31,왕길,1930,1020,910
2,2023-12-31,검단사거리,10761,5459,5302
2,2023-12-31,마전,4187,2160,2027
2,2023-12-31,완정,7419,3894,3525
2,2023-12-31,독정,4761,2427,2334
2,2023-12-31,검암,3909,2179,1730
2,2023-12-31,검바위,2937,1498,1439
2,2023-12-31,아시아드경기장(공촌사거리),5069,2717,2352
2,2023-12-31,서구청,8165,4093,4072
2,2023-12-31,가정(루원시티),9794,4926,4868
2,2023-12-31,가정중앙시장,8015,4002,4013
2,2023-12-31,석남(거북시장),3474,1689,1785
2,2023-12-31,서부여성회관,5300,2702,2598
2,2023-12-31,인천가좌,3310,1762,1548
2,2023-12-31,가재울,3414,1767,1647
2,2023-12-31,주안국가산단,683,354,329
2,2023-12-31,주안,9441,3958,5483
2,2023-12-31,시민공원(문화창작지대),10319,5285,5034
2,2023-12-31,석바위시장,5104,2474,2630
2,2023-12-31,인천시청,3399,1593,1806
2,2023-12-31,석천사거리,4554,2462,2092
2,2023-12-31,모래내시장,9765,4867,4898
2,2023-12-31,만수,5897,3046,2851
2,2023-12-31,남동구청,4315,2262,2053
2,2023-12-31,인천대공원,3280,1653,1627
2,2023-12-31,운연(서창),1125,604,521
2,2024-01-01,검단오류(검단산업단지),1169,544,625
2,2024-01-01,왕길,1708,846,862
2,2024-01-01,검단사거리,8730,4259,4471
2,2024-01-01,마전,3149,1513,1636
2,2024-01-01,완정,5937,2907,3030
2,2024-01-01,독정,3883,1795,2088
2,2024-01-01,검암,3268,1706,1562
2,2024-01-01,검바위,2281,1055,1226
2,2024-01-01,아시아드경기장(공촌사거리),3873,2036,1837
2,2024-01-01,서구청,6370,3230,3140
2,2024-01-01,가정(루원시티),7545,3777,3768
2,2024-01-01,가정중앙시장,6179,3022,3157
2,2024-01-01,석남(거북시장),2938,1370,1568
2,2024-01-01,서부여성회관,3733,1921,1812
2,2024-01-01,인천가좌,2834,1391,1443
2,2024-01-01,가재울,2499,1239,1260
2,2024-01-01,주안국가산단,597,273,324
2,2024-01-01,주안,7964,3285,4679
2,2024-01-01,시민공원(문화창작지대),8311,4351,3960
2,2024-01-01,석바위시장,3387,1630,1757
2,2024-01-01,인천시청,2536,1169,1367
2,2024-01-01,석천사거리,3875,2047,1828
2,2024-01-01,모래내시장,8167,3964,4203
2,2024-01-01,만수,4673,2419,2254
2,2024-01-01,남동구청,3397,1758,1639
2,2024-01-01,인천대공원,5464,2723,2741
2,2024-01-01,운연(서창),1002,508,494
2,2024-01-02,검단오류(검단산업단지),5777,2856,2921
2,2024-01-02,왕길,4932,2497,2435
2,2024-01-02,검단사거리,15457,7979,7478
2,2024-01-02,마전,8016,3913,4103
2,2024-01-02,완정,14235,7286,6949
2,2024-01-02,독정,8383,4240,4143
2,2024-01-02,검암,8254,4430,3824
2,2024-01-02,검바위,5823,2784,3039
2,2024-01-02,아시아드경기장(공촌사거리),8213,4408,3805
2,2024-01-02,서구청,15756,7806,7950
2,2024-01-02,가정(루원시티),21440,11054,10386
2,2024-01-02,가정중앙시장,11259,5417,5842
2,2024-01-02,석남(거북시장),5588,2762,2826
2,2024-01-02,서부여성회관,7420,3803,3617
2,2024-01-02,인천가좌,7780,3893,3887
2,2024-01-02,가재울,7648,3923,3725
2,2024-01-02,주안국가산단,5459,2700,2759
2,2024-01-02,주안,14136,5996,8140
2,2024-01-02,시민공원(문화창작지대),18914,9722,9192
2,2024-01-02,석바위시장,8420,4142,4278
2,2024-01-02,인천시청,6088,2912,3176
2,2024-01-02,석천사거리,8931,4645,4286
2,2024-01-02,모래내시장,14502,7144,7358
2,2024-01-02,만수,9507,4909,4598
2,2024-01-02,남동구청,7707,3958,3749
2,2024-01-02,인천대공원,4240,2155,2085
2,2024-01-02,운연(서창),2151,1156,995
2,2024-01-03,검단오류(검단산업단지),6117,3014,3103
2,2024-01-03,왕길,4947,2468,2479
2,2024-01-03,검단사거리,15558,8119,7439
2,2024-01-03,마전,8373,4062,4311
2,2024-01-03,완정,14868,7624,7244
2,2024-01-03,독정,8392,4243,4149
2,2024-01-03,검암,8367,4505,3862
2,2024-01-03,검바위,5894,2826,3068
2,2024-01-03,아시아드경기장(공촌사거리),8589,4535,4054
2,2024-01-03,서구청,15889,7843,8046
2,2024-01-03,가정(루원시티),22378,11472,10906
2,2024-01-03,가정중앙시장,12066,5897,6169
2,2024-01-03,석남(거북시장),5835,2836,2999
2,2024-01-03,서부여성회관,8081,4100,3981
2,2024-01-03,인천가좌,7944,3981,3963
2,2024-01-03,가재울,7961,4112,3849
2,2024-01-03,주안국가산단,5760,2834,2926
2,2024-01-03,주안,14512,6119,8393
2,2024-01-03,시민공원(문화창작지대),19498,9984,9514
2,2024-01-03,석바위시장,8719,4234,4485
2,2024-01-03,인천시청,6305,3045,3260
2,2024-01-03,석천사거리,9114,4732,4382
2,2024-01-03,모래내시장,14675,7137,7538
2,2024-01-03,만수,9705,4995,4710
2,2024-01-03,남동구청,7856,4091,3765
2,2024-01-03,인천대공원,3707,1888,1819
2,2024-01-03,운연(서창),2346,1247,1099
2,2024-01-04,검단오류(검단산업단지),6071,2981,3090
2,2024-01-04,왕길,5126,2581,2545
2,2024-01-04,검단사거리,15684,8144,7540
2,2024-01-04,마전,8332,4089,4243
2,2024-01-04,완정,14816,7655,7161
2,2024-01-04,독정,8422,4260,4162
2,2024-01-04,검암,8437,4561,3876
2,2024-01-04,검바위,6179,2967,3212
2,2024-01-04,아시아드경기장(공촌사거리),8531,4522,4009
2,2024-01-04,서구청,16266,8062,8204
2,2024-01-04,가정(루원시티),22434,11543,10891
2,2024-01-04,가정중앙시장,12163,5930,6233
2,2024-01-04,석남(거북시장),5911,2907,3004
2,2024-01-04,서부여성회관,7932,4016,3916
2,2024-01-04,인천가좌,8182,4109,4073
2,2024-01-04,가재울,7955,4091,3864
2,2024-01-04,주안국가산단,5797,2856,2941
2,2024-01-04,주안,14878,6318,8560
2,2024-01-04,시민공원(문화창작지대),19685,10097,9588
2,2024-01-04,석바위시장,8498,4187,4311
2,2024-01-04,인천시청,6429,3039,3390
2,2024-01-04,석천사거리,9111,4760,4351
2,2024-01-04,모래내시장,15312,7424,7888
2,2024-01-04,만수,9579,4912,4667
2,2024-01-04,남동구청,8167,4209,3958
2,2024-01-04,인천대공원,4371,2223,2148
2,2024-01-04,운연(서창),2355,1268,1087
2,2024-01-05,검단오류(검단산업단지),5917,2894,3023
2,2024-01-05,왕길,5043,2561,2482
2,2024-01-05,검단사거리,16925,8882,8043
2,2024-01-05,마전,8693,4278,4415
2,2024-01-05,완정,15291,7878,7413
2,2024-01-05,독정,8934,4472,4462
2,2024-01-05,검암,8694,4777,3917
2,2024-01-05,검바위,5696,2774,2922
2,2024-01-05,아시아드경기장(공촌사거리),8688,4707,3981
2,2024-01-05,서구청,17297,8512,8785
2,2024-01-05,가정(루원시티),23018,11898,11120
2,2024-01-05,가정중앙시장,12370,5990,6380
2,2024-01-05,석남(거북시장),5997,2937,3060
2,2024-01-05,서부여성회관,8591,4286,4305
2,2024-01-05,인천가좌,8274,4154,4120
2,2024-01-05,가재울,8102,4215,3887
2,2024-01-05,주안국가산단,5781,2838,2943
2,2024-01-05,주안,15366,6439,8927
2,2024-01-05,시민공원(문화창작지대),20336,10403,9933
2,2024-01-05,석바위시장,9107,4390,4717
2,2024-01-05,인천시청,6632,3140,3492
2,2024-01-05,석천사거리,9080,4809,4271
2,2024-01-05,모래내시장,16240,7917,8323
2,2024-01-05,만수,9932,5122,4810
2,2024-01-05,남동구청,8500,4445,4055
2,2024-01-05,인천대공원,4517,2301,2216
2,2024-01-05,운연(서창),2439,1336,1103
2,2024-01-06,검단오류(검단산업단지),1911,1045,866
2,2024-01-06,왕길,3001,1540,1461
2,2024-01-06,검단사거리,12927,6667,6260
2,2024-01-06,마전,5745,2853,2892
2,2024-01-06,완정,10257,5320,4937
2,2024-01-06,독정,6029,3052,2977
2,2024-01-06,검암,5528,2965,2563
2,2024-01-06,검바위,4161,1991,2170
2,2024-01-06,아시아드경기장(공촌사거리),6414,3376,3038
2,2024-01-06,서구청,10788,5285,5503
2,2024-01-06,가정(루원시티),14434,7501,6933
2,2024-01-06,가정중앙시장,9986,4923,5063
2,2024-01-06,석남(거북시장),4697,2195,2502
2,2024-01-06,서부여성회관,6073,3103,2970
2,2024-01-06,인천가좌,4802,2448,2354
2,2024-01-06,가재울,4607,2363,2244
2,2024-01-06,주안국가산단,1494,756,738
2,2024-01-06,주안,12317,4999,7318
2,2024-01-06,시민공원(문화창작지대),14060,7129,6931
2,2024-01-06,석바위시장,6421,3182,3239
2,2024-01-06,인천시청,4476,2040,2436
2,2024-01-06,석천사거리,6151,3185,2966
2,2024-01-06,모래내시장,12997,6377,6620
2,2024-01-06,만수,7556,3867,3689
2,2024-01-06,남동구청,5567,2888,2679
2,2024-01-06,인천대공원,5119,2625,2494
2,2024-01-06,운연(서창),1575,842,733
2,2024-01-07,검단오류(검단산업단지),1162,586,576
2,2024-01-07,왕길,1951,985,966
2,2024-01-07,검단사거리,9380,4704,4676
2,2024-01-07,마전,4163,2022,2141
2,2024-01-07,완정,6973,3518,3455
2,2024-01-07,독정,4276,2122,2154
2,2024-01-07,검암,3780,1999,1781
2,2024-01-07,검바위,2921,1385,1536
2,2024-01-07,아시아드경기장(공촌사거리),4692,2465,2227
2,2024-01-07,서구청,7550,3785,3765
2,2024-01-07,가정(루원시티),9862,4937,4925
2,2024-01-07,가정중앙시장,6613,3262,3351
2,2024-01-07,석남(거북시장),3280,1525,1755
2,2024-01-07,서부여성회관,4554,2330,2224
2,2024-01-07,인천가좌,3182,1615,1567
2,2024-01-07,가재울,3172,1590,1582
2,2024-01-07,주안국가산단,739,350,389
2,2024-01-07,주안,8507,3495,5012
2,2024-01-07,시민공원(문화창작지대),10095,5193,4902
2,2024-01-07,석바위시장,4667,2291,2376
2,2024-01-07,인천시청,3325,1549,1776
2,2024-01-07,석천사거리,4474,2324,2150
2,2024-01-07,모래내시장,8837,4378,4459
2,2024-01-07,만수,5237,2692,2545
2,2024-01-07,남동구청,3839,1968,1871
2,2024-01-07,인천대공원,3563,1786,1777
2,2024-01-07,운연(서창),1104,565,539
2,2024-01-08,검단오류(검단산업단지),5919,2897,3022
2,2024-01-08,왕길,4985,2490,2495
2,2024-01-08,검단사거리,15331,8023,7308
2,2024-01-08,마전,8093,3867,4226
2,2024-01-08,완정,14190,7312,6878
2,2024-01-08,독정,7691,3820,3871
2,2024-01-08,검암,8140,4352,3788
2,2024-01-08,검바위,5363,2543,2820
2,2024-01-08,아시아드경기장(공촌사거리),8192,4355,3837
2,2024-01-08,서구청,15361,7599,7762
2,2024-01-08,가정(루원시티),21537,11094,10443
2,2024-01-08,가정중앙시장,11111,5396,5715
2,2024-01-08,석남(거북시장),5556,2702,2854
2,2024-01-08,서부여성회관,7562,3867,3695
2,2024-01-08,인천가좌,7881,3934,3947
2,2024-01-08,가재울,7854,4034,3820
2,2024-01-08,주안국가산단,5811,2880,2931
2,2024-01-08,주안,14198,6122,8076
2,2024-01-08,시민공원(문화창작지대),18712,9602,9110
2,2024-01-08,석바위시장,8534,4191,4343
2,2024-01-08,인천시청,5894,2840,3054
2,2024-01-08,석천사거리,8515,4421,4094
2,2024-01-08,모래내시장,14096,6853,7243
2,2024-01-08,만수,8901,4637,4264
2,2024-01-08,남동구청,7865,4109,3756
2,2024-01-08,인천대공원,3237,1641,1596
2,2024-01-08,운연(서창),2155,1159,996
2,2024-01-09,검단오류(검단산업단지),6338,3144,3194
2,2024-01-09,왕길,5231,2607,2624
2,2024-01-09,검단사거리,16262,8444,7818
2,2024-01-09,마전,8680,4230,4450
2,2024-01-09,완정,15582,8024,7558
2,2024-01-09,독정,8117,4024,4093
2,2024-01-09,검암,8813,4749,4064
2,2024-01-09,검바위,5583,2716,2867
2,2024-01-09,아시아드경기장(공촌사거리),8669,4652,4017
2,2024-01-09,서구청,16805,8317,8488
2,2024-01-09,가정(루원시티),23356,12036,11320
2,2024-01-09,가정중앙시장,11761,5744,6017
2,2024-01-09,석남(거북시장),5882,2854,3028
2,2024-01-09,서부여성회관,7911,4012,3899
2,2024-01-09,인천가좌,8468,4233,4235
2,2024-01-09,가재울,8306,4277,4029
2,2024-01-09,주안국가산단,6372,3149,3223
2,2024-01-09,주안,14935,6363,8572
2,2024-01-09,시민공원(문화창작지대),20026,10269,9757
2,2024-01-09,석바위시장,9086,4419,4667
2,2024-01-09,인천시청,6360,2980,3380
2,2024-01-09,석천사거리,9642,5042,4600
2,2024-01-09,모래내시장,14158,6880,7278
2,2024-01-09,만수,9283,4741,4542
2,2024-01-09,남동구청,8448,4335,4113
2,2024-01-09,인천대공원,3419,1740,1679
2,2024-01-09,운연(서창),2299,1240,1059
2,2024-01-10,검단오류(검단산업단지),6046,2985,3061
2,2024-01-10,왕길,5153,2558,2595
2,2024-01-10,검단사거리,16014,8370,7644
2,2024-01-10,마전,8332,4039,4293
2,2024-01-10,완정,15085,7753,7332
2,2024-01-10,독정,8010,4028,3982
2,2024-01-10,검암,8544,4587,3957
2,2024-01-10,검바위,5542,2634,2908
2,2024-01-10,아시아드경기장(공촌사거리),8738,4665,4073
2,2024-01-10,서구청,17071,8472,8599
2,2024-01-10,가정(루원시티),22775,11746,11029
2,2024-01-10,가정중앙시장,12271,5959,6312
2,2024-01-10,석남(거북시장),6042,2962,3080
2,2024-01-10,서부여성회관,8353,4232,4121
2,2024-01-10,인천가좌,8535,4258,4277
2,2024-01-10,가재울,8352,4249,4103
2,2024-01-10,주안국가산단,5976,2927,3049
2,2024-01-10,주안,14990,6371,8619
2,2024-01-10,시민공원(문화창작지대),20283,10482,9801
2,2024-01-10,석바위시장,9030,4381,4649
2,2024-01-10,인천시청,6564,3108,3456
2,2024-01-10,석천사거리,9286,4806,4480
2,2024-01-10,모래내시장,15242,7467,7775
2,2024-01-10,만수,9730,5018,4712
2,2024-01-10,남동구청,8718,4514,4204
2,2024-01-10,인천대공원,3889,1995,1894
2,2024-01-10,운연(서창),2318,1257,1061
2,2024-01-11,검단오류(검단산업단지),6016,2955,3061
2,2024-01-11,왕길,5123,2604,2519
2,2024-01-11,검단사거리,15876,8288,7588
2,2024-01-11,마전,8572,4107,4465
2,2024-01-11,완정,15042,7783,7259
2,2024-01-11,독정,8070,4071,3999
2,2024-01-11,검암,8464,4646,3818
2,2024-01-11,검바위,5558,2688,2870
2,2024-01-11,아시아드경기장(공촌사거리),8519,4549,3970
2,2024-01-11,서구청,17039,8417,8622
2,2024-01-11,가정(루원시티),22672,11729,10943
2,2024-01-11,가정중앙시장,12194,5931,6263
2,2024-01-11,석남(거북시장),5990,2897,3093
2,2024-01-11,서부여성회관,8259,4193,4066
2,2024-01-11,인천가좌,8157,4085,4072
2,2024-01-11,가재울,8139,4175,3964
2,2024-01-11,주안국가산단,5752,2825,2927
2,2024-01-11,주안,14862,6338,8524
2,2024-01-11,시민공원(문화창작지대),19740,10138,9602
2,2024-01-11,석바위시장,8875,4298,4577
2,2024-01-11,인천시청,6543,3120,3423
2,2024-01-11,석천사거리,9270,4766,4504
2,2024-01-11,모래내시장,15398,7480,7918
2,2024-01-11,만수,9547,4910,4637
2,2024-01-11,남동구청,8824,4547,4277
2,2024-01-11,인천대공원,4313,2171,2142
2,2024-01-11,운연(서창),2398,1253,1145
2,2024-01-12,검단오류(검단산업단지),6042,3037,3005
2,2024-01-12,왕길,5177,2647,2530
2,2024-01-12,검단사거리,17220,8883,8337
2,2024-01-12,마전,8515,4197,4318
2,2024-01-12,완정,15876,8198,7678
2,2024-01-12,독정,8303,4178,4125
2,2024-01-12,검암,8623,4711,3912
2,2024-01-12,검바위,5958,2948,3010
2,2024-01-12,아시아드경기장(공촌사거리),8753,4721,4032
2,2024-01-12,서구청,18565,9060,9505
2,2024-01-12,가정(루원시티),23534,12157,11377
2,2024-01-12,가정중앙시장,12856,6204,6652
2,2024-01-12,석남(거북시장),6056,2945,3111
2,2024-01-12,서부여성회관,8731,4420,4311
2,2024-01-12,인천가좌,8278,4189,4089
2,2024-01-12,가재울,8367,4309,4058
2,2024-01-12,주안국가산단,5764,2824,2940
2,2024-01-12,주안,15866,6706,9160
2,2024-01-12,시민공원(문화창작지대),20232,10403,9829
2,2024-01-12,석바위시장,9224,4474,4750
2,2024-01-12,인천시청,6519,3149,3370
2,2024-01-12,석천사거리,9243,4852,4391
2,2024-01-12,모래내시장,16285,7928,8357
2,2024-01-12,만수,10164,5256,4908
2,2024-01-12,남동구청,8808,4560,4248
2,2024-01-12,인천대공원,4555,2304,2251
2,2024-01-12,운연(서창),2549,1364,1185
2,2024-01-13,검단오류(검단산업단지),2146,1171,975
2,2024-01-13,왕길,3046,1545,1501
2,2024-01-13,검단사거리,13366,6991,6375
2,2024-01-13,마전,5905,2945,2960
2,2024-01-13,완정,10378,5457,4921
2,2024-01-13,독정,6195,3112,3083
2,2024-01-13,검암,5380,2880,2500
2,2024-01-13,검바위,3878,1869,2009
2,2024-01-13,아시아드경기장(공촌사거리),6653,3563,3090
2,2024-01-13,서구청,11195,5485,5710
2,2024-01-13,가정(루원시티),15058,7775,7283
2,2024-01-13,가정중앙시장,10314,5055,5259
2,2024-01-13,석남(거북시장),4743,2289,2454
2,2024-01-13,서부여성회관,6033,3054,2979
2,2024-01-13,인천가좌,4813,2446,2367
2,2024-01-13,가재울,4622,2374,2248
2,2024-01-13,주안국가산단,1496,728,768
2,2024-01-13,주안,12989,5291,7698
2,2024-01-13,시민공원(문화창작지대),14493,7484,7009
2,2024-01-13,석바위시장,6884,3347,3537
2,2024-01-13,인천시청,4578,2147,2431
2,2024-01-13,석천사거리,6372,3372,3000
2,2024-01-13,모래내시장,13898,6731,7167
2,2024-01-13,만수,7888,4063,3825
2,2024-01-13,남동구청,6157,3153,3004
2,2024-01-13,인천대공원,5534,2809,2725
2,2024-01-13,운연(서창),1694,891,803
2,2024-01-14,검단오류(검단산업단지),1165,558,607
2,2024-01-14,왕길,1814,934,880
2,2024-01-14,검단사거리,9015,4459,4556
2,2024-01-14,마전,3820,1841,1979
2,2024-01-14,완정,6769,3390,3379
2,2024-01-14,독정,3543,1748,1795
2,2024-01-14,검암,3508,1842,1666
2,2024-01-14,검바위,2772,1316,1456
2,2024-01-14,아시아드경기장(공촌사거리),4339,2326,2013
2,2024-01-14,서구청,7275,3664,3611
2,2024-01-14,가정(루원시티),9417,4742,4675
2,2024-01-14,가정중앙시장,6425,3147,3278
2,2024-01-14,석남(거북시장),3067,1451,1616
2,2024-01-14,서부여성회관,4376,2269,2107
2,2024-01-14,인천가좌,2974,1440,1534
2,2024-01-14,가재울,3106,1568,1538
2,2024-01-14,주안국가산단,633,302,331
2,2024-01-14,주안,8235,3358,4877
2,2024-01-14,시민공원(문화창작지대),9899,5064,4835
2,2024-01-14,석바위시장,4519,2207,2312
2,2024-01-14,인천시청,3033,1435,1598
2,2024-01-14,석천사거리,4201,2171,2030
2,2024-01-14,모래내시장,8159,3985,4174
2,2024-01-14,만수,5112,2608,2504
2,2024-01-14,남동구청,4128,2121,2007
2,2024-01-14,인천대공원,2776,1404,1372
2,2024-01-14,운연(서창),1096,573,523
2,2024-01-15,검단오류(검단산업단지),5966,2895,3071
2,2024-01-15,왕길,4657,2345,2312
2,2024-01-15,검단사거리,15275,7957,7318
2,2024-01-15,마전,7899,3863,4036
2,2024-01-15,완정,14383,7414,6969
2,2024-01-15,독정,7799,3904,3895
2,2024-01-15,검암,8284,4529,3755
2,2024-01-15,검바위,5268,2503,2765
2,2024-01-15,아시아드경기장(공촌사거리),8455,4509,3946
2,2024-01-15,서구청,16307,8053,8254
2,2024-01-15,가정(루원시티),21445,11065,10380
2,2024-01-15,가정중앙시장,11461,5601,5860
2,2024-01-15,석남(거북시장),5801,2867,2934
2,2024-01-15,서부여성회관,7532,3836,3696
2,2024-01-15,인천가좌,7978,4032,3946
2,2024-01-15,가재울,7919,4025,3894
2,2024-01-15,주안국가산단,5673,2825,2848
2,2024-01-15,주안,14179,6074,8105
2,2024-01-15,시민공원(문화창작지대),18969,9658,9311
2,2024-01-15,석바위시장,8606,4229,4377
2,2024-01-15,인천시청,5938,2869,3069
2,2024-01-15,석천사거리,8782,4510,4272
2,2024-01-15,모래내시장,14613,7150,7463
2,2024-01-15,만수,9161,4683,4478
2,2024-01-15,남동구청,8221,4238,3983
2,2024-01-15,인천대공원,3816,1942,1874
2,2024-01-15,운연(서창),2212,1169,1043
2,2024-01-16,검단오류(검단산업단지),5942,2917,3025
2,2024-01-16,왕길,4895,2500,2395
2,2024-01-16,검단사거리,15561,8082,7479
2,2024-01-16,마전,7952,3879,4073
2,2024-01-16,완정,14589,7511,7078
2,2024-01-16,독정,7890,3903,3987
2,2024-01-16,검암,8451,4591,3860
2,2024-01-16,검바위,5257,2514,2743
2,2024-01-16,아시아드경기장(공촌사거리),8464,4479,3985
2,2024-01-16,서구청,16973,8387,8586
2,2024-01-16,가정(루원시티),22192,11447,10745
2,2024-01-16,가정중앙시장,11946,5814,6132
2,2024-01-16,석남(거북시장),5835,2824,3011
2,2024-01-16,서부여성회관,7822,3975,3847
2,2024-01-16,인천가좌,8056,4046,4010
2,2024-01-16,가재울,8115,4173,3942
2,2024-01-16,주안국가산단,5781,2852,2929
2,2024-01-16,주안,14838,6314,8524
2,2024-01-16,시민공원(문화창작지대),19511,10050,9461
2,2024-01-16,석바위시장,8901,4335,4566
2,2024-01-16,인천시청,6218,2961,3257
2,2024-01-16,석천사거리,9196,4801,4395
2,2024-01-16,모래내시장,15412,7489,7923
2,2024-01-16,만수,9421,4780,4641
2,2024-01-16,남동구청,8443,4394,4049
2,2024-01-16,인천대공원,4201,2170,2031
2,2024-01-16,운연(서창),2368,1272,1096
2,2024-01-17,검단오류(검단산업단지),5999,2971,3028
2,2024-01-17,왕길,4826,2449,2377
2,2024-01-17,검단사거리,15399,7989,7410
2,2024-01-17,마전,8063,3889,4174
2,2024-01-17,완정,14458,7447,7011
2,2024-01-17,독정,7692,3845,3847
2,2024-01-17,검암,8436,4443,3993
2,2024-01-17,검바위,5477,2633,2844
2,2024-01-17,아시아드경기장(공촌사거리),8579,4564,4015
2,2024-01-17,서구청,16106,8002,8104
2,2024-01-17,가정(루원시티),22294,11448,10846
2,2024-01-17,가정중앙시장,11611,5687,5924
2,2024-01-17,석남(거북시장),5750,2771,2979
2,2024-01-17,서부여성회관,7974,4024,3950
2,2024-01-17,인천가좌,8031,4012,4019
2,2024-01-17,가재울,8088,4144,3944
2,2024-01-17,주안국가산단,5876,2918,2958
2,2024-01-17,주안,14245,5945,8300
2,2024-01-17,시민공원(문화창작지대),19600,10025,9575
2,2024-01-17,석바위시장,8807,4219,4588
2,2024-01-17,인천시청,6211,2997,3214
2,2024-01-17,석천사거리,9112,4597,4515
2,2024-01-17,모래내시장,14184,6953,7231
2,2024-01-17,만수,9286,4674,4612
2,2024-01-17,남동구청,8433,4377,4056
2,2024-01-17,인천대공원,3296,1674,1622
2,2024-01-17,운연(서창),2251,1194,1057
2,2024-01-18,검단오류(검단산업단지),6063,2986,3077
2,2024-01-18,왕길,4944,2482,2462
2,2024-01-18,검단사거리,15455,8053,7402
2,2024-01-18,마전,7979,3870,4109
2,2024-01-18,완정,14827,7586,7241
2,2024-01-18,독정,8076,4044,4032
2,2024-01-18,검암,8412,4547,3865
2,2024-01-18,검바위,5584,2685,2899
2,2024-01-18,아시아드경기장(공촌사거리),8588,4597,3991
2,2024-01-18,서구청,17101,8455,8646
2,2024-01-18,가정(루원시티),22406,11500,10906
2,2024-01-18,가정중앙시장,12448,6066,6382
2,2024-01-18,석남(거북시장),5948,2891,3057
2,2024-01-18,서부여성회관,8296,4185,4111
2,2024-01-18,인천가좌,8196,4091,4105
2,2024-01-18,가재울,8196,4233,3963
2,2024-01-18,주안국가산단,5892,2876,3016
2,2024-01-18,주안,15072,6415,8657
2,2024-01-18,시민공원(문화창작지대),19538,10031,9507
2,2024-01-18,석바위시장,9227,4465,4762
2,2024-01-18,인천시청,6625,3142,3483
2,2024-01-18,석천사거리,9215,4783,4432
2,2024-01-18,모래내시장,16008,7863,8145
2,2024-01-18,만수,9678,4956,4722
2,2024-01-18,남동구청,8627,4485,4142
2,2024-01-18,인천대공원,4863,2502,2361
2,2024-01-18,운연(서창),2405,1287,1118
2,2024-01-19,검단오류(검단산업단지),5901,2897,3004
2,2024-01-19,왕길,5001,2586,2415
2,2024-01-19,검단사거리,17091,8940,8151
2,2024-01-19,마전,8176,3983,4193
2,2024-01-19,완정,15268,7881,7387
2,2024-01-19,독정,8284,4172,4112
2,2024-01-19,검암,8464,4597,3867
2,2024-01-19,검바위,5744,2834,2910
2,2024-01-19,아시아드경기장(공촌사거리),8733,4672,4061
2,2024-01-19,서구청,18297,9047,9250
2,2024-01-19,가정(루원시티),23481,12221,11260
2,2024-01-19,가정중앙시장,13226,6420,6806
2,2024-01-19,석남(거북시장),6320,3035,3285
2,2024-01-19,서부여성회관,8741,4412,4329
2,2024-01-19,인천가좌,8397,4234,4163
2,2024-01-19,가재울,8450,4397,4053
2,2024-01-19,주안국가산단,5681,2799,2882
2,2024-01-19,주안,15737,6699,9038
2,2024-01-19,시민공원(문화창작지대),20048,10302,9746
2,2024-01-19,석바위시장,9159,4434,4725
2,2024-01-19,인천시청,6615,3162,3453
2,2024-01-19,석천사거리,9781,5109,4672
2,2024-01-19,모래내시장,16275,7847,8428
2,2024-01-19,만수,9997,5168,4829
2,2024-01-19,남동구청,8815,4587,4228
2,2024-01-19,인천대공원,4621,2363,2258
2,2024-01-19,운연(서창),2470,1319,1151
2,2024-01-20,검단오류(검단산업단지),2115,1148,967
2,2024-01-20,왕길,2951,1511,1440
2,2024-01-20,검단사거리,12841,6616,6225
2,2024-01-20,마전,5978,3011,2967
2,2024-01-20,완정,9926,5172,4754
2,2024-01-20,독정,5972,3010,2962
2,2024-01-20,검암,5261,2905,2356
2,2024-01-20,검바위,3671,1756,1915
2,2024-01-20,아시아드경기장(공촌사거리),6315,3329,2986
2,2024-01-20,서구청,10895,5377,5518
2,2024-01-20,가정(루원시티),14091,7240,6851
2,2024-01-20,가정중앙시장,10091,4949,5142
2,2024-01-20,석남(거북시장),4482,2117,2365
2,2024-01-20,서부여성회관,6164,3162,3002
2,2024-01-20,인천가좌,4600,2313,2287
2,2024-01-20,가재울,4545,2358,2187
2,2024-01-20,주안국가산단,1472,720,752
2,2024-01-20,주안,12744,5115,7629
2,2024-01-20,시민공원(문화창작지대),13585,6990,6595
2,2024-01-20,석바위시장,6609,3212,3397
2,2024-01-20,인천시청,4136,1954,2182
2,2024-01-20,석천사거리,5985,3140,2845
2,2024-01-20,모래내시장,12567,6146,6421
2,2024-01-20,만수,7277,3756,3521
2,2024-01-20,남동구청,5278,2768,2510
2,2024-01-20,인천대공원,3963,1990,1973
2,2024-01-20,운연(서창),1569,803,766
2,2024-01-21,검단오류(검단산업단지),1284,627,657
2,2024-01-21,왕길,1934,983,951
2,2024-01-21,검단사거리,9454,4715,4739
2,2024-01-21,마전,4161,1974,2187
2,2024-01-21,완정,7125,3565,3560
2,2024-01-21,독정,4345,2125,2220
2,2024-01-21,검암,3654,1888,1766
2,2024-01-21,검바위,2891,1352,1539
2,2024-01-21,아시아드경기장(공촌사거리),4696,2503,2193
2,2024-01-21,서구청,7603,3815,3788
2,2024-01-21,가정(루원시티),9818,4973,4845
2,2024-01-21,가정중앙시장,7158,3490,3668
2,2024-01-21,석남(거북시장),3309,1572,1737
2,2024-01-21,서부여성회관,4914,2516,2398
2,2024-01-21,인천가좌,3143,1551,1592
2,2024-01-21,가재울,3290,1629,1661
2,2024-01-21,주안국가산단,709,336,373
2,2024-01-21,주안,8741,3510,5231
2,2024-01-21,시민공원(문화창작지대),10133,5219,4914
2,2024-01-21,석바위시장,4927,2403,2524
2,2024-01-21,인천시청,3104,1443,1661
2,2024-01-21,석천사거리,4488,2295,2193
2,2024-01-21,모래내시장,9338,4569,4769
2,2024-01-21,만수,5426,2798,2628
2,2024-01-21,남동구청,4063,2086,1977
2,2024-01-21,인천대공원,3516,1764,1752
2,2024-01-21,운연(서창),1090,557,533
2,2024-01-22,검단오류(검단산업단지),5788,2829,2959
2,2024-01-22,왕길,4579,2314,2265
2,2024-01-22,검단사거리,14975,7738,7237
2,2024-01-22,마전,7862,3790,4072
2,2024-01-22,완정,13954,7183,6771
2,2024-01-22,독정,7483,3784,3699
2,2024-01-22,검암,8195,4416,3779
2,2024-01-22,검바위,5414,2592,2822
2,2024-01-22,아시아드경기장(공촌사거리),8079,4283,3796
2,2024-01-22,서구청,15025,7459,7566
2,2024-01-22,가정(루원시티),21012,10794,10218
2,2024-01-22,가정중앙시장,10892,5275,5617
2,2024-01-22,석남(거북시장),5423,2649,2774
2,2024-01-22,서부여성회관,7404,3800,3604
2,2024-01-22,인천가좌,7834,3908,3926
2,2024-01-22,가재울,7575,3923,3652
2,2024-01-22,주안국가산단,5303,2611,2692
2,2024-01-22,주안,13548,5792,7756
2,2024-01-22,시민공원(문화창작지대),18550,9515,9035
2,2024-01-22,석바위시장,8278,4082,4196
2,2024-01-22,인천시청,5717,2735,2982
2,2024-01-22,석천사거리,8632,4440,4192
2,2024-01-22,모래내시장,13380,6540,6840
2,2024-01-22,만수,8661,4447,4214
2,2024-01-22,남동구청,7824,4035,3789
2,2024-01-22,인천대공원,2865,1476,1389
2,2024-01-22,운연(서창),2024,1069,955
2,2024-01-23,검단오류(검단산업단지),5637,2757,2880
2,2024-01-23,왕길,4398,2231,2167
2,2024-01-23,검단사거리,13858,7237,6621
2,2024-01-23,마전,7455,3613,3842
2,2024-01-23,완정,13300,6829,6471
2,2024-01-23,독정,7051,3534,3517
2,2024-01-23,검암,7956,4278,3678
2,2024-01-23,검바위,4907,2356,2551
2,2024-01-23,아시아드경기장(공촌사거리),7839,4171,3668
2,2024-01-23,서구청,14623,7285,7338
2,2024-01-23,가정(루원시티),20347,10462,9885
2,2024-01-23,가정중앙시장,10095,4896,5199
2,2024-01-23,석남(거북시장),5174,2529,2645
2,2024-01-23,서부여성회관,6945,3530,3415
2,2024-01-23,인천가좌,7444,3730,3714
2,2024-01-23,가재울,7434,3816,3618
2,2024-01-23,주안국가산단,5479,2732,2747
2,2024-01-23,주안,12946,5425,7521
2,2024-01-23,시민공원(문화창작지대),17761,9075,8686
2,2024-01-23,석바위시장,7918,3856,4062
2,2024-01-23,인천시청,5632,2684,2948
2,2024-01-23,석천사거리,8191,4208,3983
2,2024-01-23,모래내시장,12645,6145,6500
2,2024-01-23,만수,8507,4344,4163
2,2024-01-23,남동구청,7513,3884,3629
2,2024-01-23,인천대공원,2668,1357,1311
2,2024-01-23,운연(서창),1879,997,882
2,2024-01-24,검단오류(검단산업단지),5758,2816,2942
2,2024-01-24,왕길,4528,2260,2268
2,2024-01-24,검단사거리,14475,7503,6972
2,2024-01-24,마전,7701,3738,3963
2,2024-01-24,완정,13887,7157,6730
2,2024-01-24,독정,7471,3721,3750
2,2024-01-24,검암,8128,4344,3784
2,2024-01-24,검바위,5113,2490,2623
2,2024-01-24,아시아드경기장(공촌사거리),8537,4538,3999
2,2024-01-24,서구청,15371,7602,7769
2,2024-01-24,가정(루원시티),21145,10881,10264
2,2024-01-24,가정중앙시장,10999,5303,5696
2,2024-01-24,석남(거북시장),5494,2657,2837
2,2024-01-24,서부여성회관,7649,3854,3795
2,2024-01-24,인천가좌,7655,3848,3807
2,2024-01-24,가재울,7667,3911,3756
2,2024-01-24,주안국가산단,5560,2744,2816
2,2024-01-24,주안,13590,5782,7808
2,2024-01-24,시민공원(문화창작지대),18749,9571,9178
2,2024-01-24,석바위시장,8315,4032,4283
2,2024-01-24,인천시청,6057,2948,3109
2,2024-01-24,석천사거리,8712,4485,4227
2,2024-01-24,모래내시장,14147,6858,7289
2,2024-01-24,만수,9287,4767,4520
2,2024-01-24,남동구청,7961,4108,3853
2,2024-01-24,인천대공원,2947,1536,1411
2,2024-01-24,운연(서창),2035,1046,989
2,2024-01-25,검단오류(검단산업단지),5918,2888,3030
2,2024-01-25,왕길,4797,2405,2392
2,2024-01-25,검단사거리,15330,7992,7338
2,2024-01-25,마전,7761,3789,3972
2,2024-01-25,완정,14256,7364,6892
2,2024-01-25,독정,7752,3867,3885
2,2024-01-25,검암,8319,4520,3799
2,2024-01-25,검바위,5586,2636,2950
2,2024-01-25,아시아드경기장(공촌사거리),8464,4542,3922
2,2024-01-25,서구청,16726,8347,8379
2,2024-01-25,가정(루원시티),22044,11355,10689
2,2024-01-25,가정중앙시장,11922,5807,6115
2,2024-01-25,석남(거북시장),5653,2768,2885
2,2024-01-25,서부여성회관,8321,4178,4143
2,2024-01-25,인천가좌,7810,3913,3897
2,2024-01-25,가재울,7791,3978,3813
2,2024-01-25,주안국가산단,5641,2806,2835
2,2024-01-25,주안,14006,6006,8000
2,2024-01-25,시민공원(문화창작지대),18957,9648,9309
2,2024-01-25,석바위시장,8788,4253,4535
2,2024-01-25,인천시청,6399,3053,3346
2,2024-01-25,석천사거리,9208,4736,4472
2,2024-01-25,모래내시장,14957,7303,7654
2,2024-01-25,만수,9789,5027,4762
2,2024-01-25,남동구청,8497,4432,4065
2,2024-01-25,인천대공원,3443,1736,1707
2,2024-01-25,운연(서창),2162,1163,999
2,2024-01-26,검단오류(검단산업단지),5898,2927,2971
2,2024-01-26,왕길,4843,2475,2368
2,2024-01-26,검단사거리,16482,8585,7897
2,2024-01-26,마전,7935,3922,4013
2,2024-01-26,완정,15194,7879,7315
2,2024-01-26,독정,8148,4094,4054
2,2024-01-26,검암,8568,4624,3944
2,2024-01-26,검바위,5372,2632,2740
2,2024-01-26,아시아드경기장(공촌사거리),8498,4580,3918
2,2024-01-26,서구청,17508,8637,8871
2,2024-01-26,가정(루원시티),22889,11847,11042
2,2024-01-26,가정중앙시장,12817,6251,6566
2,2024-01-26,석남(거북시장),6108,2992,3116
2,2024-01-26,서부여성회관,8653,4421,4232
2,2024-01-26,인천가좌,8162,4157,4005
2,2024-01-26,가재울,8382,4330,4052
2,2024-01-26,주안국가산단,5628,2783,2845
2,2024-01-26,주안,15492,6509,8983
2,2024-01-26,시민공원(문화창작지대),19922,10199,9723
2,2024-01-26,석바위시장,9133,4439,4694
2,2024-01-26,인천시청,6647,3238,3409
2,2024-01-26,석천사거리,9478,4925,4553
2,2024-01-26,모래내시장,16613,7988,8625
2,2024-01-26,만수,10368,5362,5006
2,2024-01-26,남동구청,8909,4664,4245
2,2024-01-26,인천대공원,4275,2204,2071
2,2024-01-26,운연(서창),2409,1297,1112
2,2024-01-27,검단오류(검단산업단지),1897,1055,842
2,2024-01-27,왕길,3029,1555,1474
2,2024-01-27,검단사거리,12977,6760,6217
2,2024-01-27,마전,5659,2797,2862
2,2024-01-27,완정,10450,5498,4952
2,2024-01-27,독정,5968,2953,3015
2,2024-01-27,검암,5403,2881,2522
2,2024-01-27,검바위,3957,1934,2023
2,2024-01-27,아시아드경기장(공촌사거리),6367,3353,3014
2,2024-01-27,서구청,10892,5421,5471
2,2024-01-27,가정(루원시티),14504,7513,6991
2,2024-01-27,가정중앙시장,10304,5098,5206
2,2024-01-27,석남(거북시장),4601,2226,2375
2,2024-01-27,서부여성회관,6072,3103,2969
2,2024-01-27,인천가좌,4673,2348,2325
2,2024-01-27,가재울,4445,2263,2182
2,2024-01-27,주안국가산단,1483,734,749
2,2024-01-27,주안,12633,5068,7565
2,2024-01-27,시민공원(문화창작지대),14371,7395,6976
2,2024-01-27,석바위시장,6630,3221,3409
2,2024-01-27,인천시청,4550,2121,2429
2,2024-01-27,석천사거리,6073,3202,2871
2,2024-01-27,모래내시장,13575,6634,6941
2,2024-01-27,만수,7584,3914,3670
2,2024-01-27,남동구청,5621,2862,2759
2,2024-01-27,인천대공원,5116,2598,2518
2,2024-01-27,운연(서창),1636,875,761
2,2024-01-28,검단오류(검단산업단지),1298,639,659
2,2024-01-28,왕길,1991,997,994
2,2024-01-28,검단사거리,9607,4792,4815
2,2024-01-28,마전,4016,1922,2094
2,2024-01-28,완정,7004,3473,3531
2,2024-01-28,독정,3811,1871,1940
2,2024-01-28,검암,3977,2061,1916
2,2024-01-28,검바위,2743,1303,1440
2,2024-01-28,아시아드경기장(공촌사거리),4892,2511,2381
2,2024-01-28,서구청,7868,3942,3926
2,2024-01-28,가정(루원시티),10060,5027,5033
2,2024-01-28,가정중앙시장,7509,3677,3832
2,2024-01-28,석남(거북시장),3326,1563,1763
2,2024-01-28,서부여성회관,4887,2504,2383
2,2024-01-28,인천가좌,3287,1586,1701
2,2024-01-28,가재울,3400,1723,1677
2,2024-01-28,주안국가산단,745,373,372
2,2024-01-28,주안,9001,3726,5275
2,2024-01-28,시민공원(문화창작지대),10753,5523,5230
2,2024-01-28,석바위시장,5089,2455,2634
2,2024-01-28,인천시청,3318,1540,1778
2,2024-01-28,석천사거리,4669,2457,2212
2,2024-01-28,모래내시장,10811,5292,5519
2,2024-01-28,만수,5756,2923,2833
2,2024-01-28,남동구청,4128,2117,2011
2,2024-01-28,인천대공원,4761,2454,2307
2,2024-01-28,운연(서창),1290,682,608
2,2024-01-29,검단오류(검단산업단지),6025,2961,3064
2,2024-01-29,왕길,4778,2442,2336
2,2024-01-29,검단사거리,15645,8095,7550
2,2024-01-29,마전,7959,3897,4062
2,2024-01-29,완정,14568,7437,7131
2,2024-01-29,독정,8131,4072,4059
2,2024-01-29,검암,8487,4609,3878
2,2024-01-29,검바위,6364,3070,3294
2,2024-01-29,아시아드경기장(공촌사거리),8434,4514,3920
2,2024-01-29,서구청,16257,8073,8184
2,2024-01-29,가정(루원시티),22215,11436,10779
2,2024-01-29,가정중앙시장,12202,5931,6271
2,2024-01-29,석남(거북시장),5932,2893,3039
2,2024-01-29,서부여성회관,7845,3983,3862
2,2024-01-29,인천가좌,8071,4077,3994
2,2024-01-29,가재울,8033,4141,3892
2,2024-01-29,주안국가산단,5745,2811,2934
2,2024-01-29,주안,14378,6136,8242
2,2024-01-29,시민공원(문화창작지대),19343,9911,9432
2,2024-01-29,석바위시장,8755,4256,4499
2,2024-01-29,인천시청,6173,2981,3192
2,2024-01-29,석천사거리,9002,4704,4298
2,2024-01-29,모래내시장,15716,7633,8083
2,2024-01-29,만수,9616,4987,4629
2,2024-01-29,남동구청,8468,4395,4073
2,2024-01-29,인천대공원,4111,2128,1983
2,2024-01-29,운연(서창),2268,1202,1066
2,2024-01-30,검단오류(검단산업단지),6002,2985,3017
2,2024-01-30,왕길,4910,2489,2421
2,2024-01-30,검단사거리,15720,8146,7574
2,2024-01-30,마전,8152,3973,4179
2,2024-01-30,완정,14817,7681,7136
2,2024-01-30,독정,8124,4054,4070
2,2024-01-30,검암,8723,4679,4044
2,2024-01-30,검바위,6035,2910,3125
2,2024-01-30,아시아드경기장(공촌사거리),8573,4587,3986
2,2024-01-30,서구청,16709,8247,8462
2,2024-01-30,가정(루원시티),22391,11515,10876
2,2024-01-30,가정중앙시장,12623,6101,6522
2,2024-01-30,석남(거북시장),6041,2965,3076
2,2024-01-30,서부여성회관,7927,4027,3900
2,2024-01-30,인천가좌,8173,4074,4099
2,2024-01-30,가재울,8299,4260,4039
2,2024-01-30,주안국가산단,5819,2867,2952
2,2024-01-30,주안,14592,6225,8367
2,2024-01-30,시민공원(문화창작지대),19637,9973,9664
2,2024-01-30,석바위시장,8989,4347,4642
2,2024-01-30,인천시청,6434,3135,3299
2,2024-01-30,석천사거리,9125,4764,4361
2,2024-01-30,모래내시장,15911,7772,8139
2,2024-01-30,만수,9693,4969,4724
2,2024-01-30,남동구청,8602,4427,4175
2,2024-01-30,인천대공원,4602,2337,2265
2,2024-01-30,운연(서창),2366,1248,1118
2,2024-01-31,검단오류(검단산업단지),6039,2975,3064
2,2024-01-31,왕길,4796,2429,2367
2,2024-01-31,검단사거리,15826,8278,7548
2,2024-01-31,마전,8084,3970,4114
2,2024-01-31,완정,14783,7576,7207
2,2024-01-31,독정,8304,4160,4144
2,2024-01-31,검암,8655,4651,4004
2,2024-01-31,검바위,6068,2945,3123
2,2024-01-31,아시아드경기장(공촌사거리),8869,4707,4162
2,2024-01-31,서구청,16787,8272,8515
2,2024-01-31,가정(루원시티),22690,11731,10959
2,2024-01-31,가정중앙시장,12737,6195,6542
2,2024-01-31,석남(거북시장),6075,2954,3121
2,2024-01-31,서부여성회관,8434,4273,4161
2,2024-01-31,인천가좌,8213,4134,4079
2,2024-01-31,가재울,8421,4324,4097
2,2024-01-31,주안국가산단,5857,2892,2965
2,2024-01-31,주안,14619,6297,8322
2,2024-01-31,시민공원(문화창작지대),19879,10171,9708
2,2024-01-31,석바위시장,8910,4339,4571
2,2024-01-31,인천시청,6664,3242,3422
2,2024-01-31,석천사거리,9175,4732,4443
2,2024-01-31,모래내시장,15912,7664,8248
2,2024-01-31,만수,9817,5046,4771
2,2024-01-31,남동구청,8744,4548,4196
2,2024-01-31,인천대공원,4574,2341,2233
2,2024-01-31,운연(서창),2376,1256,1120
2,2024-02-01,검단오류(검단산업단지),6015,2969,3046
2,2024-02-01,왕길,4987,2504,2483
2,2024-02-01,검단사거리,15768,8217,7551
2,2024-02-01,마전,8109,3970,4139
2,2024-02-01,완정,14809,7652,7157
2,2024-02-01,독정,8376,4184,4192
2,2024-02-01,검암,8759,4767,3992
2,2024-02-01,검바위,6224,3038,3186
2,2024-02-01,아시아드경기장(공촌사거리),8598,4559,4039
2,2024-02-01,서구청,16461,8149,8312
2,2024-02-01,가정(루원시티),22657,11696,10961
2,2024-02-01,가정중앙시장,12368,6025,6343
2,2024-02-01,석남(거북시장),5979,2904,3075
2,2024-02-01,서부여성회관,8121,4072,4049
2,2024-02-01,인천가좌,8171,4098,4073
2,2024-02-01,가재울,8169,4209,3960
2,2024-02-01,주안국가산단,5687,2774,2913
2,2024-02-01,주안,14770,6282,8488
2,2024-02-01,시민공원(문화창작지대),19688,10090,9598
2,2024-02-01,석바위시장,8762,4279,4483
2,2024-02-01,인천시청,6708,3196,3512
2,2024-02-01,석천사거리,9341,4870,4471
2,2024-02-01,모래내시장,15841,7687,8154
2,2024-02-01,만수,9728,5001,4727
2,2024-02-01,남동구청,8653,4474,4179
2,2024-02-01,인천대공원,4514,2266,2248
2,2024-02-01,운연(서창),2334,1238,1096
2,2024-02-02,검단오류(검단산업단지),5934,2911,3023
2,2024-02-02,왕길,4994,2581,2413
2,2024-02-02,검단사거리,17113,8875,8238
2,2024-02-02,마전,8319,4128,4191
2,2024-02-02,완정,15246,7950,7296
2,2024-02-02,독정,8467,4280,4187
2,2024-02-02,검암,8771,4810,3961
2,2024-02-02,검바위,6689,3204,3485
2,2024-02-02,아시아드경기장(공촌사거리),8958,4786,4172
2,2024-02-02,서구청,17158,8463,8695
2,2024-02-02,가정(루원시티),23274,12045,11229
2,2024-02-02,가정중앙시장,13142,6435,6707
2,2024-02-02,석남(거북시장),6417,3104,3313
2,2024-02-02,서부여성회관,8764,4406,4358
2,2024-02-02,인천가좌,8374,4237,4137
2,2024-02-02,가재울,8560,4359,4201
2,2024-02-02,주안국가산단,5672,2752,2920
2,2024-02-02,주안,15256,6450,8806
2,2024-02-02,시민공원(문화창작지대),20021,10290,9731
2,2024-02-02,석바위시장,9235,4488,4747
2,2024-02-02,인천시청,6478,3092,3386
2,2024-02-02,석천사거리,9305,4888,4417
2,2024-02-02,모래내시장,16473,7979,8494
2,2024-02-02,만수,10117,5245,4872
2,2024-02-02,남동구청,8826,4610,4216
2,2024-02-02,인천대공원,4445,2281,2164
2,2024-02-02,운연(서창),2389,1287,1102
2,2024-02-03,검단오류(검단산업단지),2131,1133,998
2,2024-02-03,왕길,3038,1588,1450
2,2024-02-03,검단사거리,12778,6614,6164
2,2024-02-03,마전,5659,2847,2812
2,2024-02-03,완정,9821,5179,4642
2,2024-02-03,독정,5963,2987,2976
2,2024-02-03,검암,5405,2918,2487
2,2024-02-03,검바위,3817,1853,1964
2,2024-02-03,아시아드경기장(공촌사거리),6252,3267,2985
2,2024-02-03,서구청,10898,5444,5454
2,2024-02-03,가정(루원시티),13999,7277,6722
2,2024-02-03,가정중앙시장,10352,5081,5271
2,2024-02-03,석남(거북시장),4460,2143,2317
2,2024-02-03,서부여성회관,5998,3050,2948
2,2024-02-03,인천가좌,4544,2298,2246
2,2024-02-03,가재울,4596,2359,2237
2,2024-02-03,주안국가산단,1429,693,736
2,2024-02-03,주안,11787,4692,7095
2,2024-02-03,시민공원(문화창작지대),13872,7108,6764
2,2024-02-03,석바위시장,6745,3269,3476
2,2024-02-03,인천시청,4710,2251,2459
2,2024-02-03,석천사거리,6205,3225,2980
2,2024-02-03,모래내시장,13449,6562,6887
2,2024-02-03,만수,7411,3785,3626
2,2024-02-03,남동구청,5447,2816,2631
2,2024-02-03,인천대공원,4530,2304,2226
2,2024-02-03,운연(서창),1635,864,771
2,2024-02-04,검단오류(검단산업단지),1303,651,652
2,2024-02-04,왕길,2016,1018,998
2,2024-02-04,검단사거리,9586,4756,4830
2,2024-02-04,마전,4148,1976,2172
2,2024-02-04,완정,7308,3664,3644
2,2024-02-04,독정,4582,2268,2314
2,2024-02-04,검암,3878,2047,1831
2,2024-02-04,검바위,2914,1385,1529
2,2024-02-04,아시아드경기장(공촌사거리),5027,2706,2321
2,2024-02-04,서구청,8096,4010,4086
2,2024-02-04,가정(루원시티),10352,5251,5101
2,2024-02-04,가정중앙시장,7859,3856,4003
2,2024-02-04,석남(거북시장),3490,1623,1867
2,2024-02-04,서부여성회관,5016,2549,2467
2,2024-02-04,인천가좌,3321,1677,1644
2,2024-02-04,가재울,3534,1790,1744
2,2024-02-04,주안국가산단,805,402,403
2,2024-02-04,주안,9237,3801,5436
2,2024-02-04,시민공원(문화창작지대),10892,5605,5287
2,2024-02-04,석바위시장,5328,2556,2772
2,2024-02-04,인천시청,3536,1687,1849
2,2024-02-04,석천사거리,4809,2532,2277
2,2024-02-04,모래내시장,10986,5436,5550
2,2024-02-04,만수,5878,3079,2799
2,2024-02-04,남동구청,4278,2262,2016
2,2024-02-04,인천대공원,5204,2600,2604
2,2024-02-04,운연(서창),1231,629,602
2,2024-02-05,검단오류(검단산업단지),5750,2823,2927
2,2024-02-05,왕길,4741,2380,2361
2,2024-02-05,검단사거리,14913,7779,7134
2,2024-02-05,마전,7900,3808,4092
2,2024-02-05,완정,14078,7219,6859
2,2024-02-05,독정,7826,3915,3911
2,2024-02-05,검암,8486,4602,3884
2,2024-02-05,검바위,5558,2711,2847
2,2024-02-05,아시아드경기장(공촌사거리),8109,4334,3775
2,2024-02-05,서구청,15324,7675,7649
2,2024-02-05,가정(루원시티),21569,10999,10570
2,2024-02-05,가정중앙시장,11439,5482,5957
2,2024-02-05,석남(거북시장),5538,2703,2835
2,2024-02-05,서부여성회관,7194,3676,3518
2,2024-02-05,인천가좌,7986,4034,3952
2,2024-02-05,가재울,7910,4008,3902
2,2024-02-05,주안국가산단,5847,2919,2928
2,2024-02-05,주안,13935,5979,7956
2,2024-02-05,시민공원(문화창작지대),18869,9657,9212
2,2024-02-05,석바위시장,8567,4160,4407
2,2024-02-05,인천시청,6147,2970,3177
2,2024-02-05,석천사거리,8907,4611,4296
2,2024-02-05,모래내시장,13955,6820,7135
2,2024-02-05,만수,8845,4520,4325
2,2024-02-05,남동구청,8055,4176,3879
2,2024-02-05,인천대공원,2513,1285,1228
2,2024-02-05,운연(서창),2040,1093,947
2,2024-02-06,검단오류(검단산업단지),6000,2961,3039
2,2024-02-06,왕길,4974,2511,2463
2,2024-02-06,검단사거리,16166,8363,7803
2,2024-02-06,마전,8239,4005,4234
2,2024-02-06,완정,14781,7666,7115
2,2024-02-06,독정,8418,4209,4209
2,2024-02-06,검암,8664,4717,3947
2,2024-02-06,검바위,5766,2729,3037
2,2024-02-06,아시아드경기장(공촌사거리),8998,4774,4224
2,2024-02-06,서구청,16863,8367,8496
2,2024-02-06,가정(루원시티),22497,11648,10849
2,2024-02-06,가정중앙시장,13239,6493,6746
2,2024-02-06,석남(거북시장),5986,2943,3043
2,2024-02-06,서부여성회관,7952,4101,3851
2,2024-02-06,인천가좌,8547,4284,4263
2,2024-02-06,가재울,8289,4285,4004
2,2024-02-06,주안국가산단,5837,2876,2961
2,2024-02-06,주안,14728,6362,8366
2,2024-02-06,시민공원(문화창작지대),19776,10139,9637
2,2024-02-06,석바위시장,9357,4501,4856
2,2024-02-06,인천시청,6858,3187,3671
2,2024-02-06,석천사거리,9343,4877,4466
2,2024-02-06,모래내시장,16503,8015,8488
2,2024-02-06,만수,9776,5040,4736
2,2024-02-06,남동구청,8715,4503,4212
2,2024-02-06,인천대공원,3681,1872,1809
2,2024-02-06,운연(서창),2297,1209,1088
2,2024-02-07,검단오류(검단산업단지),5878,2925,2953
2,2024-02-07,왕길,4943,2501,2442
2,2024-02-07,검단사거리,16148,8460,7688
2,2024-02-07,마전,8202,4066,4136
2,2024-02-07,완정,14796,7615,7181
2,2024-02-07,독정,8710,4321,4389
2,2024-02-07,검암,8693,4688,4005
2,2024-02-07,검바위,5948,2905,3043
2,2024-02-07,아시아드경기장(공촌사거리),9017,4778,4239
2,2024-02-07,서구청,16539,8219,8320
2,2024-02-07,가정(루원시티),22672,11646,11026
2,2024-02-07,가정중앙시장,13603,6586,7017
2,2024-02-07,석남(거북시장),6180,3010,3170
2,2024-02-07,서부여성회관,8184,4104,4080
2,2024-02-07,인천가좌,8505,4253,4252
2,2024-02-07,가재울,8529,4308,4221
2,2024-02-07,주안국가산단,5823,2825,2998
2,2024-02-07,주안,15110,6376,8734
2,2024-02-07,시민공원(문화창작지대),19785,10081,9704
2,2024-02-07,석바위시장,9384,4546,4838
2,2024-02-07,인천시청,6759,3221,3538
2,2024-02-07,석천사거리,9309,4878,4431
2,2024-02-07,모래내시장,16929,8164,8765
2,2024-02-07,만수,9776,5097,4679
2,2024-02-07,남동구청,8993,4623,4370
2,2024-02-07,인천대공원,3934,2038,1896
2,2024-02-07,운연(서창),2377,1279,1098
2,2024-02-08,검단오류(검단산업단지),5105,2511,2594
2,2024-02-08,왕길,4562,2299,2263
2,2024-02-08,검단사거리,16506,8665,7841
2,2024-02-08,마전,7761,3817,3944
2,2024-02-08,완정,14422,7579,6843
2,2024-02-08,독정,8163,4109,4054
2,2024-02-08,검암,8057,4425,3632
2,2024-02-08,검바위,5072,2484,2588
2,2024-02-08,아시아드경기장(공촌사거리),8208,4425,3783
2,2024-02-08,서구청,16466,8173,8293
2,2024-02-08,가정(루원시티),21080,10975,10105
2,2024-02-08,가정중앙시장,14552,6960,7592
2,2024-02-08,석남(거북시장),5937,2867,3070
2,2024-02-08,서부여성회관,8263,4231,4032
2,2024-02-08,인천가좌,7584,3802,3782
2,2024-02-08,가재울,7834,4021,3813
2,2024-02-08,주안국가산단,5199,2560,2639
2,2024-02-08,주안,15002,6321,8681
2,2024-02-08,시민공원(문화창작지대),18806,9670,9136
2,2024-02-08,석바위시장,8893,4283,4610
2,2024-02-08,인천시청,6210,2965,3245
2,2024-02-08,석천사거리,8846,4568,4278
2,2024-02-08,모래내시장,17219,8295,8924
2,2024-02-08,만수,9739,5046,4693
2,2024-02-08,남동구청,8526,4460,4066
2,2024-02-08,인천대공원,3910,1989,1921
2,2024-02-08,운연(서창),2209,1162,1047
2,2024-02-09,검단오류(검단산업단지),1568,941,627
2,2024-02-09,왕길,1709,871,838
2,2024-02-09,검단사거리,9585,5010,4575
2,2024-02-09,마전,3428,1585,1843
2,2024-02-09,완정,5944,3121,2823
2,2024-02-09,독정,3980,1990,1990
2,2024-02-09,검암,3247,1769,1478
2,2024-02-09,검바위,2613,1300,1313
2,2024-02-09,아시아드경기장(공촌사거리),4273,2290,1983
2,2024-02-09,서구청,6674,3334,3340
2,2024-02-09,가정(루원시티),7905,4110,3795
2,2024-02-09,가정중앙시장,8534,4076,4458
2,2024-02-09,석남(거북시장),3064,1481,1583
2,2024-02-09,서부여성회관,4451,2271,2180
2,2024-02-09,인천가좌,3022,1500,1522
2,2024-02-09,가재울,2766,1396,1370
2,2024-02-09,주안국가산단,616,324,292
2,2024-02-09,주안,7731,3275,4456
2,2024-02-09,시민공원(문화창작지대),7647,3911,3736
2,2024-02-09,석바위시장,3744,1783,1961
2,2024-02-09,인천시청,2605,1203,1402
2,2024-02-09,석천사거리,3495,1769,1726
2,2024-02-09,모래내시장,9901,4799,5102
2,2024-02-09,만수,4897,2524,2373
2,2024-02-09,남동구청,3600,1835,1765
2,2024-02-09,인천대공원,3012,1554,1458
2,2024-02-09,운연(서창),975,513,462
2,2024-02-10,검단오류(검단산업단지),1282,671,611
2,2024-02-10,왕길,1265,654,611
2,2024-02-10,검단사거리,8384,4228,4156
2,2024-02-10,마전,2869,1460,1409
2,2024-02-10,완정,4668,2412,2256
2,2024-02-10,독정,3171,1594,1577
2,2024-02-10,검암,2590,1470,1120
2,2024-02-10,검바위,2175,1070,1105
2,2024-02-10,아시아드경기장(공촌사거리),3483,1868,1615
2,2024-02-10,서구청,5009,2474,2535
2,2024-02-10,가정(루원시티),6457,3264,3193
2,2024-02-10,가정중앙시장,5345,2613,2732
2,2024-02-10,석남(거북시장),2583,1222,1361
2,2024-02-10,서부여성회관,4097,2098,1999
2,2024-02-10,인천가좌,2811,1464,1347
2,2024-02-10,가재울,2346,1184,1162
2,2024-02-10,주안국가산단,396,205,191
2,2024-02-10,주안,7513,3029,4484
2,2024-02-10,시민공원(문화창작지대),6506,3371,3135
2,2024-02-10,석바위시장,2606,1275,1331
2,2024-02-10,인천시청,2089,953,1136
2,2024-02-10,석천사거리,2918,1543,1375
2,2024-02-10,모래내시장,5474,2682,2792
2,2024-02-10,만수,3992,2054,1938
2,2024-02-10,남동구청,2949,1544,1405
2,2024-02-10,인천대공원,2748,1404,1344
2,2024-02-10,운연(서창),901,459,442
2,2024-02-11,검단오류(검단산업단지),1371,704,667
2,2024-02-11,왕길,1570,812,758
2,2024-02-11,검단사거리,9748,4826,4922
2,2024-02-11,마전,3370,1623,1747
2,2024-02-11,완정,6345,3255,3090
2,2024-02-11,독정,3558,1789,1769
2,2024-02-11,검암,3345,1828,1517
2,2024-02-11,검바위,2538,1238,1300
2,2024-02-11,아시아드경기장(공촌사거리),4222,2278,1944
2,2024-02-11,서구청,6584,3165,3419
2,2024-02-11,가정(루원시티),9006,4557,4449
2,2024-02-11,가정중앙시장,6080,3114,2966
2,2024-02-11,석남(거북시장),3147,1490,1657
2,2024-02-11,서부여성회관,4801,2511,2290
2,2024-02-11,인천가좌,3225,1638,1587
2,2024-02-11,가재울,2920,1486,1434
2,2024-02-11,주안국가산단,450,208,242
2,2024-02-11,주안,8619,3433,5186
2,2024-02-11,시민공원(문화창작지대),9211,4691,4520
2,2024-02-11,석바위시장,3671,1783,1888
2,2024-02-11,인천시청,2830,1344,1486
2,2024-02-11,석천사거리,4032,2163,1869
2,2024-02-11,모래내시장,8157,4020,4137
2,2024-02-11,만수,5227,2731,2496
2,2024-02-11,남동구청,3730,1945,1785
2,2024-02-11,인천대공원,4842,2409,2433
2,2024-02-11,운연(서창),1058,588,470
2,2024-02-12,검단오류(검단산업단지),1439,653,786
2,2024-02-12,왕길,1953,1005,948
2,2024-02-12,검단사거리,9844,4832,5012
2,2024-02-12,마전,4217,2069,2148
2,2024-02-12,완정,6797,3417,3380
2,2024-02-12,독정,4249,2106,2143
2,2024-02-12,검암,3843,2047,1796
2,2024-02-12,검바위,2786,1327,1459
2,2024-02-12,아시아드경기장(공촌사거리),4350,2315,2035
2,2024-02-12,서구청,6981,3477,3504
2,2024-02-12,가정(루원시티),9699,4938,4761
2,2024-02-12,가정중앙시장,6596,3200,3396
2,2024-02-12,석남(거북시장),3382,1613,1769
2,2024-02-12,서부여성회관,4242,2186,2056
2,2024-02-12,인천가좌,3632,1825,1807
2,2024-02-12,가재울,3138,1566,1572
2,2024-02-12,주안국가산단,748,363,385
2,2024-02-12,주안,9122,3817,5305
2,2024-02-12,시민공원(문화창작지대),9642,4945,4697
2,2024-02-12,석바위시장,4323,2145,2178
2,2024-02-12,인천시청,3243,1499,1744
2,2024-02-12,석천사거리,4633,2499,2134
2,2024-02-12,모래내시장,9164,4515,4649
2,2024-02-12,만수,5601,2880,2721
2,2024-02-12,남동구청,3912,2012,1900
2,2024-02-12,인천대공원,6254,3145,3109
2,2024-02-12,운연(서창),1307,701,606
2,2024-02-13,검단오류(검단산업단지),5434,2675,2759
2,2024-02-13,왕길,4574,2314,2260
2,2024-02-13,검단사거리,15726,8129,7597
2,2024-02-13,마전,7825,3848,3977
2,2024-02-13,완정,14158,7249,6909
2,2024-02-13,독정,7802,3893,3909
2,2024-02-13,검암,8091,4274,3817
2,2024-02-13,검바위,5104,2428,2676
2,2024-02-13,아시아드경기장(공촌사거리),8249,4398,3851
2,2024-02-13,서구청,16230,8064,8166
2,2024-02-13,가정(루원시티),20805,10683,10122
2,2024-02-13,가정중앙시장,11598,5673,5925
2,2024-02-13,석남(거북시장),5801,2827,2974
2,2024-02-13,서부여성회관,7638,3855,3783
2,2024-02-13,인천가좌,7893,3969,3924
2,2024-02-13,가재울,7897,4045,3852
2,2024-02-13,주안국가산단,4915,2406,2509
2,2024-02-13,주안,14555,6232,8323
2,2024-02-13,시민공원(문화창작지대),19066,9749,9317
2,2024-02-13,석바위시장,8607,4235,4372
2,2024-02-13,인천시청,6238,2995,3243
2,2024-02-13,석천사거리,8843,4637,4206
2,2024-02-13,모래내시장,14850,7217,7633
2,2024-02-13,만수,9364,4810,4554
2,2024-02-13,남동구청,8266,4286,3980
2,2024-02-13,인천대공원,4891,2472,2419
2,2024-02-13,운연(서창),2245,1210,1035
2,2024-02-14,검단오류(검단산업단지),6058,3009,3049
2,2024-02-14,왕길,4988,2563,2425
2,2024-02-14,검단사거리,16674,8663,8011
2,2024-02-14,마전,8571,4189,4382
2,2024-02-14,완정,15045,7718,7327
2,2024-02-14,독정,8730,4354,4376
2,2024-02-14,검암,8770,4730,4040
2,2024-02-14,검바위,5507,2636,2871
2,2024-02-14,아시아드경기장(공촌사거리),9099,4805,4294
2,2024-02-14,서구청,16520,8190,8330
2,2024-02-14,가정(루원시티),23141,12033,11108
2,2024-02-14,가정중앙시장,12328,5963,6365
2,2024-02-14,석남(거북시장),6228,3009,3219
2,2024-02-14,서부여성회관,8321,4206,4115
2,2024-02-14,인천가좌,8603,4349,4254
2,2024-02-14,가재울,8309,4239,4070
2,2024-02-14,주안국가산단,5833,2883,2950
2,2024-02-14,주안,15668,6630,9038
2,2024-02-14,시민공원(문화창작지대),20330,10352,9978
2,2024-02-14,석바위시장,8856,4308,4548
2,2024-02-14,인천시청,6837,3249,3588
2,2024-02-14,석천사거리,9577,5006,4571
2,2024-02-14,모래내시장,15463,7581,7882
2,2024-02-14,만수,9995,5099,4896
2,2024-02-14,남동구청,9017,4669,4348
2,2024-02-14,인천대공원,5082,2559,2523
2,2024-02-14,운연(서창),2488,1338,1150
2,2024-02-15,검단오류(검단산업단지),5796,2855,2941
2,2024-02-15,왕길,4713,2409,2304
2,2024-02-15,검단사거리,14925,7758,7167
2,2024-02-15,마전,7890,3847,4043
2,2024-02-15,완정,13957,7228,6729
2,2024-02-15,독정,7667,3825,3842
2,2024-02-15,검암,8385,4561,3824
2,2024-02-15,검바위,5139,2504,2635
2,2024-02-15,아시아드경기장(공촌사거리),8304,4391,3913
2,2024-02-15,서구청,15625,7696,7929
2,2024-02-15,가정(루원시티),21790,11242,10548
2,2024-02-15,가정중앙시장,10919,5279,5640
2,2024-02-15,석남(거북시장),5473,2644,2829
2,2024-02-15,서부여성회관,7574,3835,3739
2,2024-02-15,인천가좌,7964,4010,3954
2,2024-02-15,가재울,7757,4000,3757
2,2024-02-15,주안국가산단,5761,2805,2956
2,2024-02-15,주안,14450,6093,8357
2,2024-02-15,시민공원(문화창작지대),19120,9817,9303
2,2024-02-15,석바위시장,8330,4086,4244
2,2024-02-15,인천시청,6271,2980,3291
2,2024-02-15,석천사거리,8854,4627,4227
2,2024-02-15,모래내시장,13520,6559,6961
2,2024-02-15,만수,9077,4639,4438
2,2024-02-15,남동구청,8078,4213,3865
2,2024-02-15,인천대공원,2773,1423,1350
2,2024-02-15,운연(서창),2149,1132,1017
2,2024-02-16,검단오류(검단산업단지),5889,2894,2995
2,2024-02-16,왕길,4977,2562,2415
2,2024-02-16,검단사거리,17079,8908,8171
2,2024-02-16,마전,8494,4204,4290
2,2024-02-16,완정,15512,8068,7444
2,2024-02-16,독정,8423,4199,4224
2,2024-02-16,검암,8977,4924,4053
2,2024-02-16,검바위,5429,2656,2773
2,2024-02-16,아시아드경기장(공촌사거리),8797,4712,4085
2,2024-02-16,서구청,17512,8586,8926
2,2024-02-16,가정(루원시티),23911,12412,11499
2,2024-02-16,가정중앙시장,12733,6243,6490
2,2024-02-16,석남(거북시장),6303,3040,3263
2,2024-02-16,서부여성회관,8881,4476,4405
2,2024-02-16,인천가좌,8351,4165,4186
2,2024-02-16,가재울,8524,4406,4118
2,2024-02-16,주안국가산단,5797,2843,2954
2,2024-02-16,주안,16569,6908,9661
2,2024-02-16,시민공원(문화창작지대),20691,10575,10116
2,2024-02-16,석바위시장,9257,4485,4772
2,2024-02-16,인천시청,6954,3347,3607
2,2024-02-16,석천사거리,9770,5114,4656
2,2024-02-16,모래내시장,16552,8078,8474
2,2024-02-16,만수,10377,5316,5061
2,2024-02-16,남동구청,8959,4668,4291
2,2024-02-16,인천대공원,4945,2539,2406
2,2024-02-16,운연(서창),2525,1346,1179
2,2024-02-17,검단오류(검단산업단지),2144,1180,964
2,2024-02-17,왕길,3213,1640,1573
2,2024-02-17,검단사거리,13668,7067,6601
2,2024-02-17,마전,6176,3090,3086
2,2024-02-17,완정,10876,5654,5222
2,2024-02-17,독정,6417,3292,3125
2,2024-02-17,검암,5814,3158,2656
2,2024-02-17,검바위,4009,1946,2063
2,2024-02-17,아시아드경기장(공촌사거리),6687,3528,3159
2,2024-02-17,서구청,11303,5559,5744
2,2024-02-17,가정(루원시티),15484,7951,7533
2,2024-02-17,가정중앙시장,10664,5284,5380
2,2024-02-17,석남(거북시장),4655,2245,2410
2,2024-02-17,서부여성회관,6249,3176,3073
2,2024-02-17,인천가좌,4907,2495,2412
2,2024-02-17,가재울,4895,2515,2380
2,2024-02-17,주안국가산단,1475,733,742
2,2024-02-17,주안,13527,5451,8076
2,2024-02-17,시민공원(문화창작지대),15270,7773,7497
2,2024-02-17,석바위시장,7019,3405,3614
2,2024-02-17,인천시청,4593,2169,2424
2,2024-02-17,석천사거리,6713,3529,3184
2,2024-02-17,모래내시장,13944,6840,7104
2,2024-02-17,만수,7992,4112,3880
2,2024-02-17,남동구청,5952,3098,2854
2,2024-02-17,인천대공원,6381,3224,3157
2,2024-02-17,운연(서창),1766,926,840
2,2024-02-18,검단오류(검단산업단지),1206,609,597
2,2024-02-18,왕길,1843,902,941
2,2024-02-18,검단사거리,9250,4653,4597
2,2024-02-18,마전,4254,1999,2255
2,2024-02-18,완정,7012,3550,3462
2,2024-02-18,독정,4105,1964,2141
2,2024-02-18,검암,4069,2141,1928
2,2024-02-18,검바위,2927,1385,1542
2,2024-02-18,아시아드경기장(공촌사거리),4893,2581,2312
2,2024-02-18,서구청,7380,3653,3727
2,2024-02-18,가정(루원시티),10049,5054,4995
2,2024-02-18,가정중앙시장,6975,3393,3582
2,2024-02-18,석남(거북시장),3179,1468,1711
2,2024-02-18,서부여성회관,4997,2543,2454
2,2024-02-18,인천가좌,3118,1569,1549
2,2024-02-18,가재울,3273,1675,1598
2,2024-02-18,주안국가산단,716,352,364
2,2024-02-18,주안,8842,3533,5309
2,2024-02-18,시민공원(문화창작지대),10515,5320,5195
2,2024-02-18,석바위시장,4972,2416,2556
2,2024-02-18,인천시청,3469,1634,1835
2,2024-02-18,석천사거리,4748,2444,2304
2,2024-02-18,모래내시장,9481,4625,4856
2,2024-02-18,만수,5624,2898,2726
2,2024-02-18,남동구청,4471,2316,2155
2,2024-02-18,인천대공원,4293,2131,2162
2,2024-02-18,운연(서창),1206,652,554
2,2024-02-19,검단오류(검단산업단지),5744,2808,2936
2,2024-02-19,왕길,4666,2372,2294
2,2024-02-19,검단사거리,15318,7884,7434
2,2024-02-19,마전,7652,3716,3936
2,2024-02-19,완정,14146,7330,6816
2,2024-02-19,독정,7623,3818,3805
2,2024-02-19,검암,8362,4502,3860
2,2024-02-19,검바위,5419,2627,2792
2,2024-02-19,아시아드경기장(공촌사거리),8208,4345,3863
2,2024-02-19,서구청,15790,7823,7967
2,2024-02-19,가정(루원시티),21526,11115,10411
2,2024-02-19,가정중앙시장,11181,5428,5753
2,2024-02-19,석남(거북시장),5754,2815,2939
2,2024-02-19,서부여성회관,7450,3775,3675
2,2024-02-19,인천가좌,8033,4053,3980
2,2024-02-19,가재울,7877,4008,3869
2,2024-02-19,주안국가산단,5686,2800,2886
2,2024-02-19,주안,14111,5945,8166
2,2024-02-19,시민공원(문화창작지대),18999,9795,9204
2,2024-02-19,석바위시장,8350,4031,4319
2,2024-02-19,인천시청,6151,2922,3229
2,2024-02-19,석천사거리,9250,4818,4432
2,2024-02-19,모래내시장,13848,6732,7116
2,2024-02-19,만수,9294,4775,4519
2,2024-02-19,남동구청,8109,4267,3842
2,2024-02-19,인천대공원,2887,1455,1432
2,2024-02-19,운연(서창),2185,1141,1044
2,2024-02-20,검단오류(검단산업단지),5914,2909,3005
2,2024-02-20,왕길,5055,2569,2486
2,2024-02-20,검단사거리,16433,8474,7959
2,2024-02-20,마전,8316,4021,4295
2,2024-02-20,완정,14587,7547,7040
2,2024-02-20,독정,8017,4034,3983
2,2024-02-20,검암,8874,4738,4136
2,2024-02-20,검바위,6061,2899,3162
2,2024-02-20,아시아드경기장(공촌사거리),8850,4712,4138
2,2024-02-20,서구청,16862,8376,8486
2,2024-02-20,가정(루원시티),23054,11895,11159
2,2024-02-20,가정중앙시장,12436,6011,6425
2,2024-02-20,석남(거북시장),5792,2830,2962
2,2024-02-20,서부여성회관,7919,4069,3850
2,2024-02-20,인천가좌,8392,4157,4235
2,2024-02-20,가재울,8135,4134,4001
2,2024-02-20,주안국가산단,5897,2966,2931
2,2024-02-20,주안,14747,6276,8471
2,2024-02-20,시민공원(문화창작지대),20086,10271,9815
2,2024-02-20,석바위시장,8913,4321,4592
2,2024-02-20,인천시청,6636,3177,3459
2,2024-02-20,석천사거리,9715,4992,4723
2,2024-02-20,모래내시장,15104,7368,7736
2,2024-02-20,만수,10021,5189,4832
2,2024-02-20,남동구청,8924,4609,4315
2,2024-02-20,인천대공원,4007,2016,1991
2,2024-02-20,운연(서창),2275,1211,1064
2,2024-02-21,검단오류(검단산업단지),5761,2858,2903
2,2024-02-21,왕길,4788,2420,2368
2,2024-02-21,검단사거리,15059,7859,7200
2,2024-02-21,마전,7943,3854,4089
2,2024-02-21,완정,14189,7297,6892
2,2024-02-21,독정,7657,3824,3833
2,2024-02-21,검암,8726,4695,4031
2,2024-02-21,검바위,5098,2483,2615
2,2024-02-21,아시아드경기장(공촌사거리),8346,4417,3929
2,2024-02-21,서구청,15568,7774,7794
2,2024-02-21,가정(루원시티),21812,11185,10627
2,2024-02-21,가정중앙시장,11309,5502,5807
2,2024-02-21,석남(거북시장),5665,2740,2925
2,2024-02-21,서부여성회관,7775,3857,3918
2,2024-02-21,인천가좌,8105,4061,4044
2,2024-02-21,가재울,7819,3973,3846
2,2024-02-21,주안국가산단,5811,2887,2924
2,2024-02-21,주안,14126,5841,8285
2,2024-02-21,시민공원(문화창작지대),19368,9852,9516
2,2024-02-21,석바위시장,8728,4267,4461
2,2024-02-21,인천시청,6441,3084,3357
2,2024-02-21,석천사거리,9360,4835,4525
2,2024-02-21,모래내시장,13922,6786,7136
2,2024-02-21,만수,9455,4851,4604
2,2024-02-21,남동구청,8556,4426,4130
2,2024-02-21,인천대공원,2661,1386,1275
2,2024-02-21,운연(서창),2075,1108,967
2,2024-02-22,검단오류(검단산업단지),6226,3017,3209
2,2024-02-22,왕길,5143,2610,2533
2,2024-02-22,검단사거리,16552,8641,7911
2,2024-02-22,마전,8699,4291,4408
2,2024-02-22,완정,15537,8010,7527
2,2024-02-22,독정,8300,4174,4126
2,2024-02-22,검암,9194,5012,4182
2,2024-02-22,검바위,5457,2654,2803
2,2024-02-22,아시아드경기장(공촌사거리),8887,4744,4143
2,2024-02-22,서구청,17764,8800,8964
2,2024-02-22,가정(루원시티),24153,12527,11626
2,2024-02-22,가정중앙시장,12477,6044,6433
2,2024-02-22,석남(거북시장),5999,2970,3029
2,2024-02-22,서부여성회관,8515,4295,4220
2,2024-02-22,인천가좌,9008,4497,4511
2,2024-02-22,가재울,8465,4328,4137
2,2024-02-22,주안국가산단,6514,3136,3378
2,2024-02-22,주안,15222,6397,8825
2,2024-02-22,시민공원(문화창작지대),20525,10519,10006
2,2024-02-22,석바위시장,8877,4356,4521
2,2024-02-22,인천시청,6896,3304,3592
2,2024-02-22,석천사거리,10117,5305,4812
2,2024-02-22,모래내시장,15085,7381,7704
2,2024-02-22,만수,9939,5140,4799
2,2024-02-22,남동구청,9259,4797,4462
2,2024-02-22,인천대공원,4306,2198,2108
2,2024-02-22,운연(서창),2320,1254,1066
2,2024-02-23,검단오류(검단산업단지),5898,2907,2991
2,2024-02-23,왕길,5016,2552,2464
2,2024-02-23,검단사거리,17305,9035,8270
2,2024-02-23,마전,8429,4154,4275
2,2024-02-23,완정,15635,8112,7523
2,2024-02-23,독정,8421,4247,4174
2,2024-02-23,검암,8902,4817,4085
2,2024-02-23,검바위,5948,2926,3022
2,2024-02-23,아시아드경기장(공촌사거리),8875,4721,4154
2,2024-02-23,서구청,17843,8757,9086
2,2024-02-23,가정(루원시티),23819,12311,11508
2,2024-02-23,가정중앙시장,13938,6776,7162
2,2024-02-23,석남(거북시장),6150,2978,3172
2,2024-02-23,서부여성회관,8749,4423,4326
2,2024-02-23,인천가좌,8554,4289,4265
2,2024-02-23,가재울,8386,4308,4078
2,2024-02-23,주안국가산단,5865,2882,2983
2,2024-02-23,주안,15887,6604,9283
2,2024-02-23,시민공원(문화창작지대),20465,10446,10019
2,2024-02-23,석바위시장,9284,4532,4752
2,2024-02-23,인천시청,6934,3334,3600
2,2024-02-23,석천사거리,9734,5151,4583
2,2024-02-23,모래내시장,16860,8166,8694
2,2024-02-23,만수,10584,5436,5148
2,2024-02-23,남동구청,9255,4822,4433
2,2024-02-23,인천대공원,4425,2273,2152
2,2024-02-23,운연(서창),2417,1289,1128
2,2024-02-24,검단오류(검단산업단지),1956,1076,880
2,2024-02-24,왕길,3203,1660,1543
2,2024-02-24,검단사거리,13172,6863,6309
2,2024-02-24,마전,6159,3096,3063
2,2024-02-24,완정,10665,5609,5056
2,2024-02-24,독정,6346,3203,3143
2,2024-02-24,검암,5755,3140,2615
2,2024-02-24,검바위,4101,1980,2121
2,2024-02-24,아시아드경기장(공촌사거리),6788,3535,3253
2,2024-02-24,서구청,11670,5825,5845
2,2024-02-24,가정(루원시티),15101,7796,7305
2,2024-02-24,가정중앙시장,10505,5137,5368
2,2024-02-24,석남(거북시장),4638,2237,2401
2,2024-02-24,서부여성회관,6402,3307,3095
2,2024-02-24,인천가좌,5108,2590,2518
2,2024-02-24,가재울,4683,2407,2276
2,2024-02-24,주안국가산단,1567,774,793
2,2024-02-24,주안,13856,5589,8267
2,2024-02-24,시민공원(문화창작지대),14783,7554,7229
2,2024-02-24,석바위시장,6982,3337,3645
2,2024-02-24,인천시청,4605,2152,2453
2,2024-02-24,석천사거리,6442,3406,3036
2,2024-02-24,모래내시장,13278,6470,6808
2,2024-02-24,만수,7861,4036,3825
2,2024-02-24,남동구청,5812,2960,2852
2,2024-02-24,인천대공원,5137,2571,2566
2,2024-02-24,운연(서창),1718,928,790
2,2024-02-25,검단오류(검단산업단지),1378,669,709
2,2024-02-25,왕길,2137,1077,1060
2,2024-02-25,검단사거리,9811,4848,4963
2,2024-02-25,마전,4246,2054,2192
2,2024-02-25,완정,7329,3697,3632
2,2024-02-25,독정,4012,1912,2100
2,2024-02-25,검암,4152,2193,1959
2,2024-02-25,검바위,3039,1450,1589
2,2024-02-25,아시아드경기장(공촌사거리),5164,2705,2459
2,2024-02-25,서구청,8078,4058,4020
2,2024-02-25,가정(루원시티),10732,5413,5319
2,2024-02-25,가정중앙시장,7532,3663,3869
2,2024-02-25,석남(거북시장),3477,1612,1865
2,2024-02-25,서부여성회관,4930,2555,2375
2,2024-02-25,인천가좌,3305,1623,1682
2,2024-02-25,가재울,3471,1787,1684
2,2024-02-25,주안국가산단,793,378,415
2,2024-02-25,주안,9880,4036,5844
2,2024-02-25,시민공원(문화창작지대),10875,5633,5242
2,2024-02-25,석바위시장,5227,2594,2633
2,2024-02-25,인천시청,3595,1755,1840
2,2024-02-25,석천사거리,4790,2479,2311
2,2024-02-25,모래내시장,10411,5133,5278
2,2024-02-25,만수,6099,3173,2926
2,2024-02-25,남동구청,4235,2200,2035
2,2024-02-25,인천대공원,4458,2257,2201
2,2024-02-25,운연(서창),1285,657,628
2,2024-02-26,검단오류(검단산업단지),5873,2881,2992
2,2024-02-26,왕길,4902,2471,2431
2,2024-02-26,검단사거리,16113,8371,7742
2,2024-02-26,마전,8108,3978,4130
2,2024-02-26,완정,14760,7546,7214
2,2024-02-26,독정,8174,4119,4055
2,2024-02-26,검암,8695,4688,4007
2,2024-02-26,검바위,5271,2535,2736
2,2024-02-26,아시아드경기장(공촌사거리),8600,4553,4047
2,2024-02-26,서구청,17146,8580,8566
2,2024-02-26,가정(루원시티),22482,11539,10943
2,2024-02-26,가정중앙시장,12182,5943,6239
2,2024-02-26,석남(거북시장),6293,3059,3234
2,2024-02-26,서부여성회관,7992,4062,3930
2,2024-02-26,인천가좌,8537,4285,4252
2,2024-02-26,가재울,8261,4238,4023
2,2024-02-26,주안국가산단,5773,2808,2965
2,2024-02-26,주안,15068,6399,8669
2,2024-02-26,시민공원(문화창작지대),20274,10399,9875
2,2024-02-26,석바위시장,8998,4352,4646
2,2024-02-26,인천시청,6533,3123,3410
2,2024-02-26,석천사거리,9496,4951,4545
2,2024-02-26,모래내시장,16050,7855,8195
2,2024-02-26,만수,9880,5071,4809
2,2024-02-26,남동구청,8848,4572,4276
2,2024-02-26,인천대공원,4679,2355,2324
2,2024-02-26,운연(서창),2371,1264,1107
2,2024-02-27,검단오류(검단산업단지),5956,2919,3037
2,2024-02-27,왕길,4928,2513,2415
2,2024-02-27,검단사거리,16128,8385,7743
2,2024-02-27,마전,8212,3991,4221
2,2024-02-27,완정,14938,7727,7211
2,2024-02-27,독정,8283,4123,4160
2,2024-02-27,검암,8881,4803,4078
2,2024-02-27,검바위,5370,2599,2771
2,2024-02-27,아시아드경기장(공촌사거리),8609,4572,4037
2,2024-02-27,서구청,17036,8447,8589
2,2024-02-27,가정(루원시티),23019,11833,11186
2,2024-02-27,가정중앙시장,12658,6205,6453
2,2024-02-27,석남(거북시장),6243,3033,3210
2,2024-02-27,서부여성회관,8068,4073,3995
2,2024-02-27,인천가좌,8454,4259,4195
2,2024-02-27,가재울,8442,4345,4097
2,2024-02-27,주안국가산단,5933,2890,3043
2,2024-02-27,주안,15269,6495,8774
2,2024-02-27,시민공원(문화창작지대),20456,10470,9986
2,2024-02-27,석바위시장,9172,4452,4720
2,2024-02-27,인천시청,6714,3242,3472
2,2024-02-27,석천사거리,9842,5159,4683
2,2024-02-27,모래내시장,16230,7941,8289
2,2024-02-27,만수,10104,5212,4892
2,2024-02-27,남동구청,9230,4828,4402
2,2024-02-27,인천대공원,5107,2608,2499
2,2024-02-27,운연(서창),2441,1276,1165
2,2024-02-28,검단오류(검단산업단지),5937,2890,3047
2,2024-02-28,왕길,5053,2535,2518
2,2024-02-28,검단사거리,16340,8508,7832
2,2024-02-28,마전,8553,4191,4362
2,2024-02-28,완정,15131,7835,7296
2,2024-02-28,독정,8524,4245,4279
2,2024-02-28,검암,8815,4773,4042
2,2024-02-28,검바위,5468,2653,2815
2,2024-02-28,아시아드경기장(공촌사거리),9005,4813,4192
2,2024-02-28,서구청,16664,8210,8454
2,2024-02-28,가정(루원시티),23423,12102,11321
2,2024-02-28,가정중앙시장,12727,6258,6469
2,2024-02-28,석남(거북시장),6480,3166,3314
2,2024-02-28,서부여성회관,8608,4305,4303
2,2024-02-28,인천가좌,8664,4369,4295
2,2024-02-28,가재울,8368,4273,4095
2,2024-02-28,주안국가산단,5811,2849,2962
2,2024-02-28,주안,15387,6437,8950
2,2024-02-28,시민공원(문화창작지대),20755,10648,10107
2,2024-02-28,석바위시장,9192,4445,4747
2,2024-02-28,인천시청,6920,3332,3588
2,2024-02-28,석천사거리,9673,5073,4600
2,2024-02-28,모래내시장,16112,7863,8249
2,2024-02-28,만수,10009,5108,4901
2,2024-02-28,남동구청,9138,4739,4399
2,2024-02-28,인천대공원,4950,2505,2445
2,2024-02-28,운연(서창),2528,1324,1204
2,2024-02-29,검단오류(검단산업단지),5948,2915,3033
2,2024-02-29,왕길,5106,2594,2512
2,2024-02-29,검단사거리,17141,8943,8198
2,2024-02-29,마전,8126,4000,4126
2,2024-02-29,완정,14924,7760,7164
2,2024-02-29,독정,8455,4243,4212
2,2024-02-29,검암,8979,4909,4070
2,2024-02-29,검바위,5582,2698,2884
2,2024-02-29,아시아드경기장(공촌사거리),8638,4635,4003
2,2024-02-29,서구청,17300,8624,8676
2,2024-02-29,가정(루원시티),23145,12015,11130
2,2024-02-29,가정중앙시장,12811,6327,6484
2,2024-02-29,석남(거북시장),6393,3037,3356
2,2024-02-29,서부여성회관,8408,4214,4194
2,2024-02-29,인천가좌,8399,4239,4160
2,2024-02-29,가재울,8185,4215,3970
2,2024-02-29,주안국가산단,5622,2697,2925
2,2024-02-29,주안,15980,6633,9347
2,2024-02-29,시민공원(문화창작지대),20576,10523,10053
2,2024-02-29,석바위시장,9195,4489,4706
2,2024-02-29,인천시청,6872,3244,3628
2,2024-02-29,석천사거리,9560,5018,4542
2,2024-02-29,모래내시장,16241,7993,8248
2,2024-02-29,만수,10112,5229,4883
2,2024-02-29,남동구청,8955,4673,4282
2,2024-02-29,인천대공원,4456,2238,2218
2,2024-02-29,운연(서창),2500,1366,1134
2,2024-03-01,검단오류(검단산업단지),1894,1016,878
2,2024-03-01,왕길,2595,1368,1227
2,2024-03-01,검단사거리,11482,5947,5535
2,2024-03-01,마전,4982,2475,2507
2,2024-03-01,완정,8430,4438,3992
2,2024-03-01,독정,5055,2523,2532
2,2024-03-01,검암,4957,2691,2266
2,2024-03-01,검바위,3293,1637,1656
2,2024-03-01,아시아드경기장(공촌사거리),5305,2830,2475
2,2024-03-01,서구청,8935,4454,4481
2,2024-03-01,가정(루원시티),12361,6464,5897
2,2024-03-01,가정중앙시장,8340,4087,4253
2,2024-03-01,석남(거북시장),4110,1938,2172
2,2024-03-01,서부여성회관,5442,2746,2696
2,2024-03-01,인천가좌,3971,1992,1979
2,2024-03-01,가재울,3845,1972,1873
2,2024-03-01,주안국가산단,1363,673,690
2,2024-03-01,주안,10582,4191,6391
2,2024-03-01,시민공원(문화창작지대),11961,6144,5817
2,2024-03-01,석바위시장,5372,2634,2738
2,2024-03-01,인천시청,3729,1743,1986
2,2024-03-01,석천사거리,5359,2801,2558
2,2024-03-01,모래내시장,10920,5410,5510
2,2024-03-01,만수,6719,3517,3202
2,2024-03-01,남동구청,4728,2432,2296
2,2024-03-01,인천대공원,4118,2078,2040
2,2024-03-01,운연(서창),1312,687,625
2,2024-03-02,검단오류(검단산업단지),1678,909,769
2,2024-03-02,왕길,2583,1329,1254
2,2024-03-02,검단사거리,11986,6097,5889
2,2024-03-02,마전,5246,2579,2667
2,2024-03-02,완정,9228,4839,4389
2,2024-03-02,독정,5606,2774,2832
2,2024-03-02,검암,5079,2724,2355
2,2024-03-02,검바위,3552,1739,1813
2,2024-03-02,아시아드경기장(공촌사거리),5401,2893,2508
2,2024-03-02,서구청,9633,4831,4802
2,2024-03-02,가정(루원시티),12806,6578,6228
2,2024-03-02,가정중앙시장,8884,4352,4532
2,2024-03-02,석남(거북시장),4147,2003,2144
2,2024-03-02,서부여성회관,5647,2880,2767
2,2024-03-02,인천가좌,4122,2096,2026
2,2024-03-02,가재울,3977,2003,1974
2,2024-03-02,주안국가산단,1045,507,538
2,2024-03-02,주안,11616,4648,6968
2,2024-03-02,시민공원(문화창작지대),13146,6804,6342
2,2024-03-02,석바위시장,5820,2836,2984
2,2024-03-02,인천시청,4019,1864,2155
2,2024-03-02,석천사거리,5603,2942,2661
2,2024-03-02,모래내시장,11451,5610,5841
2,2024-03-02,만수,6750,3476,3274
2,2024-03-02,남동구청,5113,2639,2474
2,2024-03-02,인천대공원,3966,2018,1948
2,2024-03-02,운연(서창),1610,866,744
2,2024-03-03,검단오류(검단산업단지),1296,642,654
2,2024-03-03,왕길,2018,989,1029
2,2024-03-03,검단사거리,9646,4830,4816
2,2024-03-03,마전,3846,1901,1945
2,2024-03-03,완정,7238,3641,3597
2,2024-03-03,독정,4669,2254,2415
2,2024-03-03,검암,3884,2049,1835
2,2024-03-03,검바위,2894,1354,1540
2,2024-03-03,아시아드경기장(공촌사거리),4874,2587,2287
2,2024-03-03,서구청,7435,3669,3766
2,2024-03-03,가정(루원시티),9806,5018,4788
2,2024-03-03,가정중앙시장,7017,3439,3578
2,2024-03-03,석남(거북시장),3291,1515,1776
2,2024-03-03,서부여성회관,5082,2632,2450
2,2024-03-03,인천가좌,3225,1594,1631
2,2024-03-03,가재울,3317,1706,1611
2,2024-03-03,주안국가산단,804,364,440
2,2024-03-03,주안,9323,3761,5562
2,2024-03-03,시민공원(문화창작지대),10655,5444,5211
2,2024-03-03,석바위시장,4932,2431,2501
2,2024-03-03,인천시청,3463,1612,1851
2,2024-03-03,석천사거리,4712,2446,2266
2,2024-03-03,모래내시장,9912,4867,5045
2,2024-03-03,만수,5653,2936,2717
2,2024-03-03,남동구청,4158,2141,2017
2,2024-03-03,인천대공원,5268,2605,2663
2,2024-03-03,운연(서창),1263,673,590
2,2024-03-04,검단오류(검단산업단지),5792,2823,2969
2,2024-03-04,왕길,5612,2853,2759
2,2024-03-04,검단사거리,17143,8943,8200
2,2024-03-04,마전,8930,4331,4599
2,2024-03-04,완정,15688,8122,7566
2,2024-03-04,독정,9255,4644,4611
2,2024-03-04,검암,8862,4732,4130
2,2024-03-04,검바위,7443,3622,3821
2,2024-03-04,아시아드경기장(공촌사거리),9496,5033,4463
2,2024-03-04,서구청,17194,8584,8610
2,2024-03-04,가정(루원시티),23522,12000,11522
2,2024-03-04,가정중앙시장,12407,5994,6413
2,2024-03-04,석남(거북시장),6664,3278,3386
2,2024-03-04,서부여성회관,8287,4242,4045
2,2024-03-04,인천가좌,8818,4466,4352
2,2024-03-04,가재울,8274,4231,4043
2,2024-03-04,주안국가산단,5842,2885,2957
2,2024-03-04,주안,16106,6735,9371
2,2024-03-04,시민공원(문화창작지대),20967,10768,10199
2,2024-03-04,석바위시장,8988,4397,4591
2,2024-03-04,인천시청,6633,3236,3397
2,2024-03-04,석천사거리,9973,5152,4821
2,2024-03-04,모래내시장,16037,7755,8282
2,2024-03-04,만수,10334,5363,4971
2,2024-03-04,남동구청,9485,4891,4594
2,2024-03-04,인천대공원,5152,2596,2556
2,2024-03-04,운연(서창),2457,1289,1168
2,2024-03-05,검단오류(검단산업단지),5847,2895,2952
2,2024-03-05,왕길,5511,2766,2745
2,2024-03-05,검단사거리,17092,8995,8097
2,2024-03-05,마전,9045,4385,4660
2,2024-03-05,완정,15752,8089,7663
2,2024-03-05,독정,9265,4565,4700
2,2024-03-05,검암,8725,4662,4063
2,2024-03-05,검바위,7573,3708,3865
2,2024-03-05,아시아드경기장(공촌사거리),9231,4874,4357
2,2024-03-05,서구청,17387,8603,8784
2,2024-03-05,가정(루원시티),24306,12431,11875
2,2024-03-05,가정중앙시장,12269,5989,6280
2,2024-03-05,석남(거북시장),6422,3119,3303
2,2024-03-05,서부여성회관,8302,4243,4059
2,2024-03-05,인천가좌,8896,4498,4398
2,2024-03-05,가재울,8467,4305,4162
2,2024-03-05,주안국가산단,6009,2950,3059
2,2024-03-05,주안,16087,6857,9230
2,2024-03-05,시민공원(문화창작지대),20833,10728,10105
2,2024-03-05,석바위시장,9051,4367,4684
2,2024-03-05,인천시청,6808,3280,3528
2,2024-03-05,석천사거리,10011,5230,4781
2,2024-03-05,모래내시장,15708,7631,8077
2,2024-03-05,만수,10168,5256,4912
2,2024-03-05,남동구청,9288,4804,4484
2,2024-03-05,인천대공원,4562,2294,2268
2,2024-03-05,운연(서창),2520,1328,1192
2,2024-03-06,검단오류(검단산업단지),6008,2979,3029
2,2024-03-06,왕길,5563,2817,2746
2,2024-03-06,검단사거리,17376,9070,8306
2,2024-03-06,마전,9260,4523,4737
2,2024-03-06,완정,15995,8221,7774
2,2024-03-06,독정,9509,4782,4727
2,2024-03-06,검암,9134,4912,4222
2,2024-03-06,검바위,7672,3743,3929
2,2024-03-06,아시아드경기장(공촌사거리),9823,5201,4622
2,2024-03-06,서구청,17728,8785,8943
2,2024-03-06,가정(루원시티),24818,12632,12186
2,2024-03-06,가정중앙시장,13079,6367,6712
2,2024-03-06,석남(거북시장),6660,3219,3441
2,2024-03-06,서부여성회관,8503,4336,4167
2,2024-03-06,인천가좌,9017,4554,4463
2,2024-03-06,가재울,8657,4389,4268
2,2024-03-06,주안국가산단,6136,3020,3116
2,2024-03-06,주안,16567,6968,9599
2,2024-03-06,시민공원(문화창작지대),21694,11094,10600
2,2024-03-06,석바위시장,9304,4486,4818
2,2024-03-06,인천시청,6946,3389,3557
2,2024-03-06,석천사거리,10423,5439,4984
2,2024-03-06,모래내시장,16542,8053,8489
2,2024-03-06,만수,10653,5476,5177
2,2024-03-06,남동구청,9801,5039,4762
2,2024-03-06,인천대공원,5242,2660,2582
2,2024-03-06,운연(서창),2624,1411,1213
2,2024-03-07,검단오류(검단산업단지),5841,2875,2966
2,2024-03-07,왕길,5552,2793,2759
2,2024-03-07,검단사거리,17231,9034,8197
2,2024-03-07,마전,9066,4358,4708
2,2024-03-07,완정,15900,8185,7715
2,2024-03-07,독정,9569,4842,4727
2,2024-03-07,검암,9099,4903,4196
2,2024-03-07,검바위,7657,3743,3914
2,2024-03-07,아시아드경기장(공촌사거리),9540,5035,4505
2,2024-03-07,서구청,17273,8581,8692
2,2024-03-07,가정(루원시티),24303,12415,11888
2,2024-03-07,가정중앙시장,12531,6055,6476
2,2024-03-07,석남(거북시장),6398,3120,3278
2,2024-03-07,서부여성회관,8307,4231,4076
2,2024-03-07,인천가좌,8754,4443,4311
2,2024-03-07,가재울,8498,4320,4178
2,2024-03-07,주안국가산단,5960,2929,3031
2,2024-03-07,주안,16356,6908,9448
2,2024-03-07,시민공원(문화창작지대),21425,10921,10504
2,2024-03-07,석바위시장,9118,4427,4691
2,2024-03-07,인천시청,6870,3288,3582
2,2024-03-07,석천사거리,10277,5313,4964
2,2024-03-07,모래내시장,15656,7663,7993
2,2024-03-07,만수,10453,5403,5050
2,2024-03-07,남동구청,9373,4780,4593
2,2024-03-07,인천대공원,4442,2250,2192
2,2024-03-07,운연(서창),2595,1378,1217
2,2024-03-08,검단오류(검단산업단지),5828,2869,2959
2,2024-03-08,왕길,5517,2791,2726
2,2024-03-08,검단사거리,18092,9436,8656
2,2024-03-08,마전,9201,4484,4717
2,2024-03-08,완정,16507,8475,8032
2,2024-03-08,독정,9480,4768,4712
2,2024-03-08,검암,9193,4997,4196
2,2024-03-08,검바위,7677,3727,3950
2,2024-03-08,아시아드경기장(공촌사거리),9728,5189,4539
2,2024-03-08,서구청,18326,9118,9208
2,2024-03-08,가정(루원시티),25367,12931,12436
2,2024-03-08,가정중앙시장,13319,6443,6876
2,2024-03-08,석남(거북시장),6539,3209,3330
2,2024-03-08,서부여성회관,8853,4475,4378
2,2024-03-08,인천가좌,9247,4662,4585
2,2024-03-08,가재울,8590,4350,4240
2,2024-03-08,주안국가산단,5952,2920,3032
2,2024-03-08,주안,16877,7037,9840
2,2024-03-08,시민공원(문화창작지대),21505,11109,10396
2,2024-03-08,석바위시장,9114,4437,4677
2,2024-03-08,인천시청,7044,3379,3665
2,2024-03-08,석천사거리,10371,5403,4968
2,2024-03-08,모래내시장,16524,8023,8501
2,2024-03-08,만수,10940,5657,5283
2,2024-03-08,남동구청,9957,5193,4764
2,2024-03-08,인천대공원,4685,2402,2283
2,2024-03-08,운연(서창),2637,1405,1232
2,2024-03-09,검단오류(검단산업단지),2170,1174,996
2,2024-03-09,왕길,3185,1636,1549
2,2024-03-09,검단사거리,13924,7145,6779
2,2024-03-09,마전,6321,3163,3158
2,2024-03-09,완정,10778,5644,5134
2,2024-03-09,독정,6394,3197,3197
2,2024-03-09,검암,5930,3245,2685
2,2024-03-09,검바위,4017,1982,2035
2,2024-03-09,아시아드경기장(공촌사거리),6814,3497,3317
2,2024-03-09,서구청,14060,7069,6991
2,2024-03-09,가정(루원시티),15147,7860,7287
2,2024-03-09,가정중앙시장,10768,5329,5439
2,2024-03-09,석남(거북시장),5052,2404,2648
2,2024-03-09,서부여성회관,6611,3385,3226
2,2024-03-09,인천가좌,5337,2703,2634
2,2024-03-09,가재울,5008,2537,2471
2,2024-03-09,주안국가산단,1529,754,775
2,2024-03-09,주안,13671,5575,8096
2,2024-03-09,시민공원(문화창작지대),15185,7771,7414
2,2024-03-09,석바위시장,6805,3288,3517
2,2024-03-09,인천시청,4842,2267,2575
2,2024-03-09,석천사거리,6663,3535,3128
2,2024-03-09,모래내시장,13594,6672,6922
2,2024-03-09,만수,7967,4108,3859
2,2024-03-09,남동구청,6123,3182,2941
2,2024-03-09,인천대공원,5485,2741,2744
2,2024-03-09,운연(서창),1832,977,855
2,2024-03-10,검단오류(검단산업단지),1393,683,710
2,2024-03-10,왕길,2006,1025,981
2,2024-03-10,검단사거리,10061,5003,5058
2,2024-03-10,마전,4384,2200,2184
2,2024-03-10,완정,7614,3866,3748
2,2024-03-10,독정,4126,2056,2070
2,2024-03-10,검암,4334,2292,2042
2,2024-03-10,검바위,3067,1408,1659
2,2024-03-10,아시아드경기장(공촌사거리),5280,2807,2473
2,2024-03-10,서구청,8110,4080,4030
2,2024-03-10,가정(루원시티),10764,5453,5311
2,2024-03-10,가정중앙시장,7877,3850,4027
2,2024-03-10,석남(거북시장),3601,1681,1920
2,2024-03-10,서부여성회관,5203,2671,2532
2,2024-03-10,인천가좌,3470,1754,1716
2,2024-03-10,가재울,3526,1769,1757
2,2024-03-10,주안국가산단,771,363,408
2,2024-03-10,주안,9874,3976,5898
2,2024-03-10,시민공원(문화창작지대),11436,5900,5536
2,2024-03-10,석바위시장,5372,2627,2745
2,2024-03-10,인천시청,3759,1779,1980
2,2024-03-10,석천사거리,4832,2482,2350
2,2024-03-10,모래내시장,11032,5398,5634
2,2024-03-10,만수,5857,3063,2794
2,2024-03-10,남동구청,4459,2295,2164
2,2024-03-10,인천대공원,6859,3425,3434
2,2024-03-10,운연(서창),1439,746,693
2,2024-03-11,검단오류(검단산업단지),5863,2886,2977
2,2024-03-11,왕길,5477,2757,2720
2,2024-03-11,검단사거리,17231,9041,8190
2,2024-03-11,마전,9080,4430,4650
2,2024-03-11,완정,15815,8162,7653
2,2024-03-11,독정,9425,4688,4737
2,2024-03-11,검암,8995,4902,4093
2,2024-03-11,검바위,7459,3622,3837
2,2024-03-11,아시아드경기장(공촌사거리),9466,5036,4430
2,2024-03-11,서구청,17476,8741,8735
2,2024-03-11,가정(루원시티),24122,12337,11785
2,2024-03-11,가정중앙시장,12620,6163,6457
2,2024-03-11,석남(거북시장),6489,3194,3295
2,2024-03-11,서부여성회관,8257,4240,4017
2,2024-03-11,인천가좌,9106,4585,4521
2,2024-03-11,가재울,8494,4304,4190
2,2024-03-11,주안국가산단,5954,2925,3029
2,2024-03-11,주안,16313,6950,9363
2,2024-03-11,시민공원(문화창작지대),21135,10828,10307
2,2024-03-11,석바위시장,9072,4411,4661
2,2024-03-11,인천시청,6682,3257,3425
2,2024-03-11,석천사거리,10153,5311,4842
2,2024-03-11,모래내시장,15863,7721,8142
2,2024-03-11,만수,10242,5254,4988
2,2024-03-11,남동구청,9629,4938,4691
2,2024-03-11,인천대공원,4567,2282,2285
2,2024-03-11,운연(서창),2616,1383,1233
2,2024-03-12,검단오류(검단산업단지),5958,2945,3013
2,2024-03-12,왕길,5503,2743,2760
2,2024-03-12,검단사거리,16995,8892,8103
2,2024-03-12,마전,9075,4387,4688
2,2024-03-12,완정,15823,8165,7658
2,2024-03-12,독정,9255,4554,4701
2,2024-03-12,검암,9027,4861,4166
2,2024-03-12,검바위,7372,3613,3759
2,2024-03-12,아시아드경기장(공촌사거리),9447,5015,4432
2,2024-03-12,서구청,17458,8640,8818
2,2024-03-12,가정(루원시티),24143,12362,11781
2,2024-03-12,가정중앙시장,12469,6081,6388
2,2024-03-12,석남(거북시장),6197,3003,3194
2,2024-03-12,서부여성회관,8190,4124,4066
2,2024-03-12,인천가좌,9001,4546,4455
2,2024-03-12,가재울,8389,4290,4099
2,2024-03-12,주안국가산단,6022,2944,3078
2,2024-03-12,주안,16169,6894,9275
2,2024-03-12,시민공원(문화창작지대),21152,10796,10356
2,2024-03-12,석바위시장,9003,4349,4654
2,2024-03-12,인천시청,6894,3328,3566
2,2024-03-12,석천사거리,10032,5233,4799
2,2024-03-12,모래내시장,15512,7612,7900
2,2024-03-12,만수,10360,5321,5039
2,2024-03-12,남동구청,9504,4918,4586
2,2024-03-12,인천대공원,4272,2179,2093
2,2024-03-12,운연(서창),2525,1329,1196
2,2024-03-13,검단오류(검단산업단지),5975,2950,3025
2,2024-03-13,왕길,5549,2808,2741
2,2024-03-13,검단사거리,17698,9260,8438
2,2024-03-13,마전,9213,4450,4763
2,2024-03-13,완정,16072,8296,7776
2,2024-03-13,독정,9545,4743,4802
2,2024-03-13,검암,9178,4975,4203
2,2024-03-13,검바위,7552,3682,3870
2,2024-03-13,아시아드경기장(공촌사거리),10135,5331,4804
2,2024-03-13,서구청,17788,8827,8961
2,2024-03-13,가정(루원시티),25478,13098,12380
2,2024-03-13,가정중앙시장,13094,6394,6700
2,2024-03-13,석남(거북시장),6646,3249,3397
2,2024-03-13,서부여성회관,8752,4472,4280
2,2024-03-13,인천가좌,9135,4648,4487
2,2024-03-13,가재울,8690,4413,4277
2,2024-03-13,주안국가산단,6075,2962,3113
2,2024-03-13,주안,16933,7212,9721
2,2024-03-13,시민공원(문화창작지대),22036,11299,10737
2,2024-03-13,석바위시장,9511,4578,4933
2,2024-03-13,인천시청,7074,3361,3713
2,2024-03-13,석천사거리,10372,5426,4946
2,2024-03-13,모래내시장,16737,8220,8517
2,2024-03-13,만수,10770,5515,5255
2,2024-03-13,남동구청,9938,5105,4833
2,2024-03-13,인천대공원,5645,2879,2766
2,2024-03-13,운연(서창),2636,1393,1243
2,2024-03-14,검단오류(검단산업단지),5927,2921,3006
2,2024-03-14,왕길,5624,2813,2811
2,2024-03-14,검단사거리,17436,9081,8355
2,2024-03-14,마전,9201,4494,4707
2,2024-03-14,완정,16198,8327,7871
2,2024-03-14,독정,9727,4873,4854
2,2024-03-14,검암,9209,4955,4254
2,2024-03-14,검바위,7686,3768,3918
2,2024-03-14,아시아드경기장(공촌사거리),9683,5070,4613
2,2024-03-14,서구청,17947,8867,9080
2,2024-03-14,가정(루원시티),24648,12581,12067
2,2024-03-14,가정중앙시장,13192,6425,6767
2,2024-03-14,석남(거북시장),6547,3154,3393
2,2024-03-14,서부여성회관,8641,4401,4240
2,2024-03-14,인천가좌,9232,4635,4597
2,2024-03-14,가재울,8467,4324,4143
2,2024-03-14,주안국가산단,6027,2940,3087
2,2024-03-14,주안,16670,7136,9534
2,2024-03-14,시민공원(문화창작지대),21904,11263,10641
2,2024-03-14,석바위시장,9596,4622,4974
2,2024-03-14,인천시청,7035,3381,3654
2,2024-03-14,석천사거리,10424,5473,4951
2,2024-03-14,모래내시장,16637,8076,8561
2,2024-03-14,만수,10668,5524,5144
2,2024-03-14,남동구청,9881,5179,4702
2,2024-03-14,인천대공원,5799,2918,2881
2,2024-03-14,운연(서창),2745,1434,1311
2,2024-03-15,검단오류(검단산업단지),5976,2952,3024
2,2024-03-15,왕길,5753,2915,2838
2,2024-03-15,검단사거리,18672,9764,8908
2,2024-03-15,마전,9262,4482,4780
2,2024-03-15,완정,16742,8707,8035
2,2024-03-15,독정,9613,4833,4780
2,2024-03-15,검암,9297,5085,4212
2,2024-03-15,검바위,7798,3786,4012
2,2024-03-15,아시아드경기장(공촌사거리),9815,5214,4601
2,2024-03-15,서구청,18561,9170,9391
2,2024-03-15,가정(루원시티),25627,13011,12616
2,2024-03-15,가정중앙시장,13608,6634,6974
2,2024-03-15,석남(거북시장),6781,3232,3549
2,2024-03-15,서부여성회관,9000,4595,4405
2,2024-03-15,인천가좌,9224,4709,4515
2,2024-03-15,가재울,8784,4495,4289
2,2024-03-15,주안국가산단,5796,2827,2969
2,2024-03-15,주안,17263,7249,10014
2,2024-03-15,시민공원(문화창작지대),22040,11316,10724
2,2024-03-15,석바위시장,9622,4714,4908
2,2024-03-15,인천시청,7181,3420,3761
2,2024-03-15,석천사거리,10489,5521,4968
2,2024-03-15,모래내시장,17239,8419,8820
2,2024-03-15,만수,11173,5795,5378
2,2024-03-15,남동구청,9911,5146,4765
2,2024-03-15,인천대공원,5627,2850,2777
2,2024-03-15,운연(서창),2685,1440,1245
2,2024-03-16,검단오류(검단산업단지),2202,1195,1007
2,2024-03-16,왕길,3305,1700,1605
2,2024-03-16,검단사거리,13939,7202,6737
2,2024-03-16,마전,6357,3187,3170
2,2024-03-16,완정,11180,5948,5232
2,2024-03-16,독정,6576,3318,3258
2,2024-03-16,검암,6341,3423,2918
2,2024-03-16,검바위,4158,2030,2128
2,2024-03-16,아시아드경기장(공촌사거리),6953,3615,3338
2,2024-03-16,서구청,12132,5978,6154
2,2024-03-16,가정(루원시티),15675,8079,7596
2,2024-03-16,가정중앙시장,11090,5504,5586
2,2024-03-16,석남(거북시장),5104,2462,2642
2,2024-03-16,서부여성회관,6640,3368,3272
2,2024-03-16,인천가좌,5097,2582,2515
2,2024-03-16,가재울,4915,2519,2396
2,2024-03-16,주안국가산단,1547,769,778
2,2024-03-16,주안,14127,5737,8390
2,2024-03-16,시민공원(문화창작지대),15559,7980,7579
2,2024-03-16,석바위시장,7147,3455,3692
2,2024-03-16,인천시청,4974,2385,2589
2,2024-03-16,석천사거리,6982,3749,3233
2,2024-03-16,모래내시장,15154,7403,7751
2,2024-03-16,만수,8084,4216,3868
2,2024-03-16,남동구청,6267,3277,2990
2,2024-03-16,인천대공원,8097,4082,4015
2,2024-03-16,운연(서창),1979,1019,960
2,2024-03-17,검단오류(검단산업단지),1577,779,798
2,2024-03-17,왕길,2084,1076,1008
2,2024-03-17,검단사거리,10381,5288,5093
2,2024-03-17,마전,4529,2173,2356
2,2024-03-17,완정,7509,3809,3700
2,2024-03-17,독정,4544,2230,2314
2,2024-03-17,검암,4458,2353,2105
2,2024-03-17,검바위,3092,1494,1598
2,2024-03-17,아시아드경기장(공촌사거리),5299,2806,2493
2,2024-03-17,서구청,8270,4171,4099
2,2024-03-17,가정(루원시티),10753,5511,5242
2,2024-03-17,가정중앙시장,7514,3642,3872
2,2024-03-17,석남(거북시장),3526,1674,1852
2,2024-03-17,서부여성회관,5251,2704,2547
2,2024-03-17,인천가좌,3491,1774,1717
2,2024-03-17,가재울,3660,1880,1780
2,2024-03-17,주안국가산단,878,413,465
2,2024-03-17,주안,9688,3940,5748
2,2024-03-17,시민공원(문화창작지대),11277,5821,5456
2,2024-03-17,석바위시장,5177,2506,2671
2,2024-03-17,인천시청,3862,1839,2023
2,2024-03-17,석천사거리,4825,2534,2291
2,2024-03-17,모래내시장,10503,5177,5326
2,2024-03-17,만수,6186,3188,2998
2,2024-03-17,남동구청,4363,2267,2096
2,2024-03-17,인천대공원,6570,3280,3290
2,2024-03-17,운연(서창),1474,735,739
2,2024-03-18,검단오류(검단산업단지),5873,2885,2988
2,2024-03-18,왕길,5621,2828,2793
2,2024-03-18,검단사거리,17331,9065,8266
2,2024-03-18,마전,8809,4340,4469
2,2024-03-18,완정,15855,8189,7666
2,2024-03-18,독정,9441,4714,4727
2,2024-03-18,검암,9119,4940,4179
2,2024-03-18,검바위,7433,3615,3818
2,2024-03-18,아시아드경기장(공촌사거리),9457,4978,4479
2,2024-03-18,서구청,17648,8841,8807
2,2024-03-18,가정(루원시티),24101,12351,11750
2,2024-03-18,가정중앙시장,12800,6216,6584
2,2024-03-18,석남(거북시장),6327,3093,3234
2,2024-03-18,서부여성회관,8223,4182,4041
2,2024-03-18,인천가좌,8960,4535,4425
2,2024-03-18,가재울,8401,4253,4148
2,2024-03-18,주안국가산단,5896,2894,3002
2,2024-03-18,주안,15884,6796,9088
2,2024-03-18,시민공원(문화창작지대),21720,11190,10530
2,2024-03-18,석바위시장,9184,4507,4677
2,2024-03-18,인천시청,6631,3195,3436
2,2024-03-18,석천사거리,10082,5302,4780
2,2024-03-18,모래내시장,16607,8034,8573
2,2024-03-18,만수,10271,5303,4968
2,2024-03-18,남동구청,9599,4957,4642
2,2024-03-18,인천대공원,5439,2729,2710
2,2024-03-18,운연(서창),2706,1457,1249
2,2024-03-19,검단오류(검단산업단지),5810,2868,2942
2,2024-03-19,왕길,5483,2734,2749
2,2024-03-19,검단사거리,17008,8954,8054
2,2024-03-19,마전,9100,4416,4684
2,2024-03-19,완정,15884,8192,7692
2,2024-03-19,독정,9426,4683,4743
2,2024-03-19,검암,9119,4921,4198
2,2024-03-19,검바위,7631,3714,3917
2,2024-03-19,아시아드경기장(공촌사거리),9588,5105,4483
2,2024-03-19,서구청,17309,8606,8703
2,2024-03-19,가정(루원시티),24257,12440,11817
2,2024-03-19,가정중앙시장,12517,6036,6481
2,2024-03-19,석남(거북시장),6307,3072,3235
2,2024-03-19,서부여성회관,8258,4196,4062
2,2024-03-19,인천가좌,8831,4416,4415
2,2024-03-19,가재울,8515,4337,4178
2,2024-03-19,주안국가산단,5986,2942,3044
2,2024-03-19,주안,16050,6779,9271
2,2024-03-19,시민공원(문화창작지대),21625,11078,10547
2,2024-03-19,석바위시장,9244,4521,4723
2,2024-03-19,인천시청,6798,3300,3498
2,2024-03-19,석천사거리,10136,5261,4875
2,2024-03-19,모래내시장,15395,7520,7875
2,2024-03-19,만수,10282,5307,4975
2,2024-03-19,남동구청,9398,4868,4530
2,2024-03-19,인천대공원,4425,2226,2199
2,2024-03-19,운연(서창),2564,1361,1203
2,2024-03-20,검단오류(검단산업단지),5984,2979,3005
2,2024-03-20,왕길,5576,2818,2758
2,2024-03-20,검단사거리,17241,9087,8154
2,2024-03-20,마전,9029,4422,4607
2,2024-03-20,완정,16192,8361,7831
2,2024-03-20,독정,9311,4676,4635
2,2024-03-20,검암,9140,4955,4185
2,2024-03-20,검바위,7735,3786,3949
2,2024-03-20,아시아드경기장(공촌사거리),9973,5263,4710
2,2024-03-20,서구청,17498,8629,8869
2,2024-03-20,가정(루원시티),24887,12685,12202
2,2024-03-20,가정중앙시장,13172,6355,6817
2,2024-03-20,석남(거북시장),6617,3201,3416
2,2024-03-20,서부여성회관,8498,4303,4195
2,2024-03-20,인천가좌,9204,4635,4569
2,2024-03-20,가재울,8658,4452,4206
2,2024-03-20,주안국가산단,6033,2949,3084
2,2024-03-20,주안,16286,6922,9364
2,2024-03-20,시민공원(문화창작지대),21849,11213,10636
2,2024-03-20,석바위시장,9632,4693,4939
2,2024-03-20,인천시청,7153,3421,3732
2,2024-03-20,석천사거리,10439,5432,5007
2,2024-03-20,모래내시장,16226,7897,8329
2,2024-03-20,만수,10846,5595,5251
2,2024-03-20,남동구청,9918,5120,4798
2,2024-03-20,인천대공원,4943,2489,2454
2,2024-03-20,운연(서창),2544,1338,1206
2,2024-03-21,검단오류(검단산업단지),5879,2903,2976
2,2024-03-21,왕길,5505,2735,2770
2,2024-03-21,검단사거리,17254,8982,8272
2,2024-03-21,마전,9136,4455,4681
2,2024-03-21,완정,16065,8292,7773
2,2024-03-21,독정,9472,4733,4739
2,2024-03-21,검암,9298,5063,4235
2,2024-03-21,검바위,7698,3740,3958
2,2024-03-21,아시아드경기장(공촌사거리),9905,5174,4731
2,2024-03-21,서구청,17979,8991,8988
2,2024-03-21,가정(루원시티),24795,12736,12059
2,2024-03-21,가정중앙시장,13319,6539,6780
2,2024-03-21,석남(거북시장),6411,3130,3281
2,2024-03-21,서부여성회관,8622,4341,4281
2,2024-03-21,인천가좌,9151,4639,4512
2,2024-03-21,가재울,8468,4330,4138
2,2024-03-21,주안국가산단,5977,2951,3026
2,2024-03-21,주안,16502,7066,9436
2,2024-03-21,시민공원(문화창작지대),21942,11235,10707
2,2024-03-21,석바위시장,9124,4398,4726
2,2024-03-21,인천시청,7083,3403,3680
2,2024-03-21,석천사거리,10311,5367,4944
2,2024-03-21,모래내시장,16719,8090,8629
2,2024-03-21,만수,10698,5582,5116
2,2024-03-21,남동구청,9760,5098,4662
2,2024-03-21,인천대공원,5435,2736,2699
2,2024-03-21,운연(서창),2674,1431,1243
2,2024-03-22,검단오류(검단산업단지),5817,2839,2978
2,2024-03-22,왕길,5321,2697,2624
2,2024-03-22,검단사거리,17949,9397,8552
2,2024-03-22,마전,8967,4347,4620
2,2024-03-22,완정,16178,8410,7768
2,2024-03-22,독정,9348,4677,4671
2,2024-03-22,검암,8979,4902,4077
2,2024-03-22,검바위,7630,3754,3876
2,2024-03-22,아시아드경기장(공촌사거리),9652,5110,4542
2,2024-03-22,서구청,18017,8857,9160
2,2024-03-22,가정(루원시티),24652,12565,12087
2,2024-03-22,가정중앙시장,13358,6511,6847
2,2024-03-22,석남(거북시장),6563,3198,3365
2,2024-03-22,서부여성회관,8659,4433,4226
2,2024-03-22,인천가좌,9000,4493,4507
2,2024-03-22,가재울,8582,4378,4204
2,2024-03-22,주안국가산단,5959,2892,3067
2,2024-03-22,주안,16489,7007,9482
2,2024-03-22,시민공원(문화창작지대),21178,10863,10315
2,2024-03-22,석바위시장,9220,4475,4745
2,2024-03-22,인천시청,6869,3334,3535
2,2024-03-22,석천사거리,10359,5408,4951
2,2024-03-22,모래내시장,16224,7895,8329
2,2024-03-22,만수,10676,5537,5139
2,2024-03-22,남동구청,9673,4948,4725
2,2024-03-22,인천대공원,4921,2475,2446
2,2024-03-22,운연(서창),2646,1424,1222
2,2024-03-23,검단오류(검단산업단지),2237,1211,1026
2,2024-03-23,왕길,3218,1709,1509
2,2024-03-23,검단사거리,14056,7331,6725
2,2024-03-23,마전,6239,3075,3164
2,2024-03-23,완정,10909,5714,5195
2,2024-03-23,독정,6375,3234,3141
2,2024-03-23,검암,6281,3400,2881
2,2024-03-23,검바위,3967,1932,2035
2,2024-03-23,아시아드경기장(공촌사거리),7135,3710,3425
2,2024-03-23,서구청,11782,5835,5947
2,2024-03-23,가정(루원시티),15723,8132,7591
2,2024-03-23,가정중앙시장,10855,5322,5533
2,2024-03-23,석남(거북시장),4804,2336,2468
2,2024-03-23,서부여성회관,6616,3387,3229
2,2024-03-23,인천가좌,5276,2749,2527
2,2024-03-23,가재울,4952,2537,2415
2,2024-03-23,주안국가산단,1617,784,833
2,2024-03-23,주안,13733,5564,8169
2,2024-03-23,시민공원(문화창작지대),15446,8029,7417
2,2024-03-23,석바위시장,6712,3272,3440
2,2024-03-23,인천시청,4981,2353,2628
2,2024-03-23,석천사거리,7254,3829,3425
2,2024-03-23,모래내시장,14678,7296,7382
2,2024-03-23,만수,8250,4315,3935
2,2024-03-23,남동구청,6435,3362,3073
2,2024-03-23,인천대공원,7907,3952,3955
2,2024-03-23,운연(서창),2084,1063,1021
2,2024-03-24,검단오류(검단산업단지),1662,853,809
2,2024-03-24,왕길,2151,1096,1055
2,2024-03-24,검단사거리,10588,5326,5262
2,2024-03-24,마전,4369,2153,2216
2,2024-03-24,완정,7819,3949,3870
2,2024-03-24,독정,4195,2091,2104
2,2024-03-24,검암,4784,2571,2213
2,2024-03-24,검바위,3183,1557,1626
2,2024-03-24,아시아드경기장(공촌사거리),5673,2966,2707
2,2024-03-24,서구청,8325,4225,4100
2,2024-03-24,가정(루원시티),11148,5764,5384
2,2024-03-24,가정중앙시장,7858,3862,3996
2,2024-03-24,석남(거북시장),3705,1737,1968
2,2024-03-24,서부여성회관,5341,2724,2617
2,2024-03-24,인천가좌,3567,1794,1773
2,2024-03-24,가재울,3832,1904,1928
2,2024-03-24,주안국가산단,823,373,450
2,2024-03-24,주안,10051,4176,5875
2,2024-03-24,시민공원(문화창작지대),11696,5976,5720
2,2024-03-24,석바위시장,5417,2672,2745
2,2024-03-24,인천시청,3964,1872,2092
2,2024-03-24,석천사거리,5366,2812,2554
2,2024-03-24,모래내시장,11536,5664,5872
2,2024-03-24,만수,6506,3357,3149
2,2024-03-24,남동구청,4618,2363,2255
2,2024-03-24,인천대공원,9985,4916,5069
2,2024-03-24,운연(서창),1727,921,806
2,2024-03-25,검단오류(검단산업단지),5807,2822,2985
2,2024-03-25,왕길,5278,2630,2648
2,2024-03-25,검단사거리,17171,9046,8125
2,2024-03-25,마전,8773,4252,4521
2,2024-03-25,완정,15597,8087,7510
2,2024-03-25,독정,9173,4531,4642
2,2024-03-25,검암,9004,4782,4222
2,2024-03-25,검바위,6775,3308,3467
2,2024-03-25,아시아드경기장(공촌사거리),9386,4927,4459
2,2024-03-25,서구청,17268,8683,8585
2,2024-03-25,가정(루원시티),23677,12033,11644
2,2024-03-25,가정중앙시장,12023,5825,6198
2,2024-03-25,석남(거북시장),6143,3036,3107
2,2024-03-25,서부여성회관,7922,4088,3834
2,2024-03-25,인천가좌,8751,4376,4375
2,2024-03-25,가재울,8229,4219,4010
2,2024-03-25,주안국가산단,6027,2954,3073
2,2024-03-25,주안,15349,6536,8813
2,2024-03-25,시민공원(문화창작지대),20895,10654,10241
2,2024-03-25,석바위시장,8855,4335,4520
2,2024-03-25,인천시청,6440,3076,3364
2,2024-03-25,석천사거리,9994,5147,4847
2,2024-03-25,모래내시장,15051,7398,7653
2,2024-03-25,만수,9991,5160,4831
2,2024-03-25,남동구청,9276,4803,4473
2,2024-03-25,인천대공원,3955,1992,1963
2,2024-03-25,운연(서창),2340,1279,1061
2,2024-03-26,검단오류(검단산업단지),5827,2859,2968
2,2024-03-26,왕길,5348,2657,2691
2,2024-03-26,검단사거리,17089,8971,8118
2,2024-03-26,마전,8948,4363,4585
2,2024-03-26,완정,15884,8223,7661
2,2024-03-26,독정,9234,4581,4653
2,2024-03-26,검암,9207,5018,4189
2,2024-03-26,검바위,7114,3427,3687
2,2024-03-26,아시아드경기장(공촌사거리),9594,5085,4509
2,2024-03-26,서구청,17625,8789,8836
2,2024-03-26,가정(루원시티),24666,12649,12017
2,2024-03-26,가정중앙시장,12873,6236,6637
2,2024-03-26,석남(거북시장),6415,3080,3335
2,2024-03-26,서부여성회관,8190,4220,3970
2,2024-03-26,인천가좌,9074,4559,4515
2,2024-03-26,가재울,8513,4336,4177
2,2024-03-26,주안국가산단,6100,2983,3117
2,2024-03-26,주안,16423,7017,9406
2,2024-03-26,시민공원(문화창작지대),21599,11078,10521
2,2024-03-26,석바위시장,9128,4450,4678
2,2024-03-26,인천시청,7172,3483,3689
2,2024-03-26,석천사거리,10235,5399,4836
2,2024-03-26,모래내시장,16223,7879,8344
2,2024-03-26,만수,10577,5492,5085
2,2024-03-26,남동구청,9655,4968,4687
2,2024-03-26,인천대공원,4730,2391,2339
2,2024-03-26,운연(서창),2518,1341,1177
2,2024-03-27,검단오류(검단산업단지),6165,3061,3104
2,2024-03-27,왕길,5554,2793,2761
2,2024-03-27,검단사거리,17843,9384,8459
2,2024-03-27,마전,9226,4507,4719
2,2024-03-27,완정,16282,8410,7872
2,2024-03-27,독정,9813,4966,4847
2,2024-03-27,검암,9315,5070,4245
2,2024-03-27,검바위,6452,3089,3363
2,2024-03-27,아시아드경기장(공촌사거리),9965,5273,4692
2,2024-03-27,서구청,17785,8803,8982
2,2024-03-27,가정(루원시티),25208,12936,12272
2,2024-03-27,가정중앙시장,13138,6398,6740
2,2024-03-27,석남(거북시장),6670,3248,3422
2,2024-03-27,서부여성회관,8694,4408,4286
2,2024-03-27,인천가좌,9540,4824,4716
2,2024-03-27,가재울,8705,4455,4250
2,2024-03-27,주안국가산단,6265,3039,3226
2,2024-03-27,주안,17099,7290,9809
2,2024-03-27,시민공원(문화창작지대),22675,11627,11048
2,2024-03-27,석바위시장,9579,4603,4976
2,2024-03-27,인천시청,7345,3499,3846
2,2024-03-27,석천사거리,10700,5606,5094
2,2024-03-27,모래내시장,17493,8504,8989
2,2024-03-27,만수,10956,5647,5309
2,2024-03-27,남동구청,10261,5285,4976
2,2024-03-27,인천대공원,6334,3221,3113
2,2024-03-27,운연(서창),2770,1447,1323
2,2024-03-28,검단오류(검단산업단지),5837,2871,2966
2,2024-03-28,왕길,5385,2684,2701
2,2024-03-28,검단사거리,16933,8808,8125
2,2024-03-28,마전,8892,4337,4555
2,2024-03-28,완정,15629,8047,7582
2,2024-03-28,독정,9225,4586,4639
2,2024-03-28,검암,8871,4897,3974
2,2024-03-28,검바위,7481,3669,3812
2,2024-03-28,아시아드경기장(공촌사거리),9356,4946,4410
2,2024-03-28,서구청,17457,8658,8799
2,2024-03-28,가정(루원시티),24257,12313,11944
2,2024-03-28,가정중앙시장,12644,6145,6499
2,2024-03-28,석남(거북시장),6365,3098,3267
2,2024-03-28,서부여성회관,8302,4211,4091
2,2024-03-28,인천가좌,8957,4531,4426
2,2024-03-28,가재울,8322,4236,4086
2,2024-03-28,주안국가산단,6015,2944,3071
2,2024-03-28,주안,16039,6866,9173
2,2024-03-28,시민공원(문화창작지대),21657,11094,10563
2,2024-03-28,석바위시장,8744,4225,4519
2,2024-03-28,인천시청,6969,3352,3617
2,2024-03-28,석천사거리,10206,5296,4910
2,2024-03-28,모래내시장,15678,7666,8012
2,2024-03-28,만수,10261,5340,4921
2,2024-03-28,남동구청,9539,4963,4576
2,2024-03-28,인천대공원,3825,1954,1871
2,2024-03-28,운연(서창),2428,1275,1153
2,2024-03-29,검단오류(검단산업단지),5861,2872,2989
2,2024-03-29,왕길,5285,2681,2604
2,2024-03-29,검단사거리,17683,9213,8470
2,2024-03-29,마전,8885,4367,4518
2,2024-03-29,완정,16141,8381,7760
2,2024-03-29,독정,9291,4636,4655
2,2024-03-29,검암,8830,4852,3978
2,2024-03-29,검바위,7406,3611,3795
2,2024-03-29,아시아드경기장(공촌사거리),9553,5082,4471
2,2024-03-29,서구청,17832,8799,9033
2,2024-03-29,가정(루원시티),24587,12560,12027
2,2024-03-29,가정중앙시장,12902,6295,6607
2,2024-03-29,석남(거북시장),6384,3097,3287
2,2024-03-29,서부여성회관,8468,4349,4119
2,2024-03-29,인천가좌,9073,4577,4496
2,2024-03-29,가재울,8230,4165,4065
2,2024-03-29,주안국가산단,5861,2837,3024
2,2024-03-29,주안,16759,7126,9633
2,2024-03-29,시민공원(문화창작지대),21203,10911,10292
2,2024-03-29,석바위시장,8875,4329,4546
2,2024-03-29,인천시청,6875,3297,3578
2,2024-03-29,석천사거리,10158,5283,4875
2,2024-03-29,모래내시장,15748,7577,8171
2,2024-03-29,만수,10432,5432,5000
2,2024-03-29,남동구청,9375,4875,4500
2,2024-03-29,인천대공원,3562,1842,1720
2,2024-03-29,운연(서창),2492,1330,1162
2,2024-03-30,검단오류(검단산업단지),2187,1183,1004
2,2024-03-30,왕길,3260,1677,1583
2,2024-03-30,검단사거리,14176,7326,6850
2,2024-03-30,마전,5981,2961,3020
2,2024-03-30,완정,11330,5990,5340
2,2024-03-30,독정,6539,3268,3271
2,2024-03-30,검암,7096,3760,3336
2,2024-03-30,검바위,4256,2103,2153
2,2024-03-30,아시아드경기장(공촌사거리),18915,8993,9922
2,2024-03-30,서구청,21810,10868,10942
2,2024-03-30,가정(루원시티),15897,8299,7598
2,2024-03-30,가정중앙시장,10957,5365,5592
2,2024-03-30,석남(거북시장),5174,2452,2722
2,2024-03-30,서부여성회관,6466,3333,3133
2,2024-03-30,인천가좌,5153,2628,2525
2,2024-03-30,가재울,4924,2541,2383
2,2024-03-30,주안국가산단,1491,726,765
2,2024-03-30,주안,14273,5739,8534
2,2024-03-30,시민공원(문화창작지대),16206,8289,7917
2,2024-03-30,석바위시장,6803,3283,3520
2,2024-03-30,인천시청,5366,2469,2897
2,2024-03-30,석천사거리,7004,3686,3318
2,2024-03-30,모래내시장,14362,7034,7328
2,2024-03-30,만수,7914,4134,3780
2,2024-03-30,남동구청,6133,3180,2953
2,2024-03-30,인천대공원,8404,4147,4257
2,2024-03-30,운연(서창),2053,1090,963
2,2024-03-31,검단오류(검단산업단지),1576,767,809
2,2024-03-31,왕길,2330,1177,1153
2,2024-03-31,검단사거리,10894,5416,5478
2,2024-03-31,마전,4573,2189,2384
2,2024-03-31,완정,8148,4214,3934
2,2024-03-31,독정,4772,2339,2433
2,2024-03-31,검암,5836,3127,2709
2,2024-03-31,검바위,3249,1554,1695
2,2024-03-31,아시아드경기장(공촌사거리),17342,8253,9089
2,2024-03-31,서구청,18604,9819,8785
2,2024-03-31,가정(루원시티),11313,5798,5515
2,2024-03-31,가정중앙시장,8112,4055,4057
2,2024-03-31,석남(거북시장),3874,1801,2073
2,2024-03-31,서부여성회관,5402,2793,2609
2,2024-03-31,인천가좌,3707,1883,1824
2,2024-03-31,가재울,3690,1855,1835
2,2024-03-31,주안국가산단,742,339,403
2,2024-03-31,주안,10694,4324,6370
2,2024-03-31,시민공원(문화창작지대),12758,6568,6190
2,2024-03-31,석바위시장,5599,2719,2880
2,2024-03-31,인천시청,4296,2057,2239
2,2024-03-31,석천사거리,5477,2883,2594
2,2024-03-31,모래내시장,12242,5932,6310
2,2024-03-31,만수,6588,3470,3118
2,2024-03-31,남동구청,4747,2442,2305
2,2024-03-31,인천대공원,10724,5309,5415
2,2024-03-31,운연(서창),1676,862,814
2,2024-04-01,검단오류(검단산업단지),5896,2838,3058
2,2024-04-01,왕길,5590,2819,2771
2,2024-04-01,검단사거리,17761,9285,8476
2,2024-04-01,마전,8932,4363,4569
2,2024-04-01,완정,16159,8276,7883
2,2024-04-01,독정,9467,4759,4708
2,2024-04-01,검암,9458,5115,4343
2,2024-04-01,검바위,7159,3518,3641
2,2024-04-01,아시아드경기장(공촌사거리),9616,5138,4478
2,2024-04-01,서구청,17919,9129,8790
2,2024-04-01,가정(루원시티),24501,12557,11944
2,2024-04-01,가정중앙시장,12718,6196,6522
2,2024-04-01,석남(거북시장),6522,3201,3321
2,2024-04-01,서부여성회관,8544,4351,4193
2,2024-04-01,인천가좌,9231,4669,4562
2,2024-04-01,가재울,8566,4353,4213
2,2024-04-01,주안국가산단,5936,2881,3055
2,2024-04-01,주안,16310,6975,9335
2,2024-04-01,시민공원(문화창작지대),21680,11182,10498
2,2024-04-01,석바위시장,9208,4457,4751
2,2024-04-01,인천시청,6850,3299,3551
2,2024-04-01,석천사거리,10267,5370,4897
2,2024-04-01,모래내시장,16415,8048,8367
2,2024-04-01,만수,10260,5265,4995
2,2024-04-01,남동구청,9572,4962,4610
2,2024-04-01,인천대공원,6752,3399,3353
2,2024-04-01,운연(서창),2607,1380,1227
2,2024-04-02,검단오류(검단산업단지),6060,2968,3092
2,2024-04-02,왕길,5581,2823,2758
2,2024-04-02,검단사거리,17762,9291,8471
2,2024-04-02,마전,9302,4504,4798
2,2024-04-02,완정,16388,8464,7924
2,2024-04-02,독정,9467,4737,4730
2,2024-04-02,검암,9585,5167,4418
2,2024-04-02,검바위,7401,3587,3814
2,2024-04-02,아시아드경기장(공촌사거리),9692,5156,4536
2,2024-04-02,서구청,17696,8785,8911
2,2024-04-02,가정(루원시티),24940,12711,12229
2,2024-04-02,가정중앙시장,13059,6345,6714
2,2024-04-02,석남(거북시장),6557,3188,3369
2,2024-04-02,서부여성회관,8739,4468,4271
2,2024-04-02,인천가좌,9370,4794,4576
2,2024-04-02,가재울,8754,4480,4274
2,2024-04-02,주안국가산단,6140,2986,3154
2,2024-04-02,주안,16736,7147,9589
2,2024-04-02,시민공원(문화창작지대),22008,11264,10744
2,2024-04-02,석바위시장,9668,4678,4990
2,2024-04-02,인천시청,7446,3606,3840
2,2024-04-02,석천사거리,10662,5572,5090
2,2024-04-02,모래내시장,17390,8493,8897
2,2024-04-02,만수,10848,5623,5225
2,2024-04-02,남동구청,9982,5169,4813
2,2024-04-02,인천대공원,8111,4084,4027
2,2024-04-02,운연(서창),2804,1473,1331
2,2024-04-03,검단오류(검단산업단지),6026,2977,3049
2,2024-04-03,왕길,5496,2747,2749
2,2024-04-03,검단사거리,17011,8963,8048
2,2024-04-03,마전,9008,4396,4612
2,2024-04-03,완정,16103,8340,7763
2,2024-04-03,독정,9277,4618,4659
2,2024-04-03,검암,9106,4921,4185
2,2024-04-03,검바위,7383,3621,3762
2,2024-04-03,아시아드경기장(공촌사거리),10265,5451,4814
2,2024-04-03,서구청,17261,8534,8727
2,2024-04-03,가정(루원시티),24964,12832,12132
2,2024-04-03,가정중앙시장,12846,6193,6653
2,2024-04-03,석남(거북시장),6579,3246,3333
2,2024-04-03,서부여성회관,8692,4447,4245
2,2024-04-03,인천가좌,9130,4598,4532
2,2024-04-03,가재울,8605,4361,4244
2,2024-04-03,주안국가산단,6021,2926,3095
2,2024-04-03,주안,16488,6968,9520
2,2024-04-03,시민공원(문화창작지대),21290,10812,10478
2,2024-04-03,석바위시장,9158,4448,4710
2,2024-04-03,인천시청,7004,3387,3617
2,2024-04-03,석천사거리,10298,5359,4939
2,2024-04-03,모래내시장,16158,7845,8313
2,2024-04-03,만수,10525,5453,5072
2,2024-04-03,남동구청,9604,5029,4575
2,2024-04-03,인천대공원,5518,2791,2727
2,2024-04-03,운연(서창),2613,1394,1219
2,2024-04-04,검단오류(검단산업단지),5989,2960,3029
2,2024-04-04,왕길,5614,2808,2806
2,2024-04-04,검단사거리,17532,9251,8281
2,2024-04-04,마전,9031,4424,4607
2,2024-04-04,완정,16368,8459,7909
2,2024-04-04,독정,9591,4746,4845
2,2024-04-04,검암,9416,5126,4290
2,2024-04-04,검바위,7962,3901,4061
2,2024-04-04,아시아드경기장(공촌사거리),9765,5174,4591
2,2024-04-04,서구청,17994,8918,9076
2,2024-04-04,가정(루원시티),25181,12888,12293
2,2024-04-04,가정중앙시장,13109,6405,6704
2,2024-04-04,석남(거북시장),6724,3244,3480
2,2024-04-04,서부여성회관,8998,4585,4413
2,2024-04-04,인천가좌,9324,4688,4636
2,2024-04-04,가재울,8608,4387,4221
2,2024-04-04,주안국가산단,6033,2953,3080
2,2024-04-04,주안,16662,7113,9549
2,2024-04-04,시민공원(문화창작지대),22065,11303,10762
2,2024-04-04,석바위시장,9271,4496,4775
2,2024-04-04,인천시청,7519,3616,3903
2,2024-04-04,석천사거리,10833,5630,5203
2,2024-04-04,모래내시장,17606,8588,9018
2,2024-04-04,만수,10989,5670,5319
2,2024-04-04,남동구청,10044,5202,4842
2,2024-04-04,인천대공원,10169,5066,5103
2,2024-04-04,운연(서창),2745,1458,1287
2,2024-04-05,검단오류(검단산업단지),5842,2840,3002
2,2024-04-05,왕길,5571,2852,2719
2,2024-04-05,검단사거리,18829,9820,9009
2,2024-04-05,마전,9267,4512,4755
2,2024-04-05,완정,17029,8839,8190
2,2024-04-05,독정,9674,4827,4847
2,2024-04-05,검암,9628,5225,4403
2,2024-04-05,검바위,7581,3731,3850
2,2024-04-05,아시아드경기장(공촌사거리),9981,5321,4660
2,2024-04-05,서구청,18494,9118,9376
2,2024-04-05,가정(루원시티),25293,12904,12389
2,2024-04-05,가정중앙시장,13820,6748,7072
2,2024-04-05,석남(거북시장),6750,3294,3456
2,2024-04-05,서부여성회관,9135,4613,4522
2,2024-04-05,인천가좌,9417,4797,4620
2,2024-04-05,가재울,8814,4518,4296
2,2024-04-05,주안국가산단,5840,2823,3017
2,2024-04-05,주안,17294,7426,9868
2,2024-04-05,시민공원(문화창작지대),21999,11389,10610
2,2024-04-05,석바위시장,9454,4637,4817
2,2024-04-05,인천시청,7215,3446,3769
2,2024-04-05,석천사거리,10675,5592,5083
2,2024-04-05,모래내시장,17701,8572,9129
2,2024-04-05,만수,11449,5930,5519
2,2024-04-05,남동구청,10292,5487,4805
2,2024-04-05,인천대공원,12363,6147,6216
2,2024-04-05,운연(서창),2782,1496,1286
2,2024-04-06,검단오류(검단산업단지),2309,1286,1023
2,2024-04-06,왕길,3482,1814,1668
2,2024-04-06,검단사거리,14755,7591,7164
2,2024-04-06,마전,6388,3150,3238
2,2024-04-06,완정,11823,6304,5519
2,2024-04-06,독정,6695,3304,3391
2,2024-04-06,검암,6599,3571,3028
2,2024-04-06,검바위,4213,2034,2179
2,2024-04-06,아시아드경기장(공촌사거리),7219,3732,3487
2,2024-04-06,서구청,12714,6351,6363
2,2024-04-06,가정(루원시티),16796,8754,8042
2,2024-04-06,가정중앙시장,11409,5760,5649
2,2024-04-06,석남(거북시장),5606,2675,2931
2,2024-04-06,서부여성회관,6989,3552,3437
2,2024-04-06,인천가좌,5788,2951,2837
2,2024-04-06,가재울,5758,3004,2754
2,2024-04-06,주안국가산단,1506,756,750
2,2024-04-06,주안,16055,6696,9359
2,2024-04-06,시민공원(문화창작지대),18227,9483,8744
2,2024-04-06,석바위시장,8137,3984,4153
2,2024-04-06,인천시청,7143,3300,3843
2,2024-04-06,석천사거리,9203,5002,4201
2,2024-04-06,모래내시장,18709,9160,9549
2,2024-04-06,만수,10933,5785,5148
2,2024-04-06,남동구청,8584,4609,3975
2,2024-04-06,인천대공원,50765,24585,26180
2,2024-04-06,운연(서창),3530,1895,1635
2,2024-04-07,검단오류(검단산업단지),1707,862,845
2,2024-04-07,왕길,2359,1202,1157
2,2024-04-07,검단사거리,11580,5746,5834
2,2024-04-07,마전,4799,2314,2485
2,2024-04-07,완정,8408,4278,4130
2,2024-04-07,독정,5422,2703,2719
2,2024-04-07,검암,5343,2845,2498
2,2024-04-07,검바위,3193,1531,1662
2,2024-04-07,아시아드경기장(공촌사거리),5725,3000,2725
2,2024-04-07,서구청,8796,4478,4318
2,2024-04-07,가정(루원시티),11950,6111,5839
2,2024-04-07,가정중앙시장,8687,4272,4415
2,2024-04-07,석남(거북시장),4069,1935,2134
2,2024-04-07,서부여성회관,6205,3262,2943
2,2024-04-07,인천가좌,4296,2185,2111
2,2024-04-07,가재울,4643,2361,2282
2,2024-04-07,주안국가산단,950,454,496
2,2024-04-07,주안,11930,4938,6992
2,2024-04-07,시민공원(문화창작지대),14941,7755,7186
2,2024-04-07,석바위시장,6257,3133,3124
2,2024-04-07,인천시청,5795,2682,3113
2,2024-04-07,석천사거리,7211,3918,3293
2,2024-04-07,모래내시장,15956,7846,8110
2,2024-04-07,만수,8950,4682,4268
2,2024-04-07,남동구청,6712,3626,3086
2,2024-04-07,인천대공원,47034,22819,24215
2,2024-04-07,운연(서창),3279,1839,1440
2,2024-04-08,검단오류(검단산업단지),5939,2888,3051
2,2024-04-08,왕길,5538,2795,2743
2,2024-04-08,검단사거리,17355,9090,8265
2,2024-04-08,마전,9111,4430,4681
2,2024-04-08,완정,15959,8329,7630
2,2024-04-08,독정,9409,4654,4755
2,2024-04-08,검암,9300,5055,4245
2,2024-04-08,검바위,7570,3709,3861
2,2024-04-08,아시아드경기장(공촌사거리),9657,5137,4520
2,2024-04-08,서구청,17661,8805,8856
2,2024-04-08,가정(루원시티),24459,12588,11871
2,2024-04-08,가정중앙시장,12826,6307,6519
2,2024-04-08,석남(거북시장),6635,3246,3389
2,2024-04-08,서부여성회관,8598,4423,4175
2,2024-04-08,인천가좌,9100,4587,4513
2,2024-04-08,가재울,8567,4323,4244
2,2024-04-08,주안국가산단,6121,3000,3121
2,2024-04-08,주안,16693,7184,9509
2,2024-04-08,시민공원(문화창작지대),22067,11305,10762
2,2024-04-08,석바위시장,9390,4536,4854
2,2024-04-08,인천시청,7107,3475,3632
2,2024-04-08,석천사거리,10565,5543,5022
2,2024-04-08,모래내시장,17703,8599,9104
2,2024-04-08,만수,10897,5601,5296
2,2024-04-08,남동구청,9989,5205,4784
2,2024-04-08,인천대공원,14949,7466,7483
2,2024-04-08,운연(서창),2757,1461,1296
2,2024-04-09,검단오류(검단산업단지),6054,2955,3099
2,2024-04-09,왕길,5756,2935,2821
2,2024-04-09,검단사거리,18510,9658,8852
2,2024-04-09,마전,9406,4599,4807
2,2024-04-09,완정,16905,8822,8083
2,2024-04-09,독정,9803,4914,4889
2,2024-04-09,검암,9785,5386,4399
2,2024-04-09,검바위,7744,3802,3942
2,2024-04-09,아시아드경기장(공촌사거리),9741,5269,4472
2,2024-04-09,서구청,18675,9214,9461
2,2024-04-09,가정(루원시티),25973,13374,12599
2,2024-04-09,가정중앙시장,13874,6731,7143
2,2024-04-09,석남(거북시장),6678,3306,3372
2,2024-04-09,서부여성회관,8968,4591,4377
2,2024-04-09,인천가좌,9534,4827,4707
2,2024-04-09,가재울,9148,4712,4436
2,2024-04-09,주안국가산단,6172,2990,3182
2,2024-04-09,주안,17813,7560,10253
2,2024-04-09,시민공원(문화창작지대),22948,11823,11125
2,2024-04-09,석바위시장,9765,4735,5030
2,2024-04-09,인천시청,7655,3690,3965
2,2024-04-09,석천사거리,10997,5797,5200
2,2024-04-09,모래내시장,18484,8964,9520
2,2024-04-09,만수,11599,6035,5564
2,2024-04-09,남동구청,10355,5415,4940
2,2024-04-09,인천대공원,15634,7854,7780
2,2024-04-09,운연(서창),2859,1552,1307
2,2024-04-10,검단오류(검단산업단지),2221,1117,1104
2,2024-04-10,왕길,3010,1531,1479
2,2024-04-10,검단사거리,12180,6232,5948
2,2024-04-10,마전,5316,2581,2735
2,2024-04-10,완정,9461,4955,4506
2,2024-04-10,독정,5361,2618,2743
2,2024-04-10,검암,5956,3259,2697
2,2024-04-10,검바위,3846,1867,1979
2,2024-04-10,아시아드경기장(공촌사거리),5890,3122,2768
2,2024-04-10,서구청,10450,5142,5308
2,2024-04-10,가정(루원시티),13236,6846,6390
2,2024-04-10,가정중앙시장,9456,4685,4771
2,2024-04-10,석남(거북시장),4406,2137,2269
2,2024-04-10,서부여성회관,5796,2996,2800
2,2024-04-10,인천가좌,4949,2499,2450
2,2024-04-10,가재울,4950,2534,2416
2,2024-04-10,주안국가산단,1613,759,854
2,2024-04-10,주안,12108,5019,7089
2,2024-04-10,시민공원(문화창작지대),14647,7494,7153
2,2024-04-10,석바위시장,6540,3228,3312
2,2024-04-10,인천시청,4830,2295,2535
2,2024-04-10,석천사거리,6574,3556,3018
2,2024-04-10,모래내시장,14427,7053,7374
2,2024-04-10,만수,8145,4211,3934
2,2024-04-10,남동구청,6089,3159,2930
2,2024-04-10,인천대공원,25736,12540,13196
2,2024-04-10,운연(서창),2210,1149,1061
2,2024-04-11,검단오류(검단산업단지),5949,2920,3029
2,2024-04-11,왕길,5506,2764,2742
2,2024-04-11,검단사거리,17301,9068,8233
2,2024-04-11,마전,8960,4290,4670
2,2024-04-11,완정,15835,8206,7629
2,2024-04-11,독정,9414,4726,4688
2,2024-04-11,검암,9128,4983,4145
2,2024-04-11,검바위,7557,3686,3871
2,2024-04-11,아시아드경기장(공촌사거리),9856,5274,4582
2,2024-04-11,서구청,17761,8858,8903
2,2024-04-11,가정(루원시티),24225,12388,11837
2,2024-04-11,가정중앙시장,12794,6206,6588
2,2024-04-11,석남(거북시장),6491,3169,3322
2,2024-04-11,서부여성회관,8561,4351,4210
2,2024-04-11,인천가좌,9146,4599,4547
2,2024-04-11,가재울,8432,4274,4158
2,2024-04-11,주안국가산단,5947,2880,3067
2,2024-04-11,주안,16504,7097,9407
2,2024-04-11,시민공원(문화창작지대),21754,11143,10611
2,2024-04-11,석바위시장,9010,4361,4649
2,2024-04-11,인천시청,7040,3394,3646
2,2024-04-11,석천사거리,10244,5352,4892
2,2024-04-11,모래내시장,16639,8135,8504
2,2024-04-11,만수,10679,5545,5134
2,2024-04-11,남동구청,9529,4969,4560
2,2024-04-11,인천대공원,8809,4362,4447
2,2024-04-11,운연(서창),2655,1430,1225
2,2024-04-12,검단오류(검단산업단지),5962,2921,3041
2,2024-04-12,왕길,5785,2929,2856
2,2024-04-12,검단사거리,18483,9687,8796
2,2024-04-12,마전,9258,4468,4790
2,2024-04-12,완정,16744,8670,8074
2,2024-04-12,독정,9707,4895,4812
2,2024-04-12,검암,9521,5242,4279
2,2024-04-12,검바위,7799,3823,3976
2,2024-04-12,아시아드경기장(공촌사거리),9977,5336,4641
2,2024-04-12,서구청,18366,9059,9307
2,2024-04-12,가정(루원시티),25181,12963,12218
2,2024-04-12,가정중앙시장,13576,6599,6977
2,2024-04-12,석남(거북시장),6673,3238,3435
2,2024-04-12,서부여성회관,9081,4635,4446
2,2024-04-12,인천가좌,9385,4724,4661
2,2024-04-12,가재울,8739,4485,4254
2,2024-04-12,주안국가산단,5956,2905,3051
2,2024-04-12,주안,17271,7431,9840
2,2024-04-12,시민공원(문화창작지대),21860,11252,10608
2,2024-04-12,석바위시장,9468,4555,4913
2,2024-04-12,인천시청,7752,3705,4047
2,2024-04-12,석천사거리,10693,5560,5133
2,2024-04-12,모래내시장,18186,8818,9368
2,2024-04-12,만수,11453,5983,5470
2,2024-04-12,남동구청,10213,5319,4894
2,2024-04-12,인천대공원,9567,4807,4760
2,2024-04-12,운연(서창),2875,1543,1332
2,2024-04-13,검단오류(검단산업단지),2306,1237,1069
2,2024-04-13,왕길,3333,1728,1605
2,2024-04-13,검단사거리,14313,7504,6809
2,2024-04-13,마전,6610,3313,3297
2,2024-04-13,완정,11246,5910,5336
2,2024-04-13,독정,6606,3370,3236
2,2024-04-13,검암,6828,3692,3136
2,2024-04-13,검바위,4140,2027,2113
2,2024-04-13,아시아드경기장(공촌사거리),7156,3701,3455
2,2024-04-13,서구청,11835,5941,5894
2,2024-04-13,가정(루원시티),15477,8020,7457
2,2024-04-13,가정중앙시장,10699,5278,5421
2,2024-04-13,석남(거북시장),5051,2417,2634
2,2024-04-13,서부여성회관,6762,3487,3275
2,2024-04-13,인천가좌,5251,2720,2531
2,2024-04-13,가재울,5707,2947,2760
2,2024-04-13,주안국가산단,1517,740,777
2,2024-04-13,주안,14419,5895,8524
2,2024-04-13,시민공원(문화창작지대),16051,8286,7765
2,2024-04-13,석바위시장,7464,3644,3820
2,2024-04-13,인천시청,5412,2572,2840
2,2024-04-13,석천사거리,6680,3503,3177
2,2024-04-13,모래내시장,14541,7119,7422
2,2024-04-13,만수,8768,4541,4227
2,2024-04-13,남동구청,6547,3493,3054
2,2024-04-13,인천대공원,15396,7521,7875
2,2024-04-13,운연(서창),2177,1179,998
2,2024-04-14,검단오류(검단산업단지),1759,872,887
2,2024-04-14,왕길,2275,1157,1118
2,2024-04-14,검단사거리,10670,5294,5376
2,2024-04-14,마전,4298,2134,2164
2,2024-04-14,완정,7786,3947,3839
2,2024-04-14,독정,4346,2166,2180
2,2024-04-14,검암,5041,2659,2382
2,2024-04-14,검바위,3140,1455,1685
2,2024-04-14,아시아드경기장(공촌사거리),5573,2857,2716
2,2024-04-14,서구청,8316,4207,4109
2,2024-04-14,가정(루원시티),11135,5725,5410
2,2024-04-14,가정중앙시장,7925,3882,4043
2,2024-04-14,석남(거북시장),3599,1717,1882
2,2024-04-14,서부여성회관,5413,2805,2608
2,2024-04-14,인천가좌,3768,1893,1875
2,2024-04-14,가재울,3834,1924,1910
2,2024-04-14,주안국가산단,721,327,394
2,2024-04-14,주안,10118,4157,5961
2,2024-04-14,시민공원(문화창작지대),11907,6137,5770
2,2024-04-14,석바위시장,5606,2698,2908
2,2024-04-14,인천시청,4083,1946,2137
2,2024-04-14,석천사거리,5537,2939,2598
2,2024-04-14,모래내시장,11696,5738,5958
2,2024-04-14,만수,6667,3433,3234
2,2024-04-14,남동구청,4838,2517,2321
2,2024-04-14,인천대공원,12162,6015,6147
2,2024-04-14,운연(서창),1735,891,844
2,2024-04-15,검단오류(검단산업단지),5567,2676,2891
2,2024-04-15,왕길,5118,2579,2539
2,2024-04-15,검단사거리,16144,8477,7667
2,2024-04-15,마전,8705,4233,4472
2,2024-04-15,완정,15293,7895,7398
2,2024-04-15,독정,9158,4578,4580
2,2024-04-15,검암,8697,4755,3942
2,2024-04-15,검바위,7077,3490,3587
2,2024-04-15,아시아드경기장(공촌사거리),8943,4750,4193
2,2024-04-15,서구청,16119,8009,8110
2,2024-04-15,가정(루원시티),23139,11818,11321
2,2024-04-15,가정중앙시장,11282,5504,5778
2,2024-04-15,석남(거북시장),5845,2864,2981
2,2024-04-15,서부여성회관,7695,3898,3797
2,2024-04-15,인천가좌,8704,4383,4321
2,2024-04-15,가재울,7938,3998,3940
2,2024-04-15,주안국가산단,5891,2856,3035
2,2024-04-15,주안,15107,6442,8665
2,2024-04-15,시민공원(문화창작지대),19957,10249,9708
2,2024-04-15,석바위시장,8542,4104,4438
2,2024-04-15,인천시청,6097,3003,3094
2,2024-04-15,석천사거리,9617,5035,4582
2,2024-04-15,모래내시장,13971,6829,7142
2,2024-04-15,만수,9473,4916,4557
2,2024-04-15,남동구청,8706,4547,4159
2,2024-04-15,인천대공원,2862,1431,1431
2,2024-04-15,운연(서창),2196,1178,1018
2,2024-04-16,검단오류(검단산업단지),5970,2964,3006
2,2024-04-16,왕길,5622,2807,2815
2,2024-04-16,검단사거리,17336,9120,8216
2,2024-04-16,마전,9124,4442,4682
2,2024-04-16,완정,16183,8359,7824
2,2024-04-16,독정,9529,4727,4802
2,2024-04-16,검암,9339,5164,4175
2,2024-04-16,검바위,7591,3700,3891
2,2024-04-16,아시아드경기장(공촌사거리),9721,5184,4537
2,2024-04-16,서구청,17679,8766,8913
2,2024-04-16,가정(루원시티),24737,12611,12126
2,2024-04-16,가정중앙시장,13090,6313,6777
2,2024-04-16,석남(거북시장),6315,3093,3222
2,2024-04-16,서부여성회관,8487,4339,4148
2,2024-04-16,인천가좌,9235,4668,4567
2,2024-04-16,가재울,8604,4396,4208
2,2024-04-16,주안국가산단,6095,2997,3098
2,2024-04-16,주안,16388,7031,9357
2,2024-04-16,시민공원(문화창작지대),21502,11048,10454
2,2024-04-16,석바위시장,9253,4471,4782
2,2024-04-16,인천시청,7110,3444,3666
2,2024-04-16,석천사거리,10317,5357,4960
2,2024-04-16,모래내시장,16478,8061,8417
2,2024-04-16,만수,10597,5517,5080
2,2024-04-16,남동구청,9997,5204,4793
2,2024-04-16,인천대공원,5279,2654,2625
2,2024-04-16,운연(서창),2660,1415,1245
2,2024-04-17,검단오류(검단산업단지),6181,3027,3154
2,2024-04-17,왕길,5584,2792,2792
2,2024-04-17,검단사거리,17750,9341,8409
2,2024-04-17,마전,9065,4355,4710
2,2024-04-17,완정,16636,8539,8097
2,2024-04-17,독정,9597,4828,4769
2,2024-04-17,검암,9471,5177,4294
2,2024-04-17,검바위,7787,3833,3954
2,2024-04-17,아시아드경기장(공촌사거리),10228,5391,4837
2,2024-04-17,서구청,17800,8818,8982
2,2024-04-17,가정(루원시티),25192,12944,12248
2,2024-04-17,가정중앙시장,13676,6672,7004
2,2024-04-17,석남(거북시장),6642,3219,3423
2,2024-04-17,서부여성회관,8775,4493,4282
2,2024-04-17,인천가좌,9449,4730,4719
2,2024-04-17,가재울,8804,4504,4300
2,2024-04-17,주안국가산단,6107,2980,3127
2,2024-04-17,주안,16872,7228,9644
2,2024-04-17,시민공원(문화창작지대),22109,11289,10820
2,2024-04-17,석바위시장,9580,4678,4902
2,2024-04-17,인천시청,7479,3567,3912
2,2024-04-17,석천사거리,10587,5506,5081
2,2024-04-17,모래내시장,16878,8235,8643
2,2024-04-17,만수,10836,5577,5259
2,2024-04-17,남동구청,10329,5409,4920
2,2024-04-17,인천대공원,6881,3453,3428
2,2024-04-17,운연(서창),2905,1568,1337
2,2024-04-18,검단오류(검단산업단지),6054,2978,3076
2,2024-04-18,왕길,5676,2849,2827
2,2024-04-18,검단사거리,17397,9082,8315
2,2024-04-18,마전,9136,4425,4711
2,2024-04-18,완정,16981,8758,8223
2,2024-04-18,독정,9607,4787,4820
2,2024-04-18,검암,9382,5127,4255
2,2024-04-18,검바위,7542,3665,3877
2,2024-04-18,아시아드경기장(공촌사거리),9910,5276,4634
2,2024-04-18,서구청,17848,8787,9061
2,2024-04-18,가정(루원시티),24880,12723,12157
2,2024-04-18,가정중앙시장,13356,6565,6791
2,2024-04-18,석남(거북시장),6584,3239,3345
2,2024-04-18,서부여성회관,8888,4484,4404
2,2024-04-18,인천가좌,9189,4655,4534
2,2024-04-18,가재울,8838,4510,4328
2,2024-04-18,주안국가산단,5803,2792,3011
2,2024-04-18,주안,16612,7134,9478
2,2024-04-18,시민공원(문화창작지대),22066,11283,10783
2,2024-04-18,석바위시장,9206,4393,4813
2,2024-04-18,인천시청,7509,3583,3926
2,2024-04-18,석천사거리,10556,5492,5064
2,2024-04-18,모래내시장,17224,8373,8851
2,2024-04-18,만수,10961,5629,5332
2,2024-04-18,남동구청,10173,5339,4834
2,2024-04-18,인천대공원,9377,4711,4666
2,2024-04-18,운연(서창),2767,1478,1289
2,2024-04-19,검단오류(검단산업단지),5890,2896,2994
2,2024-04-19,왕길,5812,2959,2853
2,2024-04-19,검단사거리,18421,9639,8782
2,2024-04-19,마전,9229,4465,4764
2,2024-04-19,완정,16422,8574,7848
2,2024-04-19,독정,9910,4968,4942
2,2024-04-19,검암,9563,5240,4323
2,2024-04-19,검바위,7793,3837,3956
2,2024-04-19,아시아드경기장(공촌사거리),10161,5437,4724
2,2024-04-19,서구청,18644,9267,9377
2,2024-04-19,가정(루원시티),25235,12900,12335
2,2024-04-19,가정중앙시장,13943,6837,7106
2,2024-04-19,석남(거북시장),6684,3247,3437
2,2024-04-19,서부여성회관,9183,4669,4514
2,2024-04-19,인천가좌,9639,4879,4760
2,2024-04-19,가재울,8915,4545,4370
2,2024-04-19,주안국가산단,5540,2686,2854
2,2024-04-19,주안,17214,7334,9880
2,2024-04-19,시민공원(문화창작지대),21975,11289,10686
2,2024-04-19,석바위시장,9565,4621,4944
2,2024-04-19,인천시청,7521,3588,3933
2,2024-04-19,석천사거리,10399,5496,4903
2,2024-04-19,모래내시장,17808,8626,9182
2,2024-04-19,만수,11365,5898,5467
2,2024-04-19,남동구청,10410,5459,4951
2,2024-04-19,인천대공원,8072,4050,4022
2,2024-04-19,운연(서창),2858,1555,1303
2,2024-04-20,검단오류(검단산업단지),2064,1126,938
2,2024-04-20,왕길,2909,1504,1405
2,2024-04-20,검단사거리,12825,6697,6128
2,2024-04-20,마전,5685,2811,2874
2,2024-04-20,완정,9854,5197,4657
2,2024-04-20,독정,5844,2905,2939
2,2024-04-20,검암,5385,2925,2460
2,2024-04-20,검바위,3801,1836,1965
2,2024-04-20,아시아드경기장(공촌사거리),6343,3222,3121
2,2024-04-20,서구청,11035,5553,5482
2,2024-04-20,가정(루원시티),14473,7568,6905
2,2024-04-20,가정중앙시장,9518,4681,4837
2,2024-04-20,석남(거북시장),4378,2081,2297
2,2024-04-20,서부여성회관,5889,3024,2865
2,2024-04-20,인천가좌,4580,2319,2261
2,2024-04-20,가재울,4454,2292,2162
2,2024-04-20,주안국가산단,1511,747,764
2,2024-04-20,주안,12629,5103,7526
2,2024-04-20,시민공원(문화창작지대),14330,7379,6951
2,2024-04-20,석바위시장,6578,3213,3365
2,2024-04-20,인천시청,4669,2221,2448
2,2024-04-20,석천사거리,6004,3139,2865
2,2024-04-20,모래내시장,12152,5951,6201
2,2024-04-20,만수,7267,3755,3512
2,2024-04-20,남동구청,5703,2927,2776
2,2024-04-20,인천대공원,5102,2528,2574
2,2024-04-20,운연(서창),1683,881,802
2,2024-04-21,검단오류(검단산업단지),1624,792,832
2,2024-04-21,왕길,2207,1115,1092
2,2024-04-21,검단사거리,10123,5068,5055
2,2024-04-21,마전,4237,2044,2193
2,2024-04-21,완정,7586,3898,3688
2,2024-04-21,독정,4743,2358,2385
2,2024-04-21,검암,4445,2390,2055
2,2024-04-21,검바위,3165,1532,1633
2,2024-04-21,아시아드경기장(공촌사거리),5237,2721,2516
2,2024-04-21,서구청,8247,4115,4132
2,2024-04-21,가정(루원시티),10855,5471,5384
2,2024-04-21,가정중앙시장,7912,3916,3996
2,2024-04-21,석남(거북시장),3495,1646,1849
2,2024-04-21,서부여성회관,5284,2688,2596
2,2024-04-21,인천가좌,3624,1821,1803
2,2024-04-21,가재울,3741,1862,1879
2,2024-04-21,주안국가산단,740,330,410
2,2024-04-21,주안,9866,4076,5790
2,2024-04-21,시민공원(문화창작지대),11550,5951,5599
2,2024-04-21,석바위시장,5344,2574,2770
2,2024-04-21,인천시청,4080,1933,2147
2,2024-04-21,석천사거리,5029,2657,2372
2,2024-04-21,모래내시장,11044,5403,5641
2,2024-04-21,만수,6186,3246,2940
2,2024-04-21,남동구청,4638,2408,2230
2,2024-04-21,인천대공원,9122,4545,4577
2,2024-04-21,운연(서창),1612,857,755
2,2024-04-22,검단오류(검단산업단지),5763,2817,2946
2,2024-04-22,왕길,5569,2805,2764
2,2024-04-22,검단사거리,17589,9190,8399
2,2024-04-22,마전,8901,4329,4572
2,2024-04-22,완정,16056,8298,7758
2,2024-04-22,독정,9832,4917,4915
2,2024-04-22,검암,9254,5091,4163
2,2024-04-22,검바위,7520,3657,3863
2,2024-04-22,아시아드경기장(공촌사거리),9855,5200,4655
2,2024-04-22,서구청,17854,8878,8976
2,2024-04-22,가정(루원시티),24294,12469,11825
2,2024-04-22,가정중앙시장,12984,6360,6624
2,2024-04-22,석남(거북시장),6400,3118,3282
2,2024-04-22,서부여성회관,8516,4354,4162
2,2024-04-22,인천가좌,9275,4697,4578
2,2024-04-22,가재울,8677,4431,4246
2,2024-04-22,주안국가산단,5877,2897,2980
2,2024-04-22,주안,16529,7146,9383
2,2024-04-22,시민공원(문화창작지대),21540,11044,10496
2,2024-04-22,석바위시장,9252,4482,4770
2,2024-04-22,인천시청,6991,3376,3615
2,2024-04-22,석천사거리,10165,5311,4854
2,2024-04-22,모래내시장,16897,8224,8673
2,2024-04-22,만수,10620,5488,5132
2,2024-04-22,남동구청,9733,5050,4683
2,2024-04-22,인천대공원,6909,3479,3430
2,2024-04-22,운연(서창),2691,1421,1270
2,2024-04-23,검단오류(검단산업단지),6056,2972,3084
2,2024-04-23,왕길,5529,2745,2784
2,2024-04-23,검단사거리,17277,9127,8150
2,2024-04-23,마전,9013,4377,4636
2,2024-04-23,완정,16089,8358,7731
2,2024-04-23,독정,9395,4713,4682
2,2024-04-23,검암,9516,5143,4373
2,2024-04-23,검바위,7676,3712,3964
2,2024-04-23,아시아드경기장(공촌사거리),10085,5389,4696
2,2024-04-23,서구청,18570,9184,9386
2,2024-04-23,가정(루원시티),24600,12548,12052
2,2024-04-23,가정중앙시장,13091,6339,6752
2,2024-04-23,석남(거북시장),6523,3202,3321
2,2024-04-23,서부여성회관,8593,4346,4247
2,2024-04-23,인천가좌,9247,4686,4561
2,2024-04-23,가재울,8783,4442,4341
2,2024-04-23,주안국가산단,6105,2952,3153
2,2024-04-23,주안,16643,7150,9493
2,2024-04-23,시민공원(문화창작지대),21659,11077,10582
2,2024-04-23,석바위시장,9310,4510,4800
2,2024-04-23,인천시청,7239,3550,3689
2,2024-04-23,석천사거리,10521,5440,5081
2,2024-04-23,모래내시장,17013,8318,8695
2,2024-04-23,만수,10719,5604,5115
2,2024-04-23,남동구청,9920,5159,4761
2,2024-04-23,인천대공원,7523,3823,3700
2,2024-04-23,운연(서창),2740,1471,1269
2,2024-04-24,검단오류(검단산업단지),5861,2895,2966
2,2024-04-24,왕길,5553,2752,2801
2,2024-04-24,검단사거리,16956,8901,8055
2,2024-04-24,마전,8922,4383,4539
2,2024-04-24,완정,16063,8250,7813
2,2024-04-24,독정,9533,4744,4789
2,2024-04-24,검암,9350,5113,4237
2,2024-04-24,검바위,7457,3628,3829
2,2024-04-24,아시아드경기장(공촌사거리),10061,5343,4718
2,2024-04-24,서구청,17683,8730,8953
2,2024-04-24,가정(루원시티),24317,12476,11841
2,2024-04-24,가정중앙시장,12885,6277,6608
2,2024-04-24,석남(거북시장),6348,3088,3260
2,2024-04-24,서부여성회관,8454,4285,4169
2,2024-04-24,인천가좌,9157,4635,4522
2,2024-04-24,가재울,8604,4372,4232
2,2024-04-24,주안국가산단,5952,2882,3070
2,2024-04-24,주안,16896,7231,9665
2,2024-04-24,시민공원(문화창작지대),21363,10987,10376
2,2024-04-24,석바위시장,9202,4472,4730
2,2024-04-24,인천시청,7235,3475,3760
2,2024-04-24,석천사거리,10204,5303,4901
2,2024-04-24,모래내시장,16163,7823,8340
2,2024-04-24,만수,10514,5460,5054
2,2024-04-24,남동구청,9769,5133,4636
2,2024-04-24,인천대공원,5010,2511,2499
2,2024-04-24,운연(서창),2548,1344,1204
2,2024-04-25,검단오류(검단산업단지),6028,2958,3070
2,2024-04-25,왕길,5653,2829,2824
2,2024-04-25,검단사거리,17605,9182,8423
2,2024-04-25,마전,9109,4422,4687
2,2024-04-25,완정,16559,8598,7961
2,2024-04-25,독정,9809,4878,4931
2,2024-04-25,검암,9551,5217,4334
2,2024-04-25,검바위,7631,3748,3883
2,2024-04-25,아시아드경기장(공촌사거리),9925,5317,4608
2,2024-04-25,서구청,18561,9178,9383
2,2024-04-25,가정(루원시티),24715,12611,12104
2,2024-04-25,가정중앙시장,13680,6728,6952
2,2024-04-25,석남(거북시장),6616,3198,3418
2,2024-04-25,서부여성회관,8871,4472,4399
2,2024-04-25,인천가좌,9293,4683,4610
2,2024-04-25,가재울,8873,4508,4365
2,2024-04-25,주안국가산단,5919,2865,3054
2,2024-04-25,주안,17011,7288,9723
2,2024-04-25,시민공원(문화창작지대),21996,11251,10745
2,2024-04-25,석바위시장,9279,4471,4808
2,2024-04-25,인천시청,7184,3451,3733
2,2024-04-25,석천사거리,10818,5658,5160
2,2024-04-25,모래내시장,17151,8371,8780
2,2024-04-25,만수,10829,5630,5199
2,2024-04-25,남동구청,10027,5255,4772
2,2024-04-25,인천대공원,7301,3622,3679
2,2024-04-25,운연(서창),2757,1484,1273
2,2024-04-26,검단오류(검단산업단지),5922,2900,3022
2,2024-04-26,왕길,5756,2885,2871
2,2024-04-26,검단사거리,18519,9636,8883
2,2024-04-26,마전,9195,4491,4704
2,2024-04-26,완정,16843,8740,8103
2,2024-04-26,독정,10133,5087,5046
2,2024-04-26,검암,9388,5152,4236
2,2024-04-26,검바위,7621,3718,3903
2,2024-04-26,아시아드경기장(공촌사거리),9998,5292,4706
2,2024-04-26,서구청,18735,9235,9500
2,2024-04-26,가정(루원시티),25332,13031,12301
2,2024-04-26,가정중앙시장,13989,6771,7218
2,2024-04-26,석남(거북시장),6785,3274,3511
2,2024-04-26,서부여성회관,8980,4579,4401
2,2024-04-26,인천가좌,9461,4806,4655
2,2024-04-26,가재울,8704,4463,4241
2,2024-04-26,주안국가산단,5747,2768,2979
2,2024-04-26,주안,17221,7269,9952
2,2024-04-26,시민공원(문화창작지대),21974,11233,10741
2,2024-04-26,석바위시장,9818,4773,5045
2,2024-04-26,인천시청,7260,3514,3746
2,2024-04-26,석천사거리,10502,5475,5027
2,2024-04-26,모래내시장,17612,8583,9029
2,2024-04-26,만수,11450,5971,5479
2,2024-04-26,남동구청,10225,5352,4873
2,2024-04-26,인천대공원,7595,3800,3795
2,2024-04-26,운연(서창),2839,1532,1307
2,2024-04-27,검단오류(검단산업단지),2331,1269,1062
2,2024-04-27,왕길,3501,1794,1707
2,2024-04-27,검단사거리,14565,7585,6980
2,2024-04-27,마전,6229,3095,3134
2,2024-04-27,완정,11320,5968,5352
2,2024-04-27,독정,6916,3451,3465
2,2024-04-27,검암,6851,3827,3024
2,2024-04-27,검바위,4812,2363,2449
2,2024-04-27,아시아드경기장(공촌사거리),7419,3833,3586
2,2024-04-27,서구청,12354,6134,6220
2,2024-04-27,가정(루원시티),16515,8500,8015
2,2024-04-27,가정중앙시장,10846,5383,5463
2,2024-04-27,석남(거북시장),5015,2368,2647
2,2024-04-27,서부여성회관,6696,3451,3245
2,2024-04-27,인천가좌,5253,2671,2582
2,2024-04-27,가재울,5330,2742,2588
2,2024-04-27,주안국가산단,1600,783,817
2,2024-04-27,주안,14815,5964,8851
2,2024-04-27,시민공원(문화창작지대),15882,8220,7662
2,2024-04-27,석바위시장,7037,3429,3608
2,2024-04-27,인천시청,5385,2564,2821
2,2024-04-27,석천사거리,7203,3827,3376
2,2024-04-27,모래내시장,15034,7324,7710
2,2024-04-27,만수,8357,4369,3988
2,2024-04-27,남동구청,6694,3516,3178
2,2024-04-27,인천대공원,10533,5299,5234
2,2024-04-27,운연(서창),2214,1172,1042
2,2024-04-28,검단오류(검단산업단지),1686,834,852
2,2024-04-28,왕길,2393,1210,1183
2,2024-04-28,검단사거리,10519,5326,5193
2,2024-04-28,마전,4376,2121,2255
2,2024-04-28,완정,8021,4013,4008
2,2024-04-28,독정,4186,2084,2102
2,2024-04-28,검암,4610,2466,2144
2,2024-04-28,검바위,3093,1467,1626
2,2024-04-28,아시아드경기장(공촌사거리),5717,2978,2739
2,2024-04-28,서구청,8253,4179,4074
2,2024-04-28,가정(루원시티),11148,5683,5465
2,2024-04-28,가정중앙시장,8029,3938,4091
2,2024-04-28,석남(거북시장),3764,1791,1973
2,2024-04-28,서부여성회관,5348,2727,2621
2,2024-04-28,인천가좌,3758,1898,1860
2,2024-04-28,가재울,3877,1964,1913
2,2024-04-28,주안국가산단,667,303,364
2,2024-04-28,주안,10679,4314,6365
2,2024-04-28,시민공원(문화창작지대),12299,6380,5919
2,2024-04-28,석바위시장,5479,2707,2772
2,2024-04-28,인천시청,3898,1870,2028
2,2024-04-28,석천사거리,5234,2790,2444
2,2024-04-28,모래내시장,11521,5564,5957
2,2024-04-28,만수,6475,3365,3110
2,2024-04-28,남동구청,4898,2525,2373
2,2024-04-28,인천대공원,10119,5021,5098
2,2024-04-28,운연(서창),1605,842,763
2,2024-04-29,검단오류(검단산업단지),5911,2901,3010
2,2024-04-29,왕길,5501,2753,2748
2,2024-04-29,검단사거리,17212,9090,8122
2,2024-04-29,마전,8992,4328,4664
2,2024-04-29,완정,15862,8184,7678
2,2024-04-29,독정,9700,4871,4829
2,2024-04-29,검암,9042,4935,4107
2,2024-04-29,검바위,7407,3643,3764
2,2024-04-29,아시아드경기장(공촌사거리),9672,5108,4564
2,2024-04-29,서구청,17767,8848,8919
2,2024-04-29,가정(루원시티),24236,12404,11832
2,2024-04-29,가정중앙시장,12871,6316,6555
2,2024-04-29,석남(거북시장),6274,3073,3201
2,2024-04-29,서부여성회관,8224,4225,3999
2,2024-04-29,인천가좌,9231,4685,4546
2,2024-04-29,가재울,8384,4223,4161
2,2024-04-29,주안국가산단,5945,2901,3044
2,2024-04-29,주안,16531,7057,9474
2,2024-04-29,시민공원(문화창작지대),21536,11049,10487
2,2024-04-29,석바위시장,9043,4404,4639
2,2024-04-29,인천시청,6793,3312,3481
2,2024-04-29,석천사거리,10125,5298,4827
2,2024-04-29,모래내시장,16650,8151,8499
2,2024-04-29,만수,10584,5464,5120
2,2024-04-29,남동구청,9644,5034,4610
2,2024-04-29,인천대공원,6286,3193,3093
2,2024-04-29,운연(서창),2703,1434,1269
2,2024-04-30,검단오류(검단산업단지),6067,2959,3108
2,2024-04-30,왕길,5619,2841,2778
2,2024-04-30,검단사거리,18216,9638,8578
2,2024-04-30,마전,9182,4467,4715
2,2024-04-30,완정,16577,8596,7981
2,2024-04-30,독정,10021,5063,4958
2,2024-04-30,검암,9667,5285,4382
2,2024-04-30,검바위,7699,3780,3919
2,2024-04-30,아시아드경기장(공촌사거리),10148,5451,4697
2,2024-04-30,서구청,18983,9337,9646
2,2024-04-30,가정(루원시티),25344,12937,12407
2,2024-04-30,가정중앙시장,13561,6610,6951
2,2024-04-30,석남(거북시장),6695,3262,3433
2,2024-04-30,서부여성회관,8610,4394,4216
2,2024-04-30,인천가좌,9358,4708,4650
2,2024-04-30,가재울,8813,4543,4270
2,2024-04-30,주안국가산단,6056,2925,3131
2,2024-04-30,주안,17572,7399,10173
2,2024-04-30,시민공원(문화창작지대),22443,11544,10899
2,2024-04-30,석바위시장,9672,4696,4976
2,2024-04-30,인천시청,7910,3900,4010
2,2024-04-30,석천사거리,10571,5591,4980
2,2024-04-30,모래내시장,17838,8643,9195
2,2024-04-30,만수,10971,5754,5217
2,2024-04-30,남동구청,10264,5369,4895
2,2024-04-30,인천대공원,7788,3870,3918
2,2024-04-30,운연(서창),2838,1509,1329
2,2024-05-01,검단오류(검단산업단지),2382,1226,1156
2,2024-05-01,왕길,3622,1798,1824
2,2024-05-01,검단사거리,13884,7189,6695
2,2024-05-01,마전,6734,3232,3502
2,2024-05-01,완정,11640,5956,5684
2,2024-05-01,독정,7094,3498,3596
2,2024-05-01,검암,6131,3340,2791
2,2024-05-01,검바위,4245,2021,2224
2,2024-05-01,아시아드경기장(공촌사거리),7342,3840,3502
2,2024-05-01,서구청,13106,6539,6567
2,2024-05-01,가정(루원시티),15663,7992,7671
2,2024-05-01,가정중앙시장,10563,5158,5405
2,2024-05-01,석남(거북시장),4852,2349,2503
2,2024-05-01,서부여성회관,6380,3264,3116
2,2024-05-01,인천가좌,5578,2818,2760
2,2024-05-01,가재울,5448,2769,2679
2,2024-05-01,주안국가산단,1845,893,952
2,2024-05-01,주안,14202,5905,8297
2,2024-05-01,시민공원(문화창작지대),16671,8501,8170
2,2024-05-01,석바위시장,7356,3598,3758
2,2024-05-01,인천시청,6081,2955,3126
2,2024-05-01,석천사거리,7670,3973,3697
2,2024-05-01,모래내시장,14825,7267,7558
2,2024-05-01,만수,8578,4478,4100
2,2024-05-01,남동구청,7015,3629,3386
2,2024-05-01,인천대공원,10406,5185,5221
2,2024-05-01,운연(서창),2122,1119,1003
2,2024-05-02,검단오류(검단산업단지),6000,2956,3044
2,2024-05-02,왕길,5688,2836,2852
2,2024-05-02,검단사거리,17996,9443,8553
2,2024-05-02,마전,9240,4522,4718
2,2024-05-02,완정,16810,8649,8161
2,2024-05-02,독정,9980,4978,5002
2,2024-05-02,검암,9441,5165,4276
2,2024-05-02,검바위,7682,3726,3956
2,2024-05-02,아시아드경기장(공촌사거리),10206,5340,4866
2,2024-05-02,서구청,18150,8930,9220
2,2024-05-02,가정(루원시티),24905,12705,12200
2,2024-05-02,가정중앙시장,13369,6502,6867
2,2024-05-02,석남(거북시장),6720,3279,3441
2,2024-05-02,서부여성회관,8666,4357,4309
2,2024-05-02,인천가좌,9179,4603,4576
2,2024-05-02,가재울,8978,4578,4400
2,2024-05-02,주안국가산단,5950,2896,3054
2,2024-05-02,주안,17231,7225,10006
2,2024-05-02,시민공원(문화창작지대),21843,11213,10630
2,2024-05-02,석바위시장,9271,4546,4725
2,2024-05-02,인천시청,7474,3575,3899
2,2024-05-02,석천사거리,10904,5669,5235
2,2024-05-02,모래내시장,17167,8367,8800
2,2024-05-02,만수,10914,5706,5208
2,2024-05-02,남동구청,10091,5248,4843
2,2024-05-02,인천대공원,7609,3834,3775
2,2024-05-02,운연(서창),2748,1480,1268
2,2024-05-03,검단오류(검단산업단지),6015,2962,3053
2,2024-05-03,왕길,5678,2872,2806
2,2024-05-03,검단사거리,19427,10041,9386
2,2024-05-03,마전,9726,4817,4909
2,2024-05-03,완정,18903,9819,9084
2,2024-05-03,독정,10777,5376,5401
2,2024-05-03,검암,9990,5491,4499
2,2024-05-03,검바위,7683,3843,3840
2,2024-05-03,아시아드경기장(공촌사거리),10332,5566,4766
2,2024-05-03,서구청,18506,9088,9418
2,2024-05-03,가정(루원시티),25832,13260,12572
2,2024-05-03,가정중앙시장,13980,6747,7233
2,2024-05-03,석남(거북시장),6936,3342,3594
2,2024-05-03,서부여성회관,9160,4646,4514
2,2024-05-03,인천가좌,9231,4585,4646
2,2024-05-03,가재울,8815,4508,4307
2,2024-05-03,주안국가산단,5868,2891,2977
2,2024-05-03,주안,17911,7529,10382
2,2024-05-03,시민공원(문화창작지대),22082,11340,10742
2,2024-05-03,석바위시장,9615,4639,4976
2,2024-05-03,인천시청,7611,3773,3838
2,2024-05-03,석천사거리,11043,5770,5273
2,2024-05-03,모래내시장,17845,8623,9222
2,2024-05-03,만수,11251,5873,5378
2,2024-05-03,남동구청,10139,5318,4821
2,2024-05-03,인천대공원,8020,4061,3959
2,2024-05-03,운연(서창),2814,1498,1316
2,2024-05-04,검단오류(검단산업단지),2377,1288,1089
2,2024-05-04,왕길,3286,1709,1577
2,2024-05-04,검단사거리,14255,7443,6812
2,2024-05-04,마전,6096,3097,2999
2,2024-05-04,완정,11162,5876,5286
2,2024-05-04,독정,6652,3316,3336
2,2024-05-04,검암,6375,3472,2903
2,2024-05-04,검바위,3937,1920,2017
2,2024-05-04,아시아드경기장(공촌사거리),6988,3552,3436
2,2024-05-04,서구청,11656,5835,5821
2,2024-05-04,가정(루원시티),15018,7834,7184
2,2024-05-04,가정중앙시장,10336,5074,5262
2,2024-05-04,석남(거북시장),4717,2283,2434
2,2024-05-04,서부여성회관,6496,3340,3156
2,2024-05-04,인천가좌,5270,2708,2562
2,2024-05-04,가재울,5091,2660,2431
2,2024-05-04,주안국가산단,1497,758,739
2,2024-05-04,주안,13440,5540,7900
2,2024-05-04,시민공원(문화창작지대),14295,7392,6903
2,2024-05-04,석바위시장,6611,3145,3466
2,2024-05-04,인천시청,4877,2336,2541
2,2024-05-04,석천사거리,6842,3612,3230
2,2024-05-04,모래내시장,14095,6953,7142
2,2024-05-04,만수,8189,4280,3909
2,2024-05-04,남동구청,6265,3261,3004
2,2024-05-04,인천대공원,9220,4578,4642
2,2024-05-04,운연(서창),1983,1004,979
2,2024-05-05,검단오류(검단산업단지),1367,691,676
2,2024-05-05,왕길,1702,864,838
2,2024-05-05,검단사거리,8733,4403,4330
2,2024-05-05,마전,3745,1871,1874
2,2024-05-05,완정,6379,3242,3137
2,2024-05-05,독정,3996,1940,2056
2,2024-05-05,검암,3384,1864,1520
2,2024-05-05,검바위,2469,1197,1272
2,2024-05-05,아시아드경기장(공촌사거리),4318,2232,2086
2,2024-05-05,서구청,6678,3288,3390
2,2024-05-05,가정(루원시티),8801,4422,4379
2,2024-05-05,가정중앙시장,5743,2822,2921
2,2024-05-05,석남(거북시장),2942,1382,1560
2,2024-05-05,서부여성회관,4288,2167,2121
2,2024-05-05,인천가좌,2873,1442,1431
2,2024-05-05,가재울,2866,1479,1387
2,2024-05-05,주안국가산단,654,321,333
2,2024-05-05,주안,8089,3184,4905
2,2024-05-05,시민공원(문화창작지대),9603,5002,4601
2,2024-05-05,석바위시장,4372,2102,2270
2,2024-05-05,인천시청,2798,1357,1441
2,2024-05-05,석천사거리,4136,2132,2004
2,2024-05-05,모래내시장,7417,3635,3782
2,2024-05-05,만수,4892,2536,2356
2,2024-05-05,남동구청,3452,1779,1673
2,2024-05-05,인천대공원,2035,987,1048
2,2024-05-05,운연(서창),1018,540,478
2,2024-05-06,검단오류(검단산업단지),1593,746,847
2,2024-05-06,왕길,2268,1158,1110
2,2024-05-06,검단사거리,9694,4954,4740
2,2024-05-06,마전,4131,2013,2118
2,2024-05-06,완정,7772,4023,3749
2,2024-05-06,독정,4503,2149,2354
2,2024-05-06,검암,3876,2134,1742
2,2024-05-06,검바위,2785,1322,1463
2,2024-05-06,아시아드경기장(공촌사거리),4538,2417,2121
2,2024-05-06,서구청,7616,3830,3786
2,2024-05-06,가정(루원시티),9856,5015,4841
2,2024-05-06,가정중앙시장,7117,3539,3578
2,2024-05-06,석남(거북시장),3265,1559,1706
2,2024-05-06,서부여성회관,4293,2218,2075
2,2024-05-06,인천가좌,3524,1739,1785
2,2024-05-06,가재울,3447,1679,1768
2,2024-05-06,주안국가산단,1187,547,640
2,2024-05-06,주안,9613,3874,5739
2,2024-05-06,시민공원(문화창작지대),10345,5326,5019
2,2024-05-06,석바위시장,4721,2351,2370
2,2024-05-06,인천시청,3073,1456,1617
2,2024-05-06,석천사거리,4533,2318,2215
2,2024-05-06,모래내시장,8806,4384,4422
2,2024-05-06,만수,5243,2665,2578
2,2024-05-06,남동구청,4011,2041,1970
2,2024-05-06,인천대공원,2940,1478,1462
2,2024-05-06,운연(서창),1161,604,557
2,2024-05-07,검단오류(검단산업단지),5893,2910,2983
2,2024-05-07,왕길,5445,2727,2718
2,2024-05-07,검단사거리,17173,8980,8193
2,2024-05-07,마전,8885,4372,4513
2,2024-05-07,완정,16502,8524,7978
2,2024-05-07,독정,9359,4642,4717
2,2024-05-07,검암,9180,4985,4195
2,2024-05-07,검바위,7524,3698,3826
2,2024-05-07,아시아드경기장(공촌사거리),9635,5045,4590
2,2024-05-07,서구청,17066,8513,8553
2,2024-05-07,가정(루원시티),24030,12336,11694
2,2024-05-07,가정중앙시장,12462,6091,6371
2,2024-05-07,석남(거북시장),6238,3020,3218
2,2024-05-07,서부여성회관,8050,4089,3961
2,2024-05-07,인천가좌,8996,4544,4452
2,2024-05-07,가재울,8296,4218,4078
2,2024-05-07,주안국가산단,6098,3005,3093
2,2024-05-07,주안,16060,6801,9259
2,2024-05-07,시민공원(문화창작지대),20969,10789,10180
2,2024-05-07,석바위시장,9043,4408,4635
2,2024-05-07,인천시청,6754,3291,3463
2,2024-05-07,석천사거리,10009,5221,4788
2,2024-05-07,모래내시장,15115,7425,7690
2,2024-05-07,만수,10253,5314,4939
2,2024-05-07,남동구청,9578,4979,4599
2,2024-05-07,인천대공원,3554,1774,1780
2,2024-05-07,운연(서창),2477,1311,1166
2,2024-05-08,검단오류(검단산업단지),6246,3098,3148
2,2024-05-08,왕길,5661,2857,2804
2,2024-05-08,검단사거리,18235,9547,8688
2,2024-05-08,마전,9212,4493,4719
2,2024-05-08,완정,17252,8868,8384
2,2024-05-08,독정,9709,4834,4875
2,2024-05-08,검암,9415,5165,4250
2,2024-05-08,검바위,7682,3723,3959
2,2024-05-08,아시아드경기장(공촌사거리),10502,5557,4945
2,2024-05-08,서구청,18304,9053,9251
2,2024-05-08,가정(루원시티),25134,12901,12233
2,2024-05-08,가정중앙시장,13500,6498,7002
2,2024-05-08,석남(거북시장),6848,3312,3536
2,2024-05-08,서부여성회관,9049,4601,4448
2,2024-05-08,인천가좌,9499,4824,4675
2,2024-05-08,가재울,9014,4612,4402
2,2024-05-08,주안국가산단,6141,3025,3116
2,2024-05-08,주안,17129,7284,9845
2,2024-05-08,시민공원(문화창작지대),22241,11451,10790
2,2024-05-08,석바위시장,9686,4707,4979
2,2024-05-08,인천시청,7419,3568,3851
2,2024-05-08,석천사거리,10725,5602,5123
2,2024-05-08,모래내시장,17347,8416,8931
2,2024-05-08,만수,11011,5787,5224
2,2024-05-08,남동구청,10329,5395,4934
2,2024-05-08,인천대공원,7763,3918,3845
2,2024-05-08,운연(서창),2807,1495,1312
2,2024-05-09,검단오류(검단산업단지),6067,3000,3067
2,2024-05-09,왕길,5709,2851,2858
2,2024-05-09,검단사거리,18022,9397,8625
2,2024-05-09,마전,10281,5048,5233
2,2024-05-09,완정,17026,8840,8186
2,2024-05-09,독정,9863,4904,4959
2,2024-05-09,검암,9497,5160,4337
2,2024-05-09,검바위,7734,3763,3971
2,2024-05-09,아시아드경기장(공촌사거리),10034,5313,4721
2,2024-05-09,서구청,18477,9155,9322
2,2024-05-09,가정(루원시티),25337,12878,12459
2,2024-05-09,가정중앙시장,13504,6592,6912
2,2024-05-09,석남(거북시장),6613,3218,3395
2,2024-05-09,서부여성회관,8657,4408,4249
2,2024-05-09,인천가좌,9455,4721,4734
2,2024-05-09,가재울,8807,4504,4303
2,2024-05-09,주안국가산단,6112,2975,3137
2,2024-05-09,주안,17621,7586,10035
2,2024-05-09,시민공원(문화창작지대),21746,11213,10533
2,2024-05-09,석바위시장,9568,4673,4895
2,2024-05-09,인천시청,7546,3657,3889
2,2024-05-09,석천사거리,11242,5906,5336
2,2024-05-09,모래내시장,17360,8410,8950
2,2024-05-09,만수,10974,5695,5279
2,2024-05-09,남동구청,10025,5237,4788
2,2024-05-09,인천대공원,7313,3606,3707
2,2024-05-09,운연(서창),3209,1712,1497
2,2024-05-10,검단오류(검단산업단지),6077,3001,3076
2,2024-05-10,왕길,5943,3021,2922
2,2024-05-10,검단사거리,19146,9916,9230
2,2024-05-10,마전,9716,4780,4936
2,2024-05-10,완정,17732,9232,8500
2,2024-05-10,독정,9997,4968,5029
2,2024-05-10,검암,9805,5400,4405
2,2024-05-10,검바위,7846,3818,4028
2,2024-05-10,아시아드경기장(공촌사거리),10406,5498,4908
2,2024-05-10,서구청,19024,9460,9564
2,2024-05-10,가정(루원시티),25771,13255,12516
2,2024-05-10,가정중앙시장,14277,6929,7348
2,2024-05-10,석남(거북시장),6885,3347,3538
2,2024-05-10,서부여성회관,9277,4737,4540
2,2024-05-10,인천가좌,9479,4774,4705
2,2024-05-10,가재울,9402,4818,4584
2,2024-05-10,주안국가산단,6087,2978,3109
2,2024-05-10,주안,17671,7511,10160
2,2024-05-10,시민공원(문화창작지대),22191,11426,10765
2,2024-05-10,석바위시장,9583,4640,4943
2,2024-05-10,인천시청,7769,3708,4061
2,2024-05-10,석천사거리,11742,6125,5617
2,2024-05-10,모래내시장,18178,8823,9355
2,2024-05-10,만수,11525,5961,5564
2,2024-05-10,남동구청,10320,5360,4960
2,2024-05-10,인천대공원,8522,4306,4216
2,2024-05-10,운연(서창),2948,1588,1360
2,2024-05-11,검단오류(검단산업단지),2115,1120,995
2,2024-05-11,왕길,3011,1532,1479
2,2024-05-11,검단사거리,13138,6858,6280
2,2024-05-11,마전,5979,2921,3058
2,2024-05-11,완정,10672,5567,5105
2,2024-05-11,독정,5803,2921,2882
2,2024-05-11,검암,5791,3108,2683
2,2024-05-11,검바위,3882,1874,2008
2,2024-05-11,아시아드경기장(공촌사거리),6632,3351,3281
2,2024-05-11,서구청,10591,5287,5304
2,2024-05-11,가정(루원시티),14070,7227,6843
2,2024-05-11,가정중앙시장,9296,4543,4753
2,2024-05-11,석남(거북시장),4421,2129,2292
2,2024-05-11,서부여성회관,5756,2933,2823
2,2024-05-11,인천가좌,4559,2321,2238
2,2024-05-11,가재울,4425,2308,2117
2,2024-05-11,주안국가산단,1534,735,799
2,2024-05-11,주안,12907,5254,7653
2,2024-05-11,시민공원(문화창작지대),14153,7289,6864
2,2024-05-11,석바위시장,6415,3107,3308
2,2024-05-11,인천시청,4709,2245,2464
2,2024-05-11,석천사거리,6436,3292,3144
2,2024-05-11,모래내시장,12169,5976,6193
2,2024-05-11,만수,7335,3799,3536
2,2024-05-11,남동구청,5644,2949,2695
2,2024-05-11,인천대공원,5427,2682,2745
2,2024-05-11,운연(서창),1809,962,847
2,2024-05-12,검단오류(검단산업단지),1713,859,854
2,2024-05-12,왕길,2285,1159,1126
2,2024-05-12,검단사거리,11066,5564,5502
2,2024-05-12,마전,4597,2210,2387
2,2024-05-12,완정,8267,4240,4027
2,2024-05-12,독정,4640,2262,2378
2,2024-05-12,검암,5041,2693,2348
2,2024-05-12,검바위,3301,1544,1757
2,2024-05-12,아시아드경기장(공촌사거리),5695,2981,2714
2,2024-05-12,서구청,8784,4429,4355
2,2024-05-12,가정(루원시티),11731,6007,5724
2,2024-05-12,가정중앙시장,8426,4054,4372
2,2024-05-12,석남(거북시장),3774,1746,2028
2,2024-05-12,서부여성회관,5572,2838,2734
2,2024-05-12,인천가좌,3938,2014,1924
2,2024-05-12,가재울,4046,2065,1981
2,2024-05-12,주안국가산단,783,381,402
2,2024-05-12,주안,10828,4351,6477
2,2024-05-12,시민공원(문화창작지대),11982,6110,5872
2,2024-05-12,석바위시장,5783,2810,2973
2,2024-05-12,인천시청,4228,1989,2239
2,2024-05-12,석천사거리,5577,2967,2610
2,2024-05-12,모래내시장,12455,6111,6344
2,2024-05-12,만수,6437,3360,3077
2,2024-05-12,남동구청,4983,2596,2387
2,2024-05-12,인천대공원,9328,4678,4650
2,2024-05-12,운연(서창),1701,908,793
2,2024-05-13,검단오류(검단산업단지),6021,2928,3093
2,2024-05-13,왕길,5547,2798,2749
2,2024-05-13,검단사거리,17661,9311,8350
2,2024-05-13,마전,9138,4420,4718
2,2024-05-13,완정,16810,8784,8026
2,2024-05-13,독정,9710,4807,4903
2,2024-05-13,검암,9377,5160,4217
2,2024-05-13,검바위,7550,3683,3867
2,2024-05-13,아시아드경기장(공촌사거리),9914,5240,4674
2,2024-05-13,서구청,18283,9141,9142
2,2024-05-13,가정(루원시티),24575,12534,12041
2,2024-05-13,가정중앙시장,12873,6231,6642
2,2024-05-13,석남(거북시장),6523,3200,3323
2,2024-05-13,서부여성회관,8473,4364,4109
2,2024-05-13,인천가좌,9377,4732,4645
2,2024-05-13,가재울,8713,4454,4259
2,2024-05-13,주안국가산단,6026,2921,3105
2,2024-05-13,주안,16549,7062,9487
2,2024-05-13,시민공원(문화창작지대),21782,11290,10492
2,2024-05-13,석바위시장,9560,4635,4925
2,2024-05-13,인천시청,7006,3435,3571
2,2024-05-13,석천사거리,10369,5422,4947
2,2024-05-13,모래내시장,17252,8397,8855
2,2024-05-13,만수,10582,5553,5029
2,2024-05-13,남동구청,9992,5160,4832
2,2024-05-13,인천대공원,6641,3354,3287
2,2024-05-13,운연(서창),2751,1493,1258
2,2024-05-14,검단오류(검단산업단지),6086,2995,3091
2,2024-05-14,왕길,5882,2986,2896
2,2024-05-14,검단사거리,20445,10718,9727
2,2024-05-14,마전,9504,4700,4804
2,2024-05-14,완정,18554,9690,8864
2,2024-05-14,독정,10048,5040,5008
2,2024-05-14,검암,9950,5519,4431
2,2024-05-14,검바위,7717,3755,3962
2,2024-05-14,아시아드경기장(공촌사거리),10691,5641,5050
2,2024-05-14,서구청,19486,9626,9860
2,2024-05-14,가정(루원시티),25942,13367,12575
2,2024-05-14,가정중앙시장,14044,6862,7182
2,2024-05-14,석남(거북시장),6806,3291,3515
2,2024-05-14,서부여성회관,9002,4637,4365
2,2024-05-14,인천가좌,9520,4781,4739
2,2024-05-14,가재울,9031,4648,4383
2,2024-05-14,주안국가산단,6165,3015,3150
2,2024-05-14,주안,18056,7716,10340
2,2024-05-14,시민공원(문화창작지대),22503,11570,10933
2,2024-05-14,석바위시장,9614,4663,4951
2,2024-05-14,인천시청,7608,3680,3928
2,2024-05-14,석천사거리,10700,5628,5072
2,2024-05-14,모래내시장,18118,8850,9268
2,2024-05-14,만수,11342,5937,5405
2,2024-05-14,남동구청,10793,5650,5143
2,2024-05-14,인천대공원,8253,4093,4160
2,2024-05-14,운연(서창),2901,1590,1311
2,2024-05-15,검단오류(검단산업단지),1933,975,958
2,2024-05-15,왕길,2413,1190,1223
2,2024-05-15,검단사거리,10321,5283,5038
2,2024-05-15,마전,4659,2253,2406
2,2024-05-15,완정,8120,4222,3898
2,2024-05-15,독정,5203,2607,2596
2,2024-05-15,검암,4747,2479,2268
2,2024-05-15,검바위,3162,1502,1660
2,2024-05-15,아시아드경기장(공촌사거리),5336,2847,2489
2,2024-05-15,서구청,9009,4502,4507
2,2024-05-15,가정(루원시티),11101,5706,5395
2,2024-05-15,가정중앙시장,7705,3750,3955
2,2024-05-15,석남(거북시장),3770,1818,1952
2,2024-05-15,서부여성회관,4714,2389,2325
2,2024-05-15,인천가좌,3882,1935,1947
2,2024-05-15,가재울,3871,1906,1965
2,2024-05-15,주안국가산단,1677,801,876
2,2024-05-15,주안,11490,4674,6816
2,2024-05-15,시민공원(문화창작지대),12003,6156,5847
2,2024-05-15,석바위시장,5873,2875,2998
2,2024-05-15,인천시청,3577,1683,1894
2,2024-05-15,석천사거리,5617,2879,2738
2,2024-05-15,모래내시장,10311,5089,5222
2,2024-05-15,만수,6283,3244,3039
2,2024-05-15,남동구청,4572,2363,2209
2,2024-05-15,인천대공원,5120,2556,2564
2,2024-05-15,운연(서창),1548,778,770
2,2024-05-16,검단오류(검단산업단지),6217,3053,3164
2,2024-05-16,왕길,5680,2845,2835
2,2024-05-16,검단사거리,17847,9366,8481
2,2024-05-16,마전,9165,4435,4730
2,2024-05-16,완정,17080,8828,8252
2,2024-05-16,독정,9872,4925,4947
2,2024-05-16,검암,9498,5204,4294
2,2024-05-16,검바위,7824,3839,3985
2,2024-05-16,아시아드경기장(공촌사거리),9865,5223,4642
2,2024-05-16,서구청,18513,9188,9325
2,2024-05-16,가정(루원시티),24988,12726,12262
2,2024-05-16,가정중앙시장,13593,6650,6943
2,2024-05-16,석남(거북시장),6679,3228,3451
2,2024-05-16,서부여성회관,8860,4501,4359
2,2024-05-16,인천가좌,9237,4650,4587
2,2024-05-16,가재울,8718,4431,4287
2,2024-05-16,주안국가산단,6058,2932,3126
2,2024-05-16,주안,16680,7161,9519
2,2024-05-16,시민공원(문화창작지대),22031,11362,10669
2,2024-05-16,석바위시장,9332,4527,4805
2,2024-05-16,인천시청,7509,3626,3883
2,2024-05-16,석천사거리,10508,5514,4994
2,2024-05-16,모래내시장,17392,8517,8875
2,2024-05-16,만수,11118,5724,5394
2,2024-05-16,남동구청,10176,5303,4873
2,2024-05-16,인천대공원,6749,3353,3396
2,2024-05-16,운연(서창),2911,1528,1383
2,2024-05-17,검단오류(검단산업단지),6131,3010,3121
2,2024-05-17,왕길,5678,2874,2804
2,2024-05-17,검단사거리,19367,10082,9285
2,2024-05-17,마전,9369,4567,4802
2,2024-05-17,완정,17345,9030,8315
2,2024-05-17,독정,10224,5105,5119
2,2024-05-17,검암,9865,5446,4419
2,2024-05-17,검바위,7948,3913,4035
2,2024-05-17,아시아드경기장(공촌사거리),10325,5477,4848
2,2024-05-17,서구청,18754,9231,9523
2,2024-05-17,가정(루원시티),26259,13456,12803
2,2024-05-17,가정중앙시장,14207,6911,7296
2,2024-05-17,석남(거북시장),6919,3380,3539
2,2024-05-17,서부여성회관,9090,4623,4467
2,2024-05-17,인천가좌,9507,4753,4754
2,2024-05-17,가재울,9421,4860,4561
2,2024-05-17,주안국가산단,5930,2915,3015
2,2024-05-17,주안,17447,7396,10051
2,2024-05-17,시민공원(문화창작지대),22128,11404,10724
2,2024-05-17,석바위시장,9654,4664,4990
2,2024-05-17,인천시청,7453,3615,3838
2,2024-05-17,석천사거리,10583,5521,5062
2,2024-05-17,모래내시장,17942,8712,9230
2,2024-05-17,만수,11260,5842,5418
2,2024-05-17,남동구청,10335,5449,4886
2,2024-05-17,인천대공원,8249,4161,4088
2,2024-05-17,운연(서창),2923,1607,1316
2,2024-05-18,검단오류(검단산업단지),2315,1260,1055
2,2024-05-18,왕길,3307,1720,1587
2,2024-05-18,검단사거리,14254,7328,6926
2,2024-05-18,마전,6249,3076,3173
2,2024-05-18,완정,11496,6030,5466
2,2024-05-18,독정,6634,3348,3286
2,2024-05-18,검암,6945,3824,3121
2,2024-05-18,검바위,4287,2072,2215
2,2024-05-18,아시아드경기장(공촌사거리),7426,3777,3649
2,2024-05-18,서구청,12300,6154,6146
2,2024-05-18,가정(루원시티),16172,8363,7809
2,2024-05-18,가정중앙시장,11077,5498,5579
2,2024-05-18,석남(거북시장),5047,2358,2689
2,2024-05-18,서부여성회관,6827,3550,3277
2,2024-05-18,인천가좌,5397,2737,2660
2,2024-05-18,가재울,5153,2675,2478
2,2024-05-18,주안국가산단,1557,775,782
2,2024-05-18,주안,14529,5985,8544
2,2024-05-18,시민공원(문화창작지대),15667,8074,7593
2,2024-05-18,석바위시장,7078,3415,3663
2,2024-05-18,인천시청,5420,2581,2839
2,2024-05-18,석천사거리,7527,3999,3528
2,2024-05-18,모래내시장,14767,7291,7476
2,2024-05-18,만수,8343,4369,3974
2,2024-05-18,남동구청,6487,3384,3103
2,2024-05-18,인천대공원,11327,5643,5684
2,2024-05-18,운연(서창),2077,1080,997
2,2024-05-19,검단오류(검단산업단지),1583,778,805
2,2024-05-19,왕길,2284,1166,1118
2,2024-05-19,검단사거리,11005,5572,5433
2,2024-05-19,마전,4738,2303,2435
2,2024-05-19,완정,8540,4340,4200
2,2024-05-19,독정,5103,2465,2638
2,2024-05-19,검암,5231,2842,2389
2,2024-05-19,검바위,3301,1556,1745
2,2024-05-19,아시아드경기장(공촌사거리),5450,2854,2596
2,2024-05-19,서구청,8163,4069,4094
2,2024-05-19,가정(루원시티),11234,5746,5488
2,2024-05-19,가정중앙시장,8160,4013,4147
2,2024-05-19,석남(거북시장),3619,1713,1906
2,2024-05-19,서부여성회관,5392,2762,2630
2,2024-05-19,인천가좌,3831,1943,1888
2,2024-05-19,가재울,3792,1902,1890
2,2024-05-19,주안국가산단,830,389,441
2,2024-05-19,주안,10173,4136,6037
2,2024-05-19,시민공원(문화창작지대),12360,6397,5963
2,2024-05-19,석바위시장,5601,2727,2874
2,2024-05-19,인천시청,4331,2012,2319
2,2024-05-19,석천사거리,5521,2886,2635
2,2024-05-19,모래내시장,11409,5608,5801
2,2024-05-19,만수,6403,3307,3096
2,2024-05-19,남동구청,4916,2543,2373
2,2024-05-19,인천대공원,9939,4950,4989
2,2024-05-19,운연(서창),1646,864,782
2,2024-05-20,검단오류(검단산업단지),6008,2958,3050
2,2024-05-20,왕길,5303,2676,2627
2,2024-05-20,검단사거리,17289,9128,8161
2,2024-05-20,마전,8788,4258,4530
2,2024-05-20,완정,16384,8525,7859
2,2024-05-20,독정,9951,4922,5029
2,2024-05-20,검암,9204,5047,4157
2,2024-05-20,검바위,7512,3698,3814
2,2024-05-20,아시아드경기장(공촌사거리),9821,5168,4653
2,2024-05-20,서구청,18026,8984,9042
2,2024-05-20,가정(루원시티),24448,12480,11968
2,2024-05-20,가정중앙시장,13018,6387,6631
2,2024-05-20,석남(거북시장),6492,3143,3349
2,2024-05-20,서부여성회관,8400,4325,4075
2,2024-05-20,인천가좌,9081,4584,4497
2,2024-05-20,가재울,8610,4391,4219
2,2024-05-20,주안국가산단,6029,2977,3052
2,2024-05-20,주안,16561,7137,9424
2,2024-05-20,시민공원(문화창작지대),21407,11054,10353
2,2024-05-20,석바위시장,9085,4399,4686
2,2024-05-20,인천시청,7048,3407,3641
2,2024-05-20,석천사거리,10230,5356,4874
2,2024-05-20,모래내시장,16911,8250,8661
2,2024-05-20,만수,10632,5522,5110
2,2024-05-20,남동구청,10000,5198,4802
2,2024-05-20,인천대공원,6387,3196,3191
2,2024-05-20,운연(서창),2679,1416,1263
2,2024-05-21,검단오류(검단산업단지),6162,3031,3131
2,2024-05-21,왕길,5448,2744,2704
2,2024-05-21,검단사거리,17276,9040,8236
2,2024-05-21,마전,9167,4451,4716
2,2024-05-21,완정,16579,8585,7994
2,2024-05-21,독정,10104,4924,5180
2,2024-05-21,검암,9443,5109,4334
2,2024-05-21,검바위,7476,3625,3851
2,2024-05-21,아시아드경기장(공촌사거리),9961,5321,4640
2,2024-05-21,서구청,17905,8902,9003
2,2024-05-21,가정(루원시티),24955,12785,12170
2,2024-05-21,가정중앙시장,13320,6473,6847
2,2024-05-21,석남(거북시장),6765,3323,3442
2,2024-05-21,서부여성회관,8380,4238,4142
2,2024-05-21,인천가좌,9075,4569,4506
2,2024-05-21,가재울,8534,4368,4166
2,2024-05-21,주안국가산단,6157,3017,3140
2,2024-05-21,주안,16924,7209,9715
2,2024-05-21,시민공원(문화창작지대),21607,11099,10508
2,2024-05-21,석바위시장,9243,4447,4796
2,2024-05-21,인천시청,7404,3575,3829
2,2024-05-21,석천사거리,10413,5458,4955
2,2024-05-21,모래내시장,16848,8196,8652
2,2024-05-21,만수,10757,5594,5163
2,2024-05-21,남동구청,9949,5194,4755
2,2024-05-21,인천대공원,7409,3694,3715
2,2024-05-21,운연(서창),2668,1421,1247
2,2024-05-22,검단오류(검단산업단지),6110,3025,3085
2,2024-05-22,왕길,5629,2846,2783
2,2024-05-22,검단사거리,17463,9121,8342
2,2024-05-22,마전,9102,4507,4595
2,2024-05-22,완정,16887,8683,8204
2,2024-05-22,독정,10073,5031,5042
2,2024-05-22,검암,9491,5174,4317
2,2024-05-22,검바위,7975,3877,4098
2,2024-05-22,아시아드경기장(공촌사거리),10424,5496,4928
2,2024-05-22,서구청,18319,8973,9346
2,2024-05-22,가정(루원시티),25320,12984,12336
2,2024-05-22,가정중앙시장,13280,6496,6784
2,2024-05-22,석남(거북시장),6715,3274,3441
2,2024-05-22,서부여성회관,8825,4496,4329
2,2024-05-22,인천가좌,9203,4651,4552
2,2024-05-22,가재울,8683,4400,4283
2,2024-05-22,주안국가산단,6212,3016,3196
2,2024-05-22,주안,17192,7389,9803
2,2024-05-22,시민공원(문화창작지대),21764,11081,10683
2,2024-05-22,석바위시장,9478,4578,4900
2,2024-05-22,인천시청,7574,3659,3915
2,2024-05-22,석천사거리,10448,5460,4988
2,2024-05-22,모래내시장,17062,8332,8730
2,2024-05-22,만수,11075,5765,5310
2,2024-05-22,남동구청,10216,5335,4881
2,2024-05-22,인천대공원,6875,3398,3477
2,2024-05-22,운연(서창),2714,1480,1234
2,2024-05-23,검단오류(검단산업단지),6118,3012,3106
2,2024-05-23,왕길,5639,2825,2814
2,2024-05-23,검단사거리,17624,9257,8367
2,2024-05-23,마전,9441,4577,4864
2,2024-05-23,완정,16729,8616,8113
2,2024-05-23,독정,9983,5037,4946
2,2024-05-23,검암,9408,5175,4233
2,2024-05-23,검바위,7695,3731,3964
2,2024-05-23,아시아드경기장(공촌사거리),9900,5234,4666
2,2024-05-23,서구청,18709,9231,9478
2,2024-05-23,가정(루원시티),25163,12819,12344
2,2024-05-23,가정중앙시장,13369,6513,6856
2,2024-05-23,석남(거북시장),6789,3246,3543
2,2024-05-23,서부여성회관,8729,4425,4304
2,2024-05-23,인천가좌,9261,4624,4637
2,2024-05-23,가재울,8463,4298,4165
2,2024-05-23,주안국가산단,6095,2965,3130
2,2024-05-23,주안,16864,7218,9646
2,2024-05-23,시민공원(문화창작지대),21884,11217,10667
2,2024-05-23,석바위시장,9159,4431,4728
2,2024-05-23,인천시청,7312,3532,3780
2,2024-05-23,석천사거리,10511,5526,4985
2,2024-05-23,모래내시장,17382,8492,8890
2,2024-05-23,만수,10887,5594,5293
2,2024-05-23,남동구청,10077,5277,4800
2,2024-05-23,인천대공원,6999,3507,3492
2,2024-05-23,운연(서창),2769,1495,1274
2,2024-05-24,검단오류(검단산업단지),5968,2902,3066
2,2024-05-24,왕길,5702,2860,2842
2,2024-05-24,검단사거리,18896,9906,8990
2,2024-05-24,마전,9272,4477,4795
2,2024-05-24,완정,17581,9168,8413
2,2024-05-24,독정,9670,4839,4831
2,2024-05-24,검암,9660,5389,4271
2,2024-05-24,검바위,7909,3891,4018
2,2024-05-24,아시아드경기장(공촌사거리),10104,5398,4706
2,2024-05-24,서구청,19304,9452,9852
2,2024-05-24,가정(루원시티),25481,13001,12480
2,2024-05-24,가정중앙시장,13914,6748,7166
2,2024-05-24,석남(거북시장),6911,3352,3559
2,2024-05-24,서부여성회관,9060,4613,4447
2,2024-05-24,인천가좌,9442,4811,4631
2,2024-05-24,가재울,8901,4593,4308
2,2024-05-24,주안국가산단,5963,2889,3074
2,2024-05-24,주안,17398,7447,9951
2,2024-05-24,시민공원(문화창작지대),21568,11087,10481
2,2024-05-24,석바위시장,9321,4470,4851
2,2024-05-24,인천시청,7109,3430,3679
2,2024-05-24,석천사거리,10496,5501,4995
2,2024-05-24,모래내시장,17853,8681,9172
2,2024-05-24,만수,10999,5751,5248
2,2024-05-24,남동구청,10278,5336,4942
2,2024-05-24,인천대공원,6822,3443,3379
2,2024-05-24,운연(서창),3329,1824,1505
2,2024-05-25,검단오류(검단산업단지),2398,1284,1114
2,2024-05-25,왕길,3447,1770,1677
2,2024-05-25,검단사거리,14391,7500,6891
2,2024-05-25,마전,6326,3163,3163
2,2024-05-25,완정,11519,6095,5424
2,2024-05-25,독정,6471,3257,3214
2,2024-05-25,검암,6685,3636,3049
2,2024-05-25,검바위,4323,2151,2172
2,2024-05-25,아시아드경기장(공촌사거리),7317,3737,3580
2,2024-05-25,서구청,12171,6012,6159
2,2024-05-25,가정(루원시티),16409,8451,7958
2,2024-05-25,가정중앙시장,10807,5359,5448
2,2024-05-25,석남(거북시장),5238,2518,2720
2,2024-05-25,서부여성회관,6747,3530,3217
2,2024-05-25,인천가좌,5414,2816,2598
2,2024-05-25,가재울,5116,2638,2478
2,2024-05-25,주안국가산단,1727,858,869
2,2024-05-25,주안,14319,5867,8452
2,2024-05-25,시민공원(문화창작지대),15196,7851,7345
2,2024-05-25,석바위시장,6794,3301,3493
2,2024-05-25,인천시청,5230,2477,2753
2,2024-05-25,석천사거리,7460,3968,3492
2,2024-05-25,모래내시장,14816,7306,7510
2,2024-05-25,만수,8354,4288,4066
2,2024-05-25,남동구청,6546,3424,3122
2,2024-05-25,인천대공원,9511,4699,4812
2,2024-05-25,운연(서창),2113,1086,1027
2,2024-05-26,검단오류(검단산업단지),1468,715,753
2,2024-05-26,왕길,1952,1000,952
2,2024-05-26,검단사거리,9667,4896,4771
2,2024-05-26,마전,4146,1992,2154
2,2024-05-26,완정,7234,3678,3556
2,2024-05-26,독정,3816,1882,1934
2,2024-05-26,검암,4356,2336,2020
2,2024-05-26,검바위,2899,1368,1531
2,2024-05-26,아시아드경기장(공촌사거리),5192,2628,2564
2,2024-05-26,서구청,7908,3989,3919
2,2024-05-26,가정(루원시티),10416,5337,5079
2,2024-05-26,가정중앙시장,7187,3566,3621
2,2024-05-26,석남(거북시장),3331,1589,1742
2,2024-05-26,서부여성회관,4905,2524,2381
2,2024-05-26,인천가좌,3200,1570,1630
2,2024-05-26,가재울,3555,1823,1732
2,2024-05-26,주안국가산단,754,355,399
2,2024-05-26,주안,9420,3828,5592
2,2024-05-26,시민공원(문화창작지대),11022,5706,5316
2,2024-05-26,석바위시장,5084,2443,2641
2,2024-05-26,인천시청,3338,1577,1761
2,2024-05-26,석천사거리,4826,2496,2330
2,2024-05-26,모래내시장,10039,4923,5116
2,2024-05-26,만수,5687,2962,2725
2,2024-05-26,남동구청,4220,2190,2030
2,2024-05-26,인천대공원,6108,3000,3108
2,2024-05-26,운연(서창),1343,711,632
2,2024-05-27,검단오류(검단산업단지),5928,2871,3057
2,2024-05-27,왕길,5545,2796,2749
2,2024-05-27,검단사거리,17491,9256,8235
2,2024-05-27,마전,8865,4273,4592
2,2024-05-27,완정,16758,8666,8092
2,2024-05-27,독정,9882,4946,4936
2,2024-05-27,검암,9167,5039,4128
2,2024-05-27,검바위,7558,3696,3862
2,2024-05-27,아시아드경기장(공촌사거리),9794,5204,4590
2,2024-05-27,서구청,18144,9039,9105
2,2024-05-27,가정(루원시티),24243,12402,11841
2,2024-05-27,가정중앙시장,13112,6396,6716
2,2024-05-27,석남(거북시장),6665,3225,3440
2,2024-05-27,서부여성회관,8479,4353,4126
2,2024-05-27,인천가좌,9143,4620,4523
2,2024-05-27,가재울,8578,4407,4171
2,2024-05-27,주안국가산단,6138,3018,3120
2,2024-05-27,주안,16328,7013,9315
2,2024-05-27,시민공원(문화창작지대),21717,11161,10556
2,2024-05-27,석바위시장,9317,4533,4784
2,2024-05-27,인천시청,6980,3348,3632
2,2024-05-27,석천사거리,10159,5362,4797
2,2024-05-27,모래내시장,17107,8339,8768
2,2024-05-27,만수,10781,5519,5262
2,2024-05-27,남동구청,9870,5112,4758
2,2024-05-27,인천대공원,6914,3482,3432
2,2024-05-27,운연(서창),2780,1470,1310
2,2024-05-28,검단오류(검단산업단지),6041,2957,3084
2,2024-05-28,왕길,5756,2886,2870
2,2024-05-28,검단사거리,17541,9186,8355
2,2024-05-28,마전,9887,4892,4995
2,2024-05-28,완정,16961,8703,8258
2,2024-05-28,독정,9969,4934,5035
2,2024-05-28,검암,9510,5169,4341
2,2024-05-28,검바위,7656,3711,3945
2,2024-05-28,아시아드경기장(공촌사거리),9951,5242,4709
2,2024-05-28,서구청,18371,9112,9259
2,2024-05-28,가정(루원시티),24713,12604,12109
2,2024-05-28,가정중앙시장,13421,6587,6834
2,2024-05-28,석남(거북시장),6878,3339,3539
2,2024-05-28,서부여성회관,8450,4341,4109
2,2024-05-28,인천가좌,9197,4630,4567
2,2024-05-28,가재울,8739,4519,4220
2,2024-05-28,주안국가산단,6231,3061,3170
2,2024-05-28,주안,16959,7290,9669
2,2024-05-28,시민공원(문화창작지대),22439,11614,10825
2,2024-05-28,석바위시장,9357,4476,4881
2,2024-05-28,인천시청,7567,3674,3893
2,2024-05-28,석천사거리,10735,5679,5056
2,2024-05-28,모래내시장,17561,8526,9035
2,2024-05-28,만수,11124,5791,5333
2,2024-05-28,남동구청,10013,5188,4825
2,2024-05-28,인천대공원,7578,3778,3800
2,2024-05-28,운연(서창),2804,1494,1310
2,2024-05-29,검단오류(검단산업단지),6134,3033,3101
2,2024-05-29,왕길,5582,2788,2794
2,2024-05-29,검단사거리,17570,9231,8339
2,2024-05-29,마전,9157,4443,4714
2,2024-05-29,완정,16771,8675,8096
2,2024-05-29,독정,10032,5022,5010
2,2024-05-29,검암,9609,5238,4371
2,2024-05-29,검바위,7874,3834,4040
2,2024-05-29,아시아드경기장(공촌사거리),10249,5416,4833
2,2024-05-29,서구청,18047,8943,9104
2,2024-05-29,가정(루원시티),25234,12931,12303
2,2024-05-29,가정중앙시장,13381,6476,6905
2,2024-05-29,석남(거북시장),6666,3228,3438
2,2024-05-29,서부여성회관,8702,4431,4271
2,2024-05-29,인천가좌,9206,4645,4561
2,2024-05-29,가재울,8934,4604,4330
2,2024-05-29,주안국가산단,6106,2976,3130
2,2024-05-29,주안,17033,7349,9684
2,2024-05-29,시민공원(문화창작지대),22541,11610,10931
2,2024-05-29,석바위시장,9422,4562,4860
2,2024-05-29,인천시청,7306,3504,3802
2,2024-05-29,석천사거리,10583,5548,5035
2,2024-05-29,모래내시장,17315,8452,8863
2,2024-05-29,만수,11007,5719,5288
2,2024-05-29,남동구청,9923,5138,4785
2,2024-05-29,인천대공원,7037,3535,3502
2,2024-05-29,운연(서창),2862,1529,1333
2,2024-05-30,검단오류(검단산업단지),5920,2883,3037
2,2024-05-30,왕길,5442,2735,2707
2,2024-05-30,검단사거리,17149,8955,8194
2,2024-05-30,마전,9174,4437,4737
2,2024-05-30,완정,16500,8551,7949
2,2024-05-30,독정,9991,4974,5017
2,2024-05-30,검암,9455,5197,4258
2,2024-05-30,검바위,7612,3689,3923
2,2024-05-30,아시아드경기장(공촌사거리),9989,5269,4720
2,2024-05-30,서구청,17562,8707,8855
2,2024-05-30,가정(루원시티),24864,12785,12079
2,2024-05-30,가정중앙시장,13065,6356,6709
2,2024-05-30,석남(거북시장),6507,3148,3359
2,2024-05-30,서부여성회관,8694,4446,4248
2,2024-05-30,인천가좌,9177,4613,4564
2,2024-05-30,가재울,8737,4460,4277
2,2024-05-30,주안국가산단,6139,3022,3117
2,2024-05-30,주안,16886,7327,9559
2,2024-05-30,시민공원(문화창작지대),21867,11194,10673
2,2024-05-30,석바위시장,9189,4430,4759
2,2024-05-30,인천시청,7260,3473,3787
2,2024-05-30,석천사거리,10457,5484,4973
2,2024-05-30,모래내시장,17090,8405,8685
2,2024-05-30,만수,10813,5590,5223
2,2024-05-30,남동구청,9908,5113,4795
2,2024-05-30,인천대공원,7507,3816,3691
2,2024-05-30,운연(서창),2764,1487,1277
2,2024-05-31,검단오류(검단산업단지),5816,2834,2982
2,2024-05-31,왕길,5654,2801,2853
2,2024-05-31,검단사거리,18232,9562,8670
2,2024-05-31,마전,9006,4440,4566
2,2024-05-31,완정,16906,8789,8117
2,2024-05-31,독정,9671,4773,4898
2,2024-05-31,검암,9677,5449,4228
2,2024-05-31,검바위,7693,3747,3946
2,2024-05-31,아시아드경기장(공촌사거리),10006,5267,4739
2,2024-05-31,서구청,18229,8951,9278
2,2024-05-31,가정(루원시티),25414,12984,12430
2,2024-05-31,가정중앙시장,13714,6677,7037
2,2024-05-31,석남(거북시장),6810,3287,3523
2,2024-05-31,서부여성회관,9038,4594,4444
2,2024-05-31,인천가좌,9093,4555,4538
2,2024-05-31,가재울,8854,4578,4276
2,2024-05-31,주안국가산단,6057,2909,3148
2,2024-05-31,주안,17490,7406,10084
2,2024-05-31,시민공원(문화창작지대),22061,11387,10674
2,2024-05-31,석바위시장,9277,4501,4776
2,2024-05-31,인천시청,7179,3415,3764
2,2024-05-31,석천사거리,10606,5534,5072
2,2024-05-31,모래내시장,17774,8672,9102
2,2024-05-31,만수,11133,5841,5292
2,2024-05-31,남동구청,10257,5321,4936
2,2024-05-31,인천대공원,7460,3758,3702
2,2024-05-31,운연(서창),2771,1502,1269
2,2024-06-01,검단오류(검단산업단지),2270,1214,1056
2,2024-06-01,왕길,3291,1700,1591
2,2024-06-01,검단사거리,13760,7151,6609
2,2024-06-01,마전,6109,3064,3045
2,2024-06-01,완정,11491,6047,5444
2,2024-06-01,독정,6440,3213,3227
2,2024-06-01,검암,6431,3560,2871
2,2024-06-01,검바위,4188,2085,2103
2,2024-06-01,아시아드경기장(공촌사거리),7049,3653,3396
2,2024-06-01,서구청,11930,5875,6055
2,2024-06-01,가정(루원시티),15537,8021,7516
2,2024-06-01,가정중앙시장,10565,5163,5402
2,2024-06-01,석남(거북시장),4919,2358,2561
2,2024-06-01,서부여성회관,6329,3229,3100
2,2024-06-01,인천가좌,5125,2629,2496
2,2024-06-01,가재울,4959,2582,2377
2,2024-06-01,주안국가산단,1570,784,786
2,2024-06-01,주안,13748,5693,8055
2,2024-06-01,시민공원(문화창작지대),15140,7720,7420
2,2024-06-01,석바위시장,6744,3270,3474
2,2024-06-01,인천시청,5034,2402,2632
2,2024-06-01,석천사거리,6882,3686,3196
2,2024-06-01,모래내시장,14479,7139,7340
2,2024-06-01,만수,8113,4196,3917
2,2024-06-01,남동구청,6217,3191,3026
2,2024-06-01,인천대공원,9506,4728,4778
2,2024-06-01,운연(서창),2009,1044,965
2,2024-06-02,검단오류(검단산업단지),1605,758,847
2,2024-06-02,왕길,2249,1160,1089
2,2024-06-02,검단사거리,10555,5260,5295
2,2024-06-02,마전,4312,2106,2206
2,2024-06-02,완정,7651,3897,3754
2,2024-06-02,독정,4741,2340,2401
2,2024-06-02,검암,4832,2613,2219
2,2024-06-02,검바위,3201,1538,1663
2,2024-06-02,아시아드경기장(공촌사거리),5745,2983,2762
2,2024-06-02,서구청,8042,3980,4062
2,2024-06-02,가정(루원시티),10629,5413,5216
2,2024-06-02,가정중앙시장,7761,3784,3977
2,2024-06-02,석남(거북시장),3603,1736,1867
2,2024-06-02,서부여성회관,5452,2777,2675
2,2024-06-02,인천가좌,3639,1808,1831
2,2024-06-02,가재울,3858,1915,1943
2,2024-06-02,주안국가산단,844,399,445
2,2024-06-02,주안,9900,4053,5847
2,2024-06-02,시민공원(문화창작지대),11905,6080,5825
2,2024-06-02,석바위시장,5328,2599,2729
2,2024-06-02,인천시청,4114,1931,2183
2,2024-06-02,석천사거리,5208,2782,2426
2,2024-06-02,모래내시장,11122,5435,5687
2,2024-06-02,만수,6144,3150,2994
2,2024-06-02,남동구청,4677,2445,2232
2,2024-06-02,인천대공원,9240,4602,4638
2,2024-06-02,운연(서창),1591,853,738
2,2024-06-03,검단오류(검단산업단지),5883,2883,3000
2,2024-06-03,왕길,5580,2846,2734
2,2024-06-03,검단사거리,17148,8946,8202
2,2024-06-03,마전,8886,4300,4586
2,2024-06-03,완정,16465,8490,7975
2,2024-06-03,독정,9901,4981,4920
2,2024-06-03,검암,9427,5130,4297
2,2024-06-03,검바위,7504,3609,3895
2,2024-06-03,아시아드경기장(공촌사거리),10049,5298,4751
2,2024-06-03,서구청,17648,8827,8821
2,2024-06-03,가정(루원시티),24130,12336,11794
2,2024-06-03,가정중앙시장,12995,6366,6629
2,2024-06-03,석남(거북시장),6415,3166,3249
2,2024-06-03,서부여성회관,8360,4303,4057
2,2024-06-03,인천가좌,9091,4560,4531
2,2024-06-03,가재울,8579,4398,4181
2,2024-06-03,주안국가산단,6071,2973,3098
2,2024-06-03,주안,16225,7016,9209
2,2024-06-03,시민공원(문화창작지대),21783,11291,10492
2,2024-06-03,석바위시장,9097,4367,4730
2,2024-06-03,인천시청,6978,3367,3611
2,2024-06-03,석천사거리,10216,5328,4888
2,2024-06-03,모래내시장,16697,8103,8594
2,2024-06-03,만수,10528,5437,5091
2,2024-06-03,남동구청,9882,5126,4756
2,2024-06-03,인천대공원,6306,3164,3142
2,2024-06-03,운연(서창),2758,1443,1315
2,2024-06-04,검단오류(검단산업단지),5952,2928,3024
2,2024-06-04,왕길,5742,2887,2855
2,2024-06-04,검단사거리,17168,9001,8167
2,2024-06-04,마전,9125,4387,4738
2,2024-06-04,완정,16583,8600,7983
2,2024-06-04,독정,9714,4845,4869
2,2024-06-04,검암,9606,5244,4362
2,2024-06-04,검바위,7710,3754,3956
2,2024-06-04,아시아드경기장(공촌사거리),10196,5399,4797
2,2024-06-04,서구청,17905,8844,9061
2,2024-06-04,가정(루원시티),24851,12640,12211
2,2024-06-04,가정중앙시장,13388,6562,6826
2,2024-06-04,석남(거북시장),6585,3211,3374
2,2024-06-04,서부여성회관,8615,4372,4243
2,2024-06-04,인천가좌,9280,4700,4580
2,2024-06-04,가재울,8786,4505,4281
2,2024-06-04,주안국가산단,6157,3019,3138
2,2024-06-04,주안,16604,7129,9475
2,2024-06-04,시민공원(문화창작지대),22252,11453,10799
2,2024-06-04,석바위시장,9304,4492,4812
2,2024-06-04,인천시청,7240,3460,3780
2,2024-06-04,석천사거리,10699,5569,5130
2,2024-06-04,모래내시장,16951,8281,8670
2,2024-06-04,만수,10851,5635,5216
2,2024-06-04,남동구청,9803,5104,4699
2,2024-06-04,인천대공원,6890,3459,3431
2,2024-06-04,운연(서창),2820,1519,1301
2,2024-06-05,검단오류(검단산업단지),6101,2987,3114
2,2024-06-05,왕길,5666,2848,2818
2,2024-06-05,검단사거리,17788,9285,8503
2,2024-06-05,마전,9280,4516,4764
2,2024-06-05,완정,17009,8865,8144
2,2024-06-05,독정,9946,4993,4953
2,2024-06-05,검암,9834,5402,4432
2,2024-06-05,검바위,7823,3806,4017
2,2024-06-05,아시아드경기장(공촌사거리),10030,5365,4665
2,2024-06-05,서구청,17954,8812,9142
2,2024-06-05,가정(루원시티),25643,13148,12495
2,2024-06-05,가정중앙시장,13701,6725,6976
2,2024-06-05,석남(거북시장),6722,3297,3425
2,2024-06-05,서부여성회관,8687,4499,4188
2,2024-06-05,인천가좌,9473,4841,4632
2,2024-06-05,가재울,9148,4656,4492
2,2024-06-05,주안국가산단,6081,2987,3094
2,2024-06-05,주안,17665,7508,10157
2,2024-06-05,시민공원(문화창작지대),22377,11542,10835
2,2024-06-05,석바위시장,9630,4629,5001
2,2024-06-05,인천시청,7748,3714,4034
2,2024-06-05,석천사거리,10727,5652,5075
2,2024-06-05,모래내시장,17034,8343,8691
2,2024-06-05,만수,11123,5756,5367
2,2024-06-05,남동구청,10032,5242,4790
2,2024-06-05,인천대공원,7350,3727,3623
2,2024-06-05,운연(서창),2868,1535,1333
2,2024-06-06,검단오류(검단산업단지),2311,1185,1126
2,2024-06-06,왕길,2992,1516,1476
2,2024-06-06,검단사거리,10948,5615,5333
2,2024-06-06,마전,4898,2383,2515
2,2024-06-06,완정,8722,4505,4217
2,2024-06-06,독정,5178,2561,2617
2,2024-06-06,검암,5557,3105,2452
2,2024-06-06,검바위,3464,1656,1808
2,2024-06-06,아시아드경기장(공촌사거리),5865,3108,2757
2,2024-06-06,서구청,9042,4444,4598
2,2024-06-06,가정(루원시티),12167,6254,5913
2,2024-06-06,가정중앙시장,8750,4269,4481
2,2024-06-06,석남(거북시장),4147,2041,2106
2,2024-06-06,서부여성회관,5466,2817,2649
2,2024-06-06,인천가좌,4283,2136,2147
2,2024-06-06,가재울,4435,2256,2179
2,2024-06-06,주안국가산단,1679,799,880
2,2024-06-06,주안,11215,4661,6554
2,2024-06-06,시민공원(문화창작지대),12704,6583,6121
2,2024-06-06,석바위시장,5475,2615,2860
2,2024-06-06,인천시청,4122,1944,2178
2,2024-06-06,석천사거리,5967,3130,2837
2,2024-06-06,모래내시장,12291,5999,6292
2,2024-06-06,만수,6965,3599,3366
2,2024-06-06,남동구청,5007,2654,2353
2,2024-06-06,인천대공원,10009,5009,5000
2,2024-06-06,운연(서창),1700,892,808
2,2024-06-07,검단오류(검단산업단지),4800,2367,2433
2,2024-06-07,왕길,5038,2554,2484
2,2024-06-07,검단사거리,16992,8870,8122
2,2024-06-07,마전,7822,3796,4026
2,2024-06-07,완정,15531,8101,7430
2,2024-06-07,독정,8797,4435,4362
2,2024-06-07,검암,8657,4711,3946
2,2024-06-07,검바위,6216,2999,3217
2,2024-06-07,아시아드경기장(공촌사거리),9179,4795,4384
2,2024-06-07,서구청,16894,8322,8572
2,2024-06-07,가정(루원시티),22288,11475,10813
2,2024-06-07,가정중앙시장,12798,6214,6584
2,2024-06-07,석남(거북시장),6255,3028,3227
2,2024-06-07,서부여성회관,8529,4346,4183
2,2024-06-07,인천가좌,7981,4013,3968
2,2024-06-07,가재울,7925,4086,3839
2,2024-06-07,주안국가산단,5020,2447,2573
2,2024-06-07,주안,15688,6660,9028
2,2024-06-07,시민공원(문화창작지대),20574,10657,9917
2,2024-06-07,석바위시장,9045,4407,4638
2,2024-06-07,인천시청,6756,3252,3504
2,2024-06-07,석천사거리,9346,4884,4462
2,2024-06-07,모래내시장,16375,7989,8386
2,2024-06-07,만수,10108,5208,4900
2,2024-06-07,남동구청,8819,4570,4249
2,2024-06-07,인천대공원,6343,3208,3135
2,2024-06-07,운연(서창),2465,1342,1123
2,2024-06-08,검단오류(검단산업단지),1877,1025,852
2,2024-06-08,왕길,2935,1503,1432
2,2024-06-08,검단사거리,12243,6355,5888
2,2024-06-08,마전,5478,2717,2761
2,2024-06-08,완정,9836,5140,4696
2,2024-06-08,독정,5637,2841,2796
2,2024-06-08,검암,5793,3219,2574
2,2024-06-08,검바위,3797,1865,1932
2,2024-06-08,아시아드경기장(공촌사거리),6448,3398,3050
2,2024-06-08,서구청,10407,5156,5251
2,2024-06-08,가정(루원시티),13633,6976,6657
2,2024-06-08,가정중앙시장,9389,4656,4733
2,2024-06-08,석남(거북시장),4409,2164,2245
2,2024-06-08,서부여성회관,5799,2938,2861
2,2024-06-08,인천가좌,4574,2319,2255
2,2024-06-08,가재울,4284,2185,2099
2,2024-06-08,주안국가산단,1366,662,704
2,2024-06-08,주안,12372,5096,7276
2,2024-06-08,시민공원(문화창작지대),13612,7047,6565
2,2024-06-08,석바위시장,5950,2906,3044
2,2024-06-08,인천시청,4699,2216,2483
2,2024-06-08,석천사거리,5885,3108,2777
2,2024-06-08,모래내시장,12062,5821,6241
2,2024-06-08,만수,7160,3705,3455
2,2024-06-08,남동구청,5283,2715,2568
2,2024-06-08,인천대공원,5370,2690,2680
2,2024-06-08,운연(서창),1715,836,879
2,2024-06-09,검단오류(검단산업단지),1618,780,838
2,2024-06-09,왕길,2037,1031,1006
2,2024-06-09,검단사거리,9953,4985,4968
2,2024-06-09,마전,4030,1937,2093
2,2024-06-09,완정,7478,3742,3736
2,2024-06-09,독정,3923,1957,1966
2,2024-06-09,검암,4703,2512,2191
2,2024-06-09,검바위,3025,1422,1603
2,2024-06-09,아시아드경기장(공촌사거리),5135,2618,2517
2,2024-06-09,서구청,7875,3965,3910
2,2024-06-09,가정(루원시티),10306,5276,5030
2,2024-06-09,가정중앙시장,7460,3665,3795
2,2024-06-09,석남(거북시장),3429,1598,1831
2,2024-06-09,서부여성회관,5027,2579,2448
2,2024-06-09,인천가좌,3630,1814,1816
2,2024-06-09,가재울,3666,1866,1800
2,2024-06-09,주안국가산단,760,375,385
2,2024-06-09,주안,9468,3942,5526
2,2024-06-09,시민공원(문화창작지대),11296,5831,5465
2,2024-06-09,석바위시장,5375,2593,2782
2,2024-06-09,인천시청,4203,1976,2227
2,2024-06-09,석천사거리,5026,2674,2352
2,2024-06-09,모래내시장,10796,5270,5526
2,2024-06-09,만수,5979,3029,2950
2,2024-06-09,남동구청,4491,2314,2177
2,2024-06-09,인천대공원,8173,4146,4027
2,2024-06-09,운연(서창),1466,773,693
2,2024-06-10,검단오류(검단산업단지),5788,2835,2953
2,2024-06-10,왕길,5537,2796,2741
2,2024-06-10,검단사거리,17031,8900,8131
2,2024-06-10,마전,8923,4292,4631
2,2024-06-10,완정,16410,8465,7945
2,2024-06-10,독정,9392,4696,4696
2,2024-06-10,검암,9376,5141,4235
2,2024-06-10,검바위,7543,3668,3875
2,2024-06-10,아시아드경기장(공촌사거리),9800,5167,4633
2,2024-06-10,서구청,17657,8796,8861
2,2024-06-10,가정(루원시티),23851,12174,11677
2,2024-06-10,가정중앙시장,12797,6264,6533
2,2024-06-10,석남(거북시장),6271,3083,3188
2,2024-06-10,서부여성회관,8280,4327,3953
2,2024-06-10,인천가좌,9014,4583,4431
2,2024-06-10,가재울,8461,4278,4183
2,2024-06-10,주안국가산단,6008,2950,3058
2,2024-06-10,주안,16168,6920,9248
2,2024-06-10,시민공원(문화창작지대),21654,11139,10515
2,2024-06-10,석바위시장,9145,4447,4698
2,2024-06-10,인천시청,6739,3225,3514
2,2024-06-10,석천사거리,10053,5303,4750
2,2024-06-10,모래내시장,16250,7906,8344
2,2024-06-10,만수,10514,5387,5127
2,2024-06-10,남동구청,9721,5066,4655
2,2024-06-10,인천대공원,6164,3100,3064
2,2024-06-10,운연(서창),2606,1361,1245
2,2024-06-11,검단오류(검단산업단지),6010,2960,3050
2,2024-06-11,왕길,5603,2805,2798
2,2024-06-11,검단사거리,17069,8965,8104
2,2024-06-11,마전,9065,4378,4687
2,2024-06-11,완정,16432,8525,7907
2,2024-06-11,독정,9639,4760,4879
2,2024-06-11,검암,9583,5292,4291
2,2024-06-11,검바위,7573,3652,3921
2,2024-06-11,아시아드경기장(공촌사거리),9967,5217,4750
2,2024-06-11,서구청,18457,9170,9287
2,2024-06-11,가정(루원시티),24549,12633,11916
2,2024-06-11,가정중앙시장,12949,6285,6664
2,2024-06-11,석남(거북시장),6309,3087,3222
2,2024-06-11,서부여성회관,8525,4327,4198
2,2024-06-11,인천가좌,9110,4619,4491
2,2024-06-11,가재울,8873,4598,4275
2,2024-06-11,주안국가산단,6130,3041,3089
2,2024-06-11,주안,16508,7141,9367
2,2024-06-11,시민공원(문화창작지대),21616,11207,10409
2,2024-06-11,석바위시장,9346,4535,4811
2,2024-06-11,인천시청,7393,3568,3825
2,2024-06-11,석천사거리,10420,5473,4947
2,2024-06-11,모래내시장,16599,8071,8528
2,2024-06-11,만수,10760,5529,5231
2,2024-06-11,남동구청,10187,5265,4922
2,2024-06-11,인천대공원,6168,3069,3099
2,2024-06-11,운연(서창),2751,1465,1286
2,2024-06-12,검단오류(검단산업단지),6076,2984,3092
2,2024-06-12,왕길,5550,2769,2781
2,2024-06-12,검단사거리,17256,9049,8207
2,2024-06-12,마전,8928,4377,4551
2,2024-06-12,완정,16618,8572,8046
2,2024-06-12,독정,9394,4670,4724
2,2024-06-12,검암,9438,5039,4399
2,2024-06-12,검바위,7670,3712,3958
2,2024-06-12,아시아드경기장(공촌사거리),10320,5399,4921
2,2024-06-12,서구청,17393,8658,8735
2,2024-06-12,가정(루원시티),24774,12624,12150
2,2024-06-12,가정중앙시장,12876,6345,6531
2,2024-06-12,석남(거북시장),6344,3059,3285
2,2024-06-12,서부여성회관,8493,4281,4212
2,2024-06-12,인천가좌,9096,4558,4538
2,2024-06-12,가재울,8777,4497,4280
2,2024-06-12,주안국가산단,6190,3032,3158
2,2024-06-12,주안,16577,7140,9437
2,2024-06-12,시민공원(문화창작지대),21878,11302,10576
2,2024-06-12,석바위시장,9273,4476,4797
2,2024-06-12,인천시청,7424,3615,3809
2,2024-06-12,석천사거리,10962,5706,5256
2,2024-06-12,모래내시장,16763,8119,8644
2,2024-06-12,만수,10640,5500,5140
2,2024-06-12,남동구청,9900,5161,4739
2,2024-06-12,인천대공원,6054,3021,3033
2,2024-06-12,운연(서창),2595,1370,1225
2,2024-06-13,검단오류(검단산업단지),5947,2932,3015
2,2024-06-13,왕길,5532,2805,2727
2,2024-06-13,검단사거리,17128,8970,8158
2,2024-06-13,마전,9269,4476,4793
2,2024-06-13,완정,16325,8405,7920
2,2024-06-13,독정,9768,4948,4820
2,2024-06-13,검암,9533,5225,4308
2,2024-06-13,검바위,7551,3622,3929
2,2024-06-13,아시아드경기장(공촌사거리),9884,5280,4604
2,2024-06-13,서구청,17476,8633,8843
2,2024-06-13,가정(루원시티),24532,12565,11967
2,2024-06-13,가정중앙시장,12933,6257,6676
2,2024-06-13,석남(거북시장),6266,3093,3173
2,2024-06-13,서부여성회관,8664,4371,4293
2,2024-06-13,인천가좌,9043,4590,4453
2,2024-06-13,가재울,8612,4375,4237
2,2024-06-13,주안국가산단,6182,3028,3154
2,2024-06-13,주안,16573,7147,9426
2,2024-06-13,시민공원(문화창작지대),22082,11403,10679
2,2024-06-13,석바위시장,9332,4543,4789
2,2024-06-13,인천시청,7401,3546,3855
2,2024-06-13,석천사거리,10529,5448,5081
2,2024-06-13,모래내시장,16947,8215,8732
2,2024-06-13,만수,10771,5564,5207
2,2024-06-13,남동구청,9795,5056,4739
2,2024-06-13,인천대공원,6114,3092,3022
2,2024-06-13,운연(서창),2740,1455,1285
2,2024-06-14,검단오류(검단산업단지),5750,2815,2935
2,2024-06-14,왕길,5536,2792,2744
2,2024-06-14,검단사거리,17946,9356,8590
2,2024-06-14,마전,9049,4405,4644
2,2024-06-14,완정,16797,8770,8027
2,2024-06-14,독정,9654,4818,4836
2,2024-06-14,검암,9430,5184,4246
2,2024-06-14,검바위,7570,3726,3844
2,2024-06-14,아시아드경기장(공촌사거리),10152,5383,4769
2,2024-06-14,서구청,18049,8907,9142
2,2024-06-14,가정(루원시티),25109,12892,12217
2,2024-06-14,가정중앙시장,13591,6566,7025
2,2024-06-14,석남(거북시장),6578,3188,3390
2,2024-06-14,서부여성회관,9083,4631,4452
2,2024-06-14,인천가좌,9163,4663,4500
2,2024-06-14,가재울,8662,4456,4206
2,2024-06-14,주안국가산단,6025,2953,3072
2,2024-06-14,주안,17127,7261,9866
2,2024-06-14,시민공원(문화창작지대),21593,11124,10469
2,2024-06-14,석바위시장,9530,4622,4908
2,2024-06-14,인천시청,7195,3502,3693
2,2024-06-14,석천사거리,10498,5520,4978
2,2024-06-14,모래내시장,17215,8399,8816
2,2024-06-14,만수,11254,5823,5431
2,2024-06-14,남동구청,9900,5163,4737
2,2024-06-14,인천대공원,8428,4230,4198
2,2024-06-14,운연(서창),2747,1457,1290
2,2024-06-15,검단오류(검단산업단지),2234,1202,1032
2,2024-06-15,왕길,3391,1765,1626
2,2024-06-15,검단사거리,13516,6969,6547
2,2024-06-15,마전,6006,2995,3011
2,2024-06-15,완정,10689,5611,5078
2,2024-06-15,독정,6560,3283,3277
2,2024-06-15,검암,5979,3296,2683
2,2024-06-15,검바위,3973,1955,2018
2,2024-06-15,아시아드경기장(공촌사거리),6711,3474,3237
2,2024-06-15,서구청,11338,5635,5703
2,2024-06-15,가정(루원시티),14730,7639,7091
2,2024-06-15,가정중앙시장,10247,5037,5210
2,2024-06-15,석남(거북시장),4568,2241,2327
2,2024-06-15,서부여성회관,6312,3281,3031
2,2024-06-15,인천가좌,4917,2477,2440
2,2024-06-15,가재울,4947,2579,2368
2,2024-06-15,주안국가산단,1528,750,778
2,2024-06-15,주안,13808,5739,8069
2,2024-06-15,시민공원(문화창작지대),15372,7961,7411
2,2024-06-15,석바위시장,6894,3320,3574
2,2024-06-15,인천시청,4899,2306,2593
2,2024-06-15,석천사거리,6478,3465,3013
2,2024-06-15,모래내시장,13351,6536,6815
2,2024-06-15,만수,7862,3983,3879
2,2024-06-15,남동구청,5852,3024,2828
2,2024-06-15,인천대공원,6276,3123,3153
2,2024-06-15,운연(서창),1770,911,859
2,2024-06-16,검단오류(검단산업단지),1589,774,815
2,2024-06-16,왕길,2175,1089,1086
2,2024-06-16,검단사거리,10146,5114,5032
2,2024-06-16,마전,4347,2074,2273
2,2024-06-16,완정,7683,3842,3841
2,2024-06-16,독정,4840,2343,2497
2,2024-06-16,검암,4617,2493,2124
2,2024-06-16,검바위,3133,1468,1665
2,2024-06-16,아시아드경기장(공촌사거리),5282,2732,2550
2,2024-06-16,서구청,7983,4009,3974
2,2024-06-16,가정(루원시티),10401,5235,5166
2,2024-06-16,가정중앙시장,7720,3781,3939
2,2024-06-16,석남(거북시장),3307,1583,1724
2,2024-06-16,서부여성회관,5246,2696,2550
2,2024-06-16,인천가좌,3568,1785,1783
2,2024-06-16,가재울,3585,1791,1794
2,2024-06-16,주안국가산단,807,372,435
2,2024-06-16,주안,9764,4044,5720
2,2024-06-16,시민공원(문화창작지대),11919,6232,5687
2,2024-06-16,석바위시장,5128,2514,2614
2,2024-06-16,인천시청,3951,1876,2075
2,2024-06-16,석천사거리,4942,2609,2333
2,2024-06-16,모래내시장,11149,5411,5738
2,2024-06-16,만수,6063,3099,2964
2,2024-06-16,남동구청,4601,2347,2254
2,2024-06-16,인천대공원,6984,3508,3476
2,2024-06-16,운연(서창),1485,792,693
2,2024-06-17,검단오류(검단산업단지),5747,2790,2957
2,2024-06-17,왕길,5477,2769,2708
2,2024-06-17,검단사거리,16787,8747,8040
2,2024-06-17,마전,8708,4183,4525
2,2024-06-17,완정,16005,8251,7754
2,2024-06-17,독정,9502,4766,4736
2,2024-06-17,검암,9248,5038,4210
2,2024-06-17,검바위,7501,3608,3893
2,2024-06-17,아시아드경기장(공촌사거리),9521,5029,4492
2,2024-06-17,서구청,17418,8709,8709
2,2024-06-17,가정(루원시티),23838,12245,11593
2,2024-06-17,가정중앙시장,12482,6077,6405
2,2024-06-17,석남(거북시장),6093,2999,3094
2,2024-06-17,서부여성회관,8137,4214,3923
2,2024-06-17,인천가좌,8873,4465,4408
2,2024-06-17,가재울,8551,4347,4204
2,2024-06-17,주안국가산단,6127,2993,3134
2,2024-06-17,주안,15676,6664,9012
2,2024-06-17,시민공원(문화창작지대),20842,10735,10107
2,2024-06-17,석바위시장,9211,4446,4765
2,2024-06-17,인천시청,7166,3474,3692
2,2024-06-17,석천사거리,9986,5201,4785
2,2024-06-17,모래내시장,16339,7961,8378
2,2024-06-17,만수,10521,5399,5122
2,2024-06-17,남동구청,9618,4974,4644
2,2024-06-17,인천대공원,5596,2807,2789
2,2024-06-17,운연(서창),2604,1362,1242
2,2024-06-18,검단오류(검단산업단지),5877,2884,2993
2,2024-06-18,왕길,5531,2800,2731
2,2024-06-18,검단사거리,16960,8843,8117
2,2024-06-18,마전,8952,4365,4587
2,2024-06-18,완정,16379,8468,7911
2,2024-06-18,독정,9399,4663,4736
2,2024-06-18,검암,9415,5163,4252
2,2024-06-18,검바위,7418,3573,3845
2,2024-06-18,아시아드경기장(공촌사거리),9679,5120,4559
2,2024-06-18,서구청,17632,8778,8854
2,2024-06-18,가정(루원시티),24106,12260,11846
2,2024-06-18,가정중앙시장,12876,6241,6635
2,2024-06-18,석남(거북시장),6354,3109,3245
2,2024-06-18,서부여성회관,8265,4271,3994
2,2024-06-18,인천가좌,8906,4511,4395
2,2024-06-18,가재울,8609,4348,4261
2,2024-06-18,주안국가산단,6067,2983,3084
2,2024-06-18,주안,15846,6827,9019
2,2024-06-18,시민공원(문화창작지대),21275,10952,10323
2,2024-06-18,석바위시장,9100,4377,4723
2,2024-06-18,인천시청,7412,3554,3858
2,2024-06-18,석천사거리,10175,5353,4822
2,2024-06-18,모래내시장,16351,7958,8393
2,2024-06-18,만수,10539,5417,5122
2,2024-06-18,남동구청,9752,5065,4687
2,2024-06-18,인천대공원,6023,3029,2994
2,2024-06-18,운연(서창),2611,1383,1228
2,2024-06-19,검단오류(검단산업단지),6013,2971,3042
2,2024-06-19,왕길,5531,2772,2759
2,2024-06-19,검단사거리,16986,8873,8113
2,2024-06-19,마전,9177,4396,4781
2,2024-06-19,완정,16452,8474,7978
2,2024-06-19,독정,9468,4741,4727
2,2024-06-19,검암,9285,5077,4208
2,2024-06-19,검바위,7598,3672,3926
2,2024-06-19,아시아드경기장(공촌사거리),10207,5373,4834
2,2024-06-19,서구청,17157,8427,8730
2,2024-06-19,가정(루원시티),24565,12551,12014
2,2024-06-19,가정중앙시장,12652,6178,6474
2,2024-06-19,석남(거북시장),6307,3046,3261
2,2024-06-19,서부여성회관,8234,4216,4018
2,2024-06-19,인천가좌,8880,4486,4394
2,2024-06-19,가재울,8719,4415,4304
2,2024-06-19,주안국가산단,6159,3005,3154
2,2024-06-19,주안,15852,6751,9101
2,2024-06-19,시민공원(문화창작지대),21344,11049,10295
2,2024-06-19,석바위시장,9338,4514,4824
2,2024-06-19,인천시청,7335,3568,3767
2,2024-06-19,석천사거리,10150,5305,4845
2,2024-06-19,모래내시장,16295,7935,8360
2,2024-06-19,만수,10684,5450,5234
2,2024-06-19,남동구청,9698,5058,4640
2,2024-06-19,인천대공원,5503,2746,2757
2,2024-06-19,운연(서창),2658,1419,1239
2,2024-06-20,검단오류(검단산업단지),5914,2902,3012
2,2024-06-20,왕길,5522,2753,2769
2,2024-06-20,검단사거리,17065,8849,8216
2,2024-06-20,마전,9010,4342,4668
2,2024-06-20,완정,15989,8323,7666
2,2024-06-20,독정,9472,4801,4671
2,2024-06-20,검암,9239,5002,4237
2,2024-06-20,검바위,7503,3576,3927
2,2024-06-20,아시아드경기장(공촌사거리),9699,5155,4544
2,2024-06-20,서구청,17287,8588,8699
2,2024-06-20,가정(루원시티),24133,12288,11845
2,2024-06-20,가정중앙시장,12723,6185,6538
2,2024-06-20,석남(거북시장),6340,3097,3243
2,2024-06-20,서부여성회관,8380,4240,4140
2,2024-06-20,인천가좌,8766,4414,4352
2,2024-06-20,가재울,8422,4321,4101
2,2024-06-20,주안국가산단,6108,2998,3110
2,2024-06-20,주안,15920,6768,9152
2,2024-06-20,시민공원(문화창작지대),21287,10939,10348
2,2024-06-20,석바위시장,9022,4370,4652
2,2024-06-20,인천시청,7568,3620,3948
2,2024-06-20,석천사거리,9950,5204,4746
2,2024-06-20,모래내시장,16386,7849,8537
2,2024-06-20,만수,10487,5484,5003
2,2024-06-20,남동구청,9674,5025,4649
2,2024-06-20,인천대공원,5729,2911,2818
2,2024-06-20,운연(서창),2589,1397,1192
2,2024-06-21,검단오류(검단산업단지),5843,2887,2956
2,2024-06-21,왕길,5552,2829,2723
2,2024-06-21,검단사거리,17658,9162,8496
2,2024-06-21,마전,9097,4478,4619
2,2024-06-21,완정,16573,8603,7970
2,2024-06-21,독정,9622,4862,4760
2,2024-06-21,검암,9354,5153,4201
2,2024-06-21,검바위,7649,3674,3975
2,2024-06-21,아시아드경기장(공촌사거리),9672,5114,4558
2,2024-06-21,서구청,18288,9038,9250
2,2024-06-21,가정(루원시티),24906,12809,12097
2,2024-06-21,가정중앙시장,13442,6589,6853
2,2024-06-21,석남(거북시장),6519,3171,3348
2,2024-06-21,서부여성회관,8842,4525,4317
2,2024-06-21,인천가좌,9019,4562,4457
2,2024-06-21,가재울,8827,4479,4348
2,2024-06-21,주안국가산단,5980,2936,3044
2,2024-06-21,주안,16481,6957,9524
2,2024-06-21,시민공원(문화창작지대),21151,10853,10298
2,2024-06-21,석바위시장,9400,4525,4875
2,2024-06-21,인천시청,7261,3542,3719
2,2024-06-21,석천사거리,10255,5363,4892
2,2024-06-21,모래내시장,16768,8114,8654
2,2024-06-21,만수,10871,5646,5225
2,2024-06-21,남동구청,9721,5018,4703
2,2024-06-21,인천대공원,5496,2801,2695
2,2024-06-21,운연(서창),2716,1458,1258
2,2024-06-22,검단오류(검단산업단지),2086,1138,948
2,2024-06-22,왕길,3091,1541,1550
2,2024-06-22,검단사거리,12840,6632,6208
2,2024-06-22,마전,5681,2843,2838
2,2024-06-22,완정,10068,5329,4739
2,2024-06-22,독정,5938,2949,2989
2,2024-06-22,검암,5415,3043,2372
2,2024-06-22,검바위,3647,1776,1871
2,2024-06-22,아시아드경기장(공촌사거리),6099,3206,2893
2,2024-06-22,서구청,10629,5201,5428
2,2024-06-22,가정(루원시티),14243,7236,7007
2,2024-06-22,가정중앙시장,9045,4424,4621
2,2024-06-22,석남(거북시장),4410,2157,2253
2,2024-06-22,서부여성회관,5736,2974,2762
2,2024-06-22,인천가좌,4567,2305,2262
2,2024-06-22,가재울,4450,2300,2150
2,2024-06-22,주안국가산단,1425,697,728
2,2024-06-22,주안,12320,5016,7304
2,2024-06-22,시민공원(문화창작지대),13804,7161,6643
2,2024-06-22,석바위시장,5898,2877,3021
2,2024-06-22,인천시청,4273,1961,2312
2,2024-06-22,석천사거리,6379,3303,3076
2,2024-06-22,모래내시장,11175,5540,5635
2,2024-06-22,만수,7223,3720,3503
2,2024-06-22,남동구청,5418,2808,2610
2,2024-06-22,인천대공원,3874,1934,1940
2,2024-06-22,운연(서창),1551,797,754
2,2024-06-23,검단오류(검단산업단지),1530,748,782
2,2024-06-23,왕길,2284,1150,1134
2,2024-06-23,검단사거리,10342,5164,5178
2,2024-06-23,마전,4214,1986,2228
2,2024-06-23,완정,7622,3815,3807
2,2024-06-23,독정,4358,2103,2255
2,2024-06-23,검암,4484,2418,2066
2,2024-06-23,검바위,3051,1432,1619
2,2024-06-23,아시아드경기장(공촌사거리),5194,2720,2474
2,2024-06-23,서구청,7844,3890,3954
2,2024-06-23,가정(루원시티),10693,5365,5328
2,2024-06-23,가정중앙시장,7586,3779,3807
2,2024-06-23,석남(거북시장),3506,1651,1855
2,2024-06-23,서부여성회관,5238,2667,2571
2,2024-06-23,인천가좌,3614,1830,1784
2,2024-06-23,가재울,3668,1888,1780
2,2024-06-23,주안국가산단,749,351,398
2,2024-06-23,주안,9591,3962,5629
2,2024-06-23,시민공원(문화창작지대),11585,5987,5598
2,2024-06-23,석바위시장,5457,2683,2774
2,2024-06-23,인천시청,3673,1770,1903
2,2024-06-23,석천사거리,5124,2705,2419
2,2024-06-23,모래내시장,10498,5143,5355
2,2024-06-23,만수,6077,3124,2953
2,2024-06-23,남동구청,4390,2299,2091
2,2024-06-23,인천대공원,6062,3019,3043
2,2024-06-23,운연(서창),1408,730,678
2,2024-06-24,검단오류(검단산업단지),5909,2893,3016
2,2024-06-24,왕길,5432,2719,2713
2,2024-06-24,검단사거리,16744,8765,7979
2,2024-06-24,마전,8712,4193,4519
2,2024-06-24,완정,16201,8447,7754
2,2024-06-24,독정,9363,4677,4686
2,2024-06-24,검암,9283,5096,4187
2,2024-06-24,검바위,7494,3662,3832
2,2024-06-24,아시아드경기장(공촌사거리),9541,5018,4523
2,2024-06-24,서구청,17483,8725,8758
2,2024-06-24,가정(루원시티),23522,11998,11524
2,2024-06-24,가정중앙시장,12440,6093,6347
2,2024-06-24,석남(거북시장),6179,2997,3182
2,2024-06-24,서부여성회관,8047,4090,3957
2,2024-06-24,인천가좌,8786,4456,4330
2,2024-06-24,가재울,8399,4275,4124
2,2024-06-24,주안국가산단,6023,2968,3055
2,2024-06-24,주안,15378,6632,8746
2,2024-06-24,시민공원(문화창작지대),20785,10678,10107
2,2024-06-24,석바위시장,9134,4423,4711
2,2024-06-24,인천시청,7198,3466,3732
2,2024-06-24,석천사거리,10021,5199,4822
2,2024-06-24,모래내시장,16179,7906,8273
2,2024-06-24,만수,10462,5421,5041
2,2024-06-24,남동구청,9584,4954,4630
2,2024-06-24,인천대공원,5453,2759,2694
2,2024-06-24,운연(서창),2555,1357,1198
2,2024-06-25,검단오류(검단산업단지),6049,2994,3055
2,2024-06-25,왕길,5524,2758,2766
2,2024-06-25,검단사거리,17043,8848,8195
2,2024-06-25,마전,8770,4224,4546
2,2024-06-25,완정,16278,8444,7834
2,2024-06-25,독정,9495,4700,4795
2,2024-06-25,검암,9400,5180,4220
2,2024-06-25,검바위,7413,3582,3831
2,2024-06-25,아시아드경기장(공촌사거리),9643,5022,4621
2,2024-06-25,서구청,18767,9302,9465
2,2024-06-25,가정(루원시티),24166,12434,11732
2,2024-06-25,가정중앙시장,13244,6452,6792
2,2024-06-25,석남(거북시장),6426,3147,3279
2,2024-06-25,서부여성회관,8271,4236,4035
2,2024-06-25,인천가좌,9036,4559,4477
2,2024-06-25,가재울,8845,4501,4344
2,2024-06-25,주안국가산단,6146,3045,3101
2,2024-06-25,주안,15917,6847,9070
2,2024-06-25,시민공원(문화창작지대),21179,10860,10319
2,2024-06-25,석바위시장,9561,4708,4853
2,2024-06-25,인천시청,7720,3637,4083
2,2024-06-25,석천사거리,10303,5400,4903
2,2024-06-25,모래내시장,16875,8257,8618
2,2024-06-25,만수,10979,5683,5296
2,2024-06-25,남동구청,10079,5206,4873
2,2024-06-25,인천대공원,6075,3063,3012
2,2024-06-25,운연(서창),2730,1443,1287
2,2024-06-26,검단오류(검단산업단지),6104,3009,3095
2,2024-06-26,왕길,5529,2793,2736
2,2024-06-26,검단사거리,16865,8808,8057
2,2024-06-26,마전,8913,4348,4565
2,2024-06-26,완정,16465,8528,7937
2,2024-06-26,독정,9641,4774,4867
2,2024-06-26,검암,9290,5103,4187
2,2024-06-26,검바위,7482,3590,3892
2,2024-06-26,아시아드경기장(공촌사거리),9972,5207,4765
2,2024-06-26,서구청,18049,8935,9114
2,2024-06-26,가정(루원시티),24749,12616,12133
2,2024-06-26,가정중앙시장,12892,6288,6604
2,2024-06-26,석남(거북시장),6522,3199,3323
2,2024-06-26,서부여성회관,8382,4225,4157
2,2024-06-26,인천가좌,8927,4561,4366
2,2024-06-26,가재울,8677,4460,4217
2,2024-06-26,주안국가산단,6104,2992,3112
2,2024-06-26,주안,15916,6771,9145
2,2024-06-26,시민공원(문화창작지대),21519,11062,10457
2,2024-06-26,석바위시장,9673,4710,4963
2,2024-06-26,인천시청,7458,3569,3889
2,2024-06-26,석천사거리,10436,5465,4971
2,2024-06-26,모래내시장,16687,8105,8582
2,2024-06-26,만수,11124,5753,5371
2,2024-06-26,남동구청,10101,5227,4874
2,2024-06-26,인천대공원,5803,2910,2893
2,2024-06-26,운연(서창),3126,1653,1473
2,2024-06-27,검단오류(검단산업단지),5990,2945,3045
2,2024-06-27,왕길,5490,2764,2726
2,2024-06-27,검단사거리,17082,8972,8110
2,2024-06-27,마전,8782,4208,4574
2,2024-06-27,완정,16313,8433,7880
2,2024-06-27,독정,9754,4911,4843
2,2024-06-27,검암,9141,5047,4094
2,2024-06-27,검바위,7346,3583,3763
2,2024-06-27,아시아드경기장(공촌사거리),9704,5127,4577
2,2024-06-27,서구청,17904,8917,8987
2,2024-06-27,가정(루원시티),24306,12458,11848
2,2024-06-27,가정중앙시장,12970,6370,6600
2,2024-06-27,석남(거북시장),6216,3005,3211
2,2024-06-27,서부여성회관,8533,4342,4191
2,2024-06-27,인천가좌,8819,4484,4335
2,2024-06-27,가재울,8476,4312,4164
2,2024-06-27,주안국가산단,6114,3016,3098
2,2024-06-27,주안,16000,6880,9120
2,2024-06-27,시민공원(문화창작지대),21605,11123,10482
2,2024-06-27,석바위시장,9294,4529,4765
2,2024-06-27,인천시청,7177,3439,3738
2,2024-06-27,석천사거리,10214,5335,4879
2,2024-06-27,모래내시장,16503,8032,8471
2,2024-06-27,만수,10727,5604,5123
2,2024-06-27,남동구청,9714,5015,4699
2,2024-06-27,인천대공원,5870,2939,2931
2,2024-06-27,운연(서창),2648,1412,1236
2,2024-06-28,검단오류(검단산업단지),5799,2863,2936
2,2024-06-28,왕길,5675,2872,2803
2,2024-06-28,검단사거리,18037,9447,8590
2,2024-06-28,마전,8827,4315,4512
2,2024-06-28,완정,16680,8704,7976
2,2024-06-28,독정,9691,4785,4906
2,2024-06-28,검암,9433,5264,4169
2,2024-06-28,검바위,7546,3651,3895
2,2024-06-28,아시아드경기장(공촌사거리),9817,5178,4639
2,2024-06-28,서구청,17900,8845,9055
2,2024-06-28,가정(루원시티),24815,12655,12160
2,2024-06-28,가정중앙시장,13581,6574,7007
2,2024-06-28,석남(거북시장),6630,3212,3418
2,2024-06-28,서부여성회관,8688,4473,4215
2,2024-06-28,인천가좌,9076,4571,4505
2,2024-06-28,가재울,8461,4321,4140
2,2024-06-28,주안국가산단,5944,2910,3034
2,2024-06-28,주안,16387,7013,9374
2,2024-06-28,시민공원(문화창작지대),21512,11077,10435
2,2024-06-28,석바위시장,9850,4773,5077
2,2024-06-28,인천시청,7180,3432,3748
2,2024-06-28,석천사거리,10089,5287,4802
2,2024-06-28,모래내시장,17315,8384,8931
2,2024-06-28,만수,11028,5771,5257
2,2024-06-28,남동구청,9774,5103,4671
2,2024-06-28,인천대공원,5683,2895,2788
2,2024-06-28,운연(서창),2783,1501,1282
2,2024-06-29,검단오류(검단산업단지),2144,1195,949
2,2024-06-29,왕길,3166,1630,1536
2,2024-06-29,검단사거리,13162,6843,6319
2,2024-06-29,마전,5989,2887,3102
2,2024-06-29,완정,10409,5447,4962
2,2024-06-29,독정,6028,3039,2989
2,2024-06-29,검암,5982,3251,2731
2,2024-06-29,검바위,3968,1923,2045
2,2024-06-29,아시아드경기장(공촌사거리),6275,3338,2937
2,2024-06-29,서구청,10839,5294,5545
2,2024-06-29,가정(루원시티),14381,7369,7012
2,2024-06-29,가정중앙시장,9920,4918,5002
2,2024-06-29,석남(거북시장),4474,2127,2347
2,2024-06-29,서부여성회관,5866,2995,2871
2,2024-06-29,인천가좌,4592,2339,2253
2,2024-06-29,가재울,4631,2395,2236
2,2024-06-29,주안국가산단,1467,708,759
2,2024-06-29,주안,12588,5061,7527
2,2024-06-29,시민공원(문화창작지대),14656,7477,7179
2,2024-06-29,석바위시장,6990,3418,3572
2,2024-06-29,인천시청,4561,2154,2407
2,2024-06-29,석천사거리,6630,3454,3176
2,2024-06-29,모래내시장,13494,6612,6882
2,2024-06-29,만수,7762,3970,3792
2,2024-06-29,남동구청,5620,2933,2687
2,2024-06-29,인천대공원,6310,3130,3180
2,2024-06-29,운연(서창),1728,893,835
2,2024-06-30,검단오류(검단산업단지),1411,691,720
2,2024-06-30,왕길,2170,1082,1088
2,2024-06-30,검단사거리,9208,4571,4637
2,2024-06-30,마전,3876,1875,2001
2,2024-06-30,완정,6838,3423,3415
2,2024-06-30,독정,4145,2042,2103
2,2024-06-30,검암,3990,2141,1849
2,2024-06-30,검바위,2871,1368,1503
2,2024-06-30,아시아드경기장(공촌사거리),4711,2470,2241
2,2024-06-30,서구청,7229,3552,3677
2,2024-06-30,가정(루원시티),9449,4714,4735
2,2024-06-30,가정중앙시장,6849,3334,3515
2,2024-06-30,석남(거북시장),3048,1462,1586
2,2024-06-30,서부여성회관,4731,2436,2295
2,2024-06-30,인천가좌,3245,1688,1557
2,2024-06-30,가재울,3272,1677,1595
2,2024-06-30,주안국가산단,757,357,400
2,2024-06-30,주안,8710,3637,5073
2,2024-06-30,시민공원(문화창작지대),10285,5308,4977
2,2024-06-30,석바위시장,5077,2466,2611
2,2024-06-30,인천시청,3473,1646,1827
2,2024-06-30,석천사거리,4477,2327,2150
2,2024-06-30,모래내시장,9667,4791,4876
2,2024-06-30,만수,5461,2814,2647
2,2024-06-30,남동구청,4079,2108,1971
2,2024-06-30,인천대공원,4083,2039,2044
2,2024-06-30,운연(서창),1216,648,568
7,2023-07-01,삼산체육관,9498,4935,4563
7,2023-07-01,굴포천,15352,7508,7844
7,2023-07-01,부평구청,9877,5249,4628
7,2023-07-01,산곡,10984,5699,5285
7,2023-07-01,석남(거북시장),10835,5770,5065
7,2023-07-02,삼산체육관,6956,3601,3355
7,2023-07-02,굴포천,10790,5355,5435
7,2023-07-02,부평구청,6974,3683,3291
7,2023-07-02,산곡,7797,3966,3831
7,2023-07-02,석남(거북시장),7801,4154,3647
7,2023-07-03,삼산체육관,12333,6509,5824
7,2023-07-03,굴포천,20521,9986,10535
7,2023-07-03,부평구청,14527,7471,7056
7,2023-07-03,산곡,17166,8929,8237
7,2023-07-03,석남(거북시장),14071,7519,6552
7,2023-07-04,삼산체육관,12691,6483,6208
7,2023-07-04,굴포천,20263,9814,10449
7,2023-07-04,부평구청,14172,7288,6884
7,2023-07-04,산곡,16539,8639,7900
7,2023-07-04,석남(거북시장),13253,7088,6165
7,2023-07-05,삼산체육관,12834,6760,6074
7,2023-07-05,굴포천,21157,10299,10858
7,2023-07-05,부평구청,14767,7615,7152
7,2023-07-05,산곡,17629,9263,8366
7,2023-07-05,석남(거북시장),14433,7672,6761
7,2023-07-06,삼산체육관,13064,6893,6171
7,2023-07-06,굴포천,21501,10503,10998
7,2023-07-06,부평구청,14897,7739,7158
7,2023-07-06,산곡,17612,9210,8402
7,2023-07-06,석남(거북시장),14432,7742,6690
7,2023-07-07,삼산체육관,13664,7273,6391
7,2023-07-07,굴포천,22143,10763,11380
7,2023-07-07,부평구청,15059,7884,7175
7,2023-07-07,산곡,18103,9511,8592
7,2023-07-07,석남(거북시장),15022,7963,7059
7,2023-07-08,삼산체육관,9248,4803,4445
7,2023-07-08,굴포천,15542,7666,7876
7,2023-07-08,부평구청,10130,5354,4776
7,2023-07-08,산곡,11605,5980,5625
7,2023-07-08,석남(거북시장),11007,5877,5130
7,2023-07-09,삼산체육관,6322,3309,3013
7,2023-07-09,굴포천,9312,4625,4687
7,2023-07-09,부평구청,6268,3320,2948
7,2023-07-09,산곡,7002,3621,3381
7,2023-07-09,석남(거북시장),7338,3907,3431
7,2023-07-10,삼산체육관,12030,6347,5683
7,2023-07-10,굴포천,20526,9916,10610
7,2023-07-10,부평구청,13866,7200,6666
7,2023-07-10,산곡,17016,8947,8069
7,2023-07-10,석남(거북시장),14108,7562,6546
7,2023-07-11,삼산체육관,12453,6286,6167
7,2023-07-11,굴포천,19953,9791,10162
7,2023-07-11,부평구청,14002,7207,6795
7,2023-07-11,산곡,16823,8781,8042
7,2023-07-11,석남(거북시장),13163,7075,6088
7,2023-07-12,삼산체육관,13066,6874,6192
7,2023-07-12,굴포천,21212,10355,10857
7,2023-07-12,부평구청,14767,7680,7087
7,2023-07-12,산곡,17641,9205,8436
7,2023-07-12,석남(거북시장),14360,7685,6675
7,2023-07-13,삼산체육관,12094,6404,5690
7,2023-07-13,굴포천,19869,9701,10168
7,2023-07-13,부평구청,13736,7142,6594
7,2023-07-13,산곡,16229,8480,7749
7,2023-07-13,석남(거북시장),13248,7154,6094
7,2023-07-14,삼산체육관,12915,6774,6141
7,2023-07-14,굴포천,20706,10111,10595
7,2023-07-14,부평구청,13990,7288,6702
7,2023-07-14,산곡,16626,8720,7906
7,2023-07-14,석남(거북시장),14131,7543,6588
7,2023-07-15,삼산체육관,7822,4062,3760
7,2023-07-15,굴포천,14352,7106,7246
7,2023-07-15,부평구청,9158,4857,4301
7,2023-07-15,산곡,10368,5328,5040
7,2023-07-15,석남(거북시장),10011,5285,4726
7,2023-07-16,삼산체육관,5700,2995,2705
7,2023-07-16,굴포천,9968,4882,5086
7,2023-07-16,부평구청,6722,3553,3169
7,2023-07-16,산곡,7321,3688,3633
7,2023-07-16,석남(거북시장),7623,4075,3548
7,2023-07-17,삼산체육관,12118,6341,5777
7,2023-07-17,굴포천,20545,9977,10568
7,2023-07-17,부평구청,14092,7331,6761
7,2023-07-17,산곡,17219,9029,8190
7,2023-07-17,석남(거북시장),14157,7599,6558
7,2023-07-18,삼산체육관,12281,6433,5848
7,2023-07-18,굴포천,20631,10093,10538
7,2023-07-18,부평구청,14663,7548,7115
7,2023-07-18,산곡,17232,9023,8209
7,2023-07-18,석남(거북시장),13987,7451,6536
7,2023-07-19,삼산체육관,13261,6955,6306
7,2023-07-19,굴포천,21526,10539,10987
7,2023-07-19,부평구청,14949,7727,7222
7,2023-07-19,산곡,17650,9166,8484
7,2023-07-19,석남(거북시장),14462,7661,6801
7,2023-07-20,삼산체육관,12785,6714,6071
7,2023-07-20,굴포천,21777,10641,11136
7,2023-07-20,부평구청,15118,7888,7230
7,2023-07-20,산곡,17657,9190,8467
7,2023-07-20,석남(거북시장),14481,7727,6754
7,2023-07-21,삼산체육관,12707,6742,5965
7,2023-07-21,굴포천,21758,10617,11141
7,2023-07-21,부평구청,14867,7735,7132
7,2023-07-21,산곡,17388,9062,8326
7,2023-07-21,석남(거북시장),14807,7914,6893
7,2023-07-22,삼산체육관,8271,4305,3966
7,2023-07-22,굴포천,14393,7073,7320
7,2023-07-22,부평구청,9181,4872,4309
7,2023-07-22,산곡,10499,5397,5102
7,2023-07-22,석남(거북시장),10244,5417,4827
7,2023-07-23,삼산체육관,4920,2531,2389
7,2023-07-23,굴포천,8800,4389,4411
7,2023-07-23,부평구청,5821,3042,2779
7,2023-07-23,산곡,6393,3243,3150
7,2023-07-23,석남(거북시장),6660,3509,3151
7,2023-07-24,삼산체육관,11936,6330,5606
7,2023-07-24,굴포천,20549,10051,10498
7,2023-07-24,부평구청,14159,7264,6895
7,2023-07-24,산곡,16620,8737,7883
7,2023-07-24,석남(거북시장),13604,7356,6248
7,2023-07-25,삼산체육관,12079,6306,5773
7,2023-07-25,굴포천,20836,10160,10676
7,2023-07-25,부평구청,14377,7511,6866
7,2023-07-25,산곡,17041,8830,8211
7,2023-07-25,석남(거북시장),13846,7421,6425
7,2023-07-26,삼산체육관,12293,6510,5783
7,2023-07-26,굴포천,20896,10229,10667
7,2023-07-26,부평구청,14843,7630,7213
7,2023-07-26,산곡,17185,8979,8206
7,2023-07-26,석남(거북시장),14031,7465,6566
7,2023-07-27,삼산체육관,12156,6396,5760
7,2023-07-27,굴포천,20761,10099,10662
7,2023-07-27,부평구청,14356,7448,6908
7,2023-07-27,산곡,16997,8870,8127
7,2023-07-27,석남(거북시장),13901,7413,6488
7,2023-07-28,삼산체육관,12129,6462,5667
7,2023-07-28,굴포천,21002,10146,10856
7,2023-07-28,부평구청,14476,7487,6989
7,2023-07-28,산곡,16673,8733,7940
7,2023-07-28,석남(거북시장),14019,7422,6597
7,2023-07-29,삼산체육관,7430,3912,3518
7,2023-07-29,굴포천,13462,6598,6864
7,2023-07-29,부평구청,8835,4646,4189
7,2023-07-29,산곡,9952,5061,4891
7,2023-07-29,석남(거북시장),10020,5259,4761
7,2023-07-30,삼산체육관,5528,2825,2703
7,2023-07-30,굴포천,9665,4778,4887
7,2023-07-30,부평구청,6563,3489,3074
7,2023-07-30,산곡,6939,3496,3443
7,2023-07-30,석남(거북시장),7333,3891,3442
7,2023-07-31,삼산체육관,10663,5614,5049
7,2023-07-31,굴포천,18629,9087,9542
7,2023-07-31,부평구청,12506,6536,5970
7,2023-07-31,산곡,14787,7740,7047
7,2023-07-31,석남(거북시장),12540,6807,5733
7,2023-08-01,삼산체육관,11263,5873,5390
7,2023-08-01,굴포천,18735,9083,9652
7,2023-08-01,부평구청,13078,6821,6257
7,2023-08-01,산곡,15081,7853,7228
7,2023-08-01,석남(거북시장),12729,6826,5903
7,2023-08-02,삼산체육관,11430,6026,5404
7,2023-08-02,굴포천,18704,9107,9597
7,2023-08-02,부평구청,12916,6618,6298
7,2023-08-02,산곡,15020,7895,7125
7,2023-08-02,석남(거북시장),12864,6871,5993
7,2023-08-03,삼산체육관,11340,5910,5430
7,2023-08-03,굴포천,19011,9225,9786
7,2023-08-03,부평구청,13158,6803,6355
7,2023-08-03,산곡,15114,7844,7270
7,2023-08-03,석남(거북시장),12762,6843,5919
7,2023-08-04,삼산체육관,11208,5900,5308
7,2023-08-04,굴포천,19406,9482,9924
7,2023-08-04,부평구청,13277,6887,6390
7,2023-08-04,산곡,15160,7945,7215
7,2023-08-04,석남(거북시장),13340,7086,6254
7,2023-08-05,삼산체육관,7124,3677,3447
7,2023-08-05,굴포천,13358,6548,6810
7,2023-08-05,부평구청,8523,4529,3994
7,2023-08-05,산곡,9390,4780,4610
7,2023-08-05,석남(거북시장),9548,5035,4513
7,2023-08-06,삼산체육관,5209,2627,2582
7,2023-08-06,굴포천,9634,4720,4914
7,2023-08-06,부평구청,6348,3356,2992
7,2023-08-06,산곡,6689,3408,3281
7,2023-08-06,석남(거북시장),7219,3815,3404
7,2023-08-07,삼산체육관,10903,5740,5163
7,2023-08-07,굴포천,19528,9471,10057
7,2023-08-07,부평구청,13439,7018,6421
7,2023-08-07,산곡,15846,8321,7525
7,2023-08-07,석남(거북시장),13351,7155,6196
7,2023-08-08,삼산체육관,11640,6129,5511
7,2023-08-08,굴포천,20125,9790,10335
7,2023-08-08,부평구청,14131,7286,6845
7,2023-08-08,산곡,16359,8509,7850
7,2023-08-08,석남(거북시장),13469,7197,6272
7,2023-08-09,삼산체육관,11872,6279,5593
7,2023-08-09,굴포천,20599,9990,10609
7,2023-08-09,부평구청,14238,7253,6985
7,2023-08-09,산곡,16626,8689,7937
7,2023-08-09,석남(거북시장),14018,7522,6496
7,2023-08-10,삼산체육관,9476,4916,4560
7,2023-08-10,굴포천,17150,8320,8830
7,2023-08-10,부평구청,11573,6044,5529
7,2023-08-10,산곡,13343,6972,6371
7,2023-08-10,석남(거북시장),11188,5963,5225
7,2023-08-11,삼산체육관,11299,5971,5328
7,2023-08-11,굴포천,19665,9638,10027
7,2023-08-11,부평구청,13163,6778,6385
7,2023-08-11,산곡,15266,7937,7329
7,2023-08-11,석남(거북시장),13226,6985,6241
7,2023-08-12,삼산체육관,7914,4195,3719
7,2023-08-12,굴포천,14021,6880,7141
7,2023-08-12,부평구청,8804,4603,4201
7,2023-08-12,산곡,10243,5325,4918
7,2023-08-12,석남(거북시장),10357,5338,5019
7,2023-08-13,삼산체육관,5933,3003,2930
7,2023-08-13,굴포천,9919,5000,4919
7,2023-08-13,부평구청,6587,3477,3110
7,2023-08-13,산곡,7257,3643,3614
7,2023-08-13,석남(거북시장),7604,4028,3576
7,2023-08-14,삼산체육관,10360,5499,4861
7,2023-08-14,굴포천,18863,9172,9691
7,2023-08-14,부평구청,12558,6487,6071
7,2023-08-14,산곡,14771,7711,7060
7,2023-08-14,석남(거북시장),12887,6880,6007
7,2023-08-15,삼산체육관,6357,3206,3151
7,2023-08-15,굴포천,11269,5513,5756
7,2023-08-15,부평구청,7287,3816,3471
7,2023-08-15,산곡,8325,4259,4066
7,2023-08-15,석남(거북시장),8227,4305,3922
7,2023-08-16,삼산체육관,12309,6455,5854
7,2023-08-16,굴포천,20442,10045,10397
7,2023-08-16,부평구청,14362,7463,6899
7,2023-08-16,산곡,16862,8778,8084
7,2023-08-16,석남(거북시장),14055,7555,6500
7,2023-08-17,삼산체육관,12143,6374,5769
7,2023-08-17,굴포천,20722,10053,10669
7,2023-08-17,부평구청,14656,7591,7065
7,2023-08-17,산곡,17008,8930,8078
7,2023-08-17,석남(거북시장),14069,7483,6586
7,2023-08-18,삼산체육관,12393,6645,5748
7,2023-08-18,굴포천,21309,10317,10992
7,2023-08-18,부평구청,14674,7627,7047
7,2023-08-18,산곡,17136,8971,8165
7,2023-08-18,석남(거북시장),14692,7823,6869
7,2023-08-19,삼산체육관,8771,4569,4202
7,2023-08-19,굴포천,14918,7335,7583
7,2023-08-19,부평구청,9776,5187,4589
7,2023-08-19,산곡,10935,5619,5316
7,2023-08-19,석남(거북시장),10431,5507,4924
7,2023-08-20,삼산체육관,5835,3004,2831
7,2023-08-20,굴포천,10586,5184,5402
7,2023-08-20,부평구청,6774,3557,3217
7,2023-08-20,산곡,7588,3859,3729
7,2023-08-20,석남(거북시장),7714,4096,3618
7,2023-08-21,삼산체육관,11827,6213,5614
7,2023-08-21,굴포천,20372,9802,10570
7,2023-08-21,부평구청,14029,7299,6730
7,2023-08-21,산곡,16692,8752,7940
7,2023-08-21,석남(거북시장),14155,7612,6543
7,2023-08-22,삼산체육관,11669,6105,5564
7,2023-08-22,굴포천,20397,10055,10342
7,2023-08-22,부평구청,14001,7200,6801
7,2023-08-22,산곡,16428,8567,7861
7,2023-08-22,석남(거북시장),13635,7311,6324
7,2023-08-23,삼산체육관,11574,6031,5543
7,2023-08-23,굴포천,19737,9563,10174
7,2023-08-23,부평구청,13815,7152,6663
7,2023-08-23,산곡,15995,8325,7670
7,2023-08-23,석남(거북시장),13332,7154,6178
7,2023-08-24,삼산체육관,12169,6325,5844
7,2023-08-24,굴포천,20685,10072,10613
7,2023-08-24,부평구청,14368,7423,6945
7,2023-08-24,산곡,16818,8794,8024
7,2023-08-24,석남(거북시장),13841,7418,6423
7,2023-08-25,삼산체육관,12522,6670,5852
7,2023-08-25,굴포천,21990,10624,11366
7,2023-08-25,부평구청,15297,7881,7416
7,2023-08-25,산곡,17537,9193,8344
7,2023-08-25,석남(거북시장),14917,7903,7014
7,2023-08-26,삼산체육관,8841,4580,4261
7,2023-08-26,굴포천,15953,7850,8103
7,2023-08-26,부평구청,10059,5293,4766
7,2023-08-26,산곡,11270,5895,5375
7,2023-08-26,석남(거북시장),10913,5784,5129
7,2023-08-27,삼산체육관,5978,3119,2859
7,2023-08-27,굴포천,10556,5307,5249
7,2023-08-27,부평구청,7011,3772,3239
7,2023-08-27,산곡,7749,3993,3756
7,2023-08-27,석남(거북시장),7895,4139,3756
7,2023-08-28,삼산체육관,11763,6173,5590
7,2023-08-28,굴포천,20295,9915,10380
7,2023-08-28,부평구청,13876,7183,6693
7,2023-08-28,산곡,16983,8900,8083
7,2023-08-28,석남(거북시장),13577,7302,6275
7,2023-08-29,삼산체육관,11646,6110,5536
7,2023-08-29,굴포천,20262,9920,10342
7,2023-08-29,부평구청,14185,7316,6869
7,2023-08-29,산곡,16721,8744,7977
7,2023-08-29,석남(거북시장),13406,7119,6287
7,2023-08-30,삼산체육관,12614,6516,6098
7,2023-08-30,굴포천,21346,10388,10958
7,2023-08-30,부평구청,14626,7564,7062
7,2023-08-30,산곡,17198,8954,8244
7,2023-08-30,석남(거북시장),14447,7768,6679
7,2023-08-31,삼산체육관,12763,6677,6086
7,2023-08-31,굴포천,21547,10483,11064
7,2023-08-31,부평구청,14741,7714,7027
7,2023-08-31,산곡,17598,9261,8337
7,2023-08-31,석남(거북시장),14531,7746,6785
7,2023-09-01,삼산체육관,12905,6958,5947
7,2023-09-01,굴포천,22090,10745,11345
7,2023-09-01,부평구청,15132,7799,7333
7,2023-09-01,산곡,18087,9458,8629
7,2023-09-01,석남(거북시장),15146,8093,7053
7,2023-09-02,삼산체육관,9378,4891,4487
7,2023-09-02,굴포천,16019,7937,8082
7,2023-09-02,부평구청,9938,5358,4580
7,2023-09-02,산곡,11594,5980,5614
7,2023-09-02,석남(거북시장),11179,5883,5296
7,2023-09-03,삼산체육관,6332,3279,3053
7,2023-09-03,굴포천,11016,5526,5490
7,2023-09-03,부평구청,6965,3689,3276
7,2023-09-03,산곡,7883,4065,3818
7,2023-09-03,석남(거북시장),7911,4313,3598
7,2023-09-04,삼산체육관,12545,6625,5920
7,2023-09-04,굴포천,21423,10459,10964
7,2023-09-04,부평구청,14666,7647,7019
7,2023-09-04,산곡,17862,9395,8467
7,2023-09-04,석남(거북시장),14618,7838,6780
7,2023-09-05,삼산체육관,12829,6686,6143
7,2023-09-05,굴포천,21392,10444,10948
7,2023-09-05,부평구청,15008,7723,7285
7,2023-09-05,산곡,17982,9379,8603
7,2023-09-05,석남(거북시장),14579,7846,6733
7,2023-09-06,삼산체육관,12997,6869,6128
7,2023-09-06,굴포천,21721,10612,11109
7,2023-09-06,부평구청,14906,7716,7190
7,2023-09-06,산곡,18033,9406,8627
7,2023-09-06,석남(거북시장),14978,8052,6926
7,2023-09-07,삼산체육관,13284,7025,6259
7,2023-09-07,굴포천,21867,10709,11158
7,2023-09-07,부평구청,15266,7883,7383
7,2023-09-07,산곡,18062,9413,8649
7,2023-09-07,석남(거북시장),14973,7974,6999
7,2023-09-08,삼산체육관,13135,6877,6258
7,2023-09-08,굴포천,22218,10766,11452
7,2023-09-08,부평구청,15361,8047,7314
7,2023-09-08,산곡,18288,9594,8694
7,2023-09-08,석남(거북시장),15448,8211,7237
7,2023-09-09,삼산체육관,9374,4928,4446
7,2023-09-09,굴포천,16514,8176,8338
7,2023-09-09,부평구청,10286,5498,4788
7,2023-09-09,산곡,11583,6014,5569
7,2023-09-09,석남(거북시장),11488,6103,5385
7,2023-09-10,삼산체육관,6384,3333,3051
7,2023-09-10,굴포천,10754,5387,5367
7,2023-09-10,부평구청,7269,3848,3421
7,2023-09-10,산곡,8014,4102,3912
7,2023-09-10,석남(거북시장),8042,4354,3688
7,2023-09-11,삼산체육관,12693,6651,6042
7,2023-09-11,굴포천,21225,10470,10755
7,2023-09-11,부평구청,14700,7629,7071
7,2023-09-11,산곡,17872,9422,8450
7,2023-09-11,석남(거북시장),15293,8249,7044
7,2023-09-12,삼산체육관,12936,6842,6094
7,2023-09-12,굴포천,21923,10731,11192
7,2023-09-12,부평구청,15355,7884,7471
7,2023-09-12,산곡,18688,9791,8897
7,2023-09-12,석남(거북시장),15039,8039,7000
7,2023-09-13,삼산체육관,12852,6715,6137
7,2023-09-13,굴포천,21525,10496,11029
7,2023-09-13,부평구청,15159,7864,7295
7,2023-09-13,산곡,18079,9454,8625
7,2023-09-13,석남(거북시장),14838,7937,6901
7,2023-09-14,삼산체육관,14364,7519,6845
7,2023-09-14,굴포천,22168,10768,11400
7,2023-09-14,부평구청,15510,7920,7590
7,2023-09-14,산곡,18490,9665,8825
7,2023-09-14,석남(거북시장),15157,8075,7082
7,2023-09-15,삼산체육관,15276,7964,7312
7,2023-09-15,굴포천,22175,10792,11383
7,2023-09-15,부평구청,15317,7926,7391
7,2023-09-15,산곡,18377,9593,8784
7,2023-09-15,석남(거북시장),15822,8344,7478
7,2023-09-16,삼산체육관,15083,7763,7320
7,2023-09-16,굴포천,16272,7985,8287
7,2023-09-16,부평구청,10251,5394,4857
7,2023-09-16,산곡,12227,6233,5994
7,2023-09-16,석남(거북시장),10956,5803,5153
7,2023-09-17,삼산체육관,10751,5562,5189
7,2023-09-17,굴포천,11028,5547,5481
7,2023-09-17,부평구청,7145,3778,3367
7,2023-09-17,산곡,8734,4461,4273
7,2023-09-17,석남(거북시장),7907,4230,3677
7,2023-09-18,삼산체육관,12930,6877,6053
7,2023-09-18,굴포천,21474,10541,10933
7,2023-09-18,부평구청,14929,7762,7167
7,2023-09-18,산곡,18846,9906,8940
7,2023-09-18,석남(거북시장),15215,8214,7001
7,2023-09-19,삼산체육관,13373,6950,6423
7,2023-09-19,굴포천,21540,10559,10981
7,2023-09-19,부평구청,15307,7884,7423
7,2023-09-19,산곡,18428,9740,8688
7,2023-09-19,석남(거북시장),15139,8135,7004
7,2023-09-20,삼산체육관,12762,6742,6020
7,2023-09-20,굴포천,21459,10459,11000
7,2023-09-20,부평구청,15104,7876,7228
7,2023-09-20,산곡,17932,9315,8617
7,2023-09-20,석남(거북시장),14540,7804,6736
7,2023-09-21,삼산체육관,13205,6955,6250
7,2023-09-21,굴포천,21864,10664,11200
7,2023-09-21,부평구청,15360,7954,7406
7,2023-09-21,산곡,18408,9668,8740
7,2023-09-21,석남(거북시장),15234,8166,7068
7,2023-09-22,삼산체육관,13873,7363,6510
7,2023-09-22,굴포천,22854,11086,11768
7,2023-09-22,부평구청,15856,8217,7639
7,2023-09-22,산곡,18706,9811,8895
7,2023-09-22,석남(거북시장),15965,8482,7483
7,2023-09-23,삼산체육관,9422,4916,4506
7,2023-09-23,굴포천,16188,7977,8211
7,2023-09-23,부평구청,10374,5495,4879
7,2023-09-23,산곡,11995,6139,5856
7,2023-09-23,석남(거북시장),11357,5930,5427
7,2023-09-24,삼산체육관,6191,3191,3000
7,2023-09-24,굴포천,10875,5463,5412
7,2023-09-24,부평구청,7543,4019,3524
7,2023-09-24,산곡,8495,4372,4123
7,2023-09-24,석남(거북시장),8219,4425,3794
7,2023-09-25,삼산체육관,13068,6784,6284
7,2023-09-25,굴포천,22076,10808,11268
7,2023-09-25,부평구청,15115,7868,7247
7,2023-09-25,산곡,18507,9764,8743
7,2023-09-25,석남(거북시장),15070,8116,6954
7,2023-09-26,삼산체육관,12391,6544,5847
7,2023-09-26,굴포천,21687,10570,11117
7,2023-09-26,부평구청,15036,7735,7301
7,2023-09-26,산곡,18195,9564,8631
7,2023-09-26,석남(거북시장),14665,7871,6794
7,2023-09-27,삼산체육관,13268,7113,6155
7,2023-09-27,굴포천,22289,10766,11523
7,2023-09-27,부평구청,15241,7915,7326
7,2023-09-27,산곡,18140,9457,8683
7,2023-09-27,석남(거북시장),15479,8156,7323
7,2023-09-28,삼산체육관,4525,2285,2240
7,2023-09-28,굴포천,9346,4554,4792
7,2023-09-28,부평구청,5963,3113,2850
7,2023-09-28,산곡,6596,3267,3329
7,2023-09-28,석남(거북시장),7109,3573,3536
7,2023-09-29,삼산체육관,3900,2051,1849
7,2023-09-29,굴포천,7638,3775,3863
7,2023-09-29,부평구청,5092,2739,2353
7,2023-09-29,산곡,5538,2754,2784
7,2023-09-29,석남(거북시장),6184,3182,3002
7,2023-09-30,삼산체육관,4675,2500,2175
7,2023-09-30,굴포천,9399,4667,4732
7,2023-09-30,부평구청,5900,3202,2698
7,2023-09-30,산곡,6547,3407,3140
7,2023-09-30,석남(거북시장),6980,3682,3298
7,2023-10-01,삼산체육관,5618,2929,2689
7,2023-10-01,굴포천,10650,5263,5387
7,2023-10-01,부평구청,6882,3677,3205
7,2023-10-01,산곡,7694,3926,3768
7,2023-10-01,석남(거북시장),7908,4143,3765
7,2023-10-02,삼산체육관,6733,3596,3137
7,2023-10-02,굴포천,12255,6120,6135
7,2023-10-02,부평구청,8123,4315,3808
7,2023-10-02,산곡,9433,4906,4527
7,2023-10-02,석남(거북시장),8742,4631,4111
7,2023-10-03,삼산체육관,5990,3189,2801
7,2023-10-03,굴포천,10360,5133,5227
7,2023-10-03,부평구청,7075,3772,3303
7,2023-10-03,산곡,8067,4166,3901
7,2023-10-03,석남(거북시장),7886,4260,3626
7,2023-10-04,삼산체육관,12819,6758,6061
7,2023-10-04,굴포천,21561,10468,11093
7,2023-10-04,부평구청,14533,7569,6964
7,2023-10-04,산곡,18503,9608,8895
7,2023-10-04,석남(거북시장),14912,8060,6852
7,2023-10-05,삼산체육관,14038,7384,6654
7,2023-10-05,굴포천,22157,10743,11414
7,2023-10-05,부평구청,14942,7699,7243
7,2023-10-05,산곡,18316,9526,8790
7,2023-10-05,석남(거북시장),14952,8012,6940
7,2023-10-06,삼산체육관,12798,6812,5986
7,2023-10-06,굴포천,22201,10778,11423
7,2023-10-06,부평구청,15537,8006,7531
7,2023-10-06,산곡,19175,9989,9186
7,2023-10-06,석남(거북시장),15605,8282,7323
7,2023-10-07,삼산체육관,9038,4762,4276
7,2023-10-07,굴포천,15769,7843,7926
7,2023-10-07,부평구청,10280,5480,4800
7,2023-10-07,산곡,11858,6202,5656
7,2023-10-07,석남(거북시장),11494,5972,5522
7,2023-10-08,삼산체육관,6551,3340,3211
7,2023-10-08,굴포천,11043,5499,5544
7,2023-10-08,부평구청,7519,3949,3570
7,2023-10-08,산곡,8692,4455,4237
7,2023-10-08,석남(거북시장),8412,4432,3980
7,2023-10-09,삼산체육관,6783,3560,3223
7,2023-10-09,굴포천,11109,5502,5607
7,2023-10-09,부평구청,7442,3879,3563
7,2023-10-09,산곡,8684,4435,4249
7,2023-10-09,석남(거북시장),8191,4324,3867
7,2023-10-10,삼산체육관,12946,6806,6140
7,2023-10-10,굴포천,21462,10603,10859
7,2023-10-10,부평구청,15594,8110,7484
7,2023-10-10,산곡,18930,9914,9016
7,2023-10-10,석남(거북시장),15194,8120,7074
7,2023-10-11,삼산체육관,13103,6930,6173
7,2023-10-11,굴포천,22053,10660,11393
7,2023-10-11,부평구청,15540,8102,7438
7,2023-10-11,산곡,18940,9894,9046
7,2023-10-11,석남(거북시장),15398,8279,7119
7,2023-10-12,삼산체육관,13200,6916,6284
7,2023-10-12,굴포천,21837,10650,11187
7,2023-10-12,부평구청,15418,7991,7427
7,2023-10-12,산곡,18780,9771,9009
7,2023-10-12,석남(거북시장),15048,7984,7064
7,2023-10-13,삼산체육관,13489,7232,6257
7,2023-10-13,굴포천,22559,10950,11609
7,2023-10-13,부평구청,15540,7987,7553
7,2023-10-13,산곡,18919,9956,8963
7,2023-10-13,석남(거북시장),15812,8383,7429
7,2023-10-14,삼산체육관,8761,4530,4231
7,2023-10-14,굴포천,15639,7693,7946
7,2023-10-14,부평구청,9692,5155,4537
7,2023-10-14,산곡,11628,5951,5677
7,2023-10-14,석남(거북시장),10928,5741,5187
7,2023-10-15,삼산체육관,7175,3627,3548
7,2023-10-15,굴포천,11314,5663,5651
7,2023-10-15,부평구청,7718,4194,3524
7,2023-10-15,산곡,9147,4688,4459
7,2023-10-15,석남(거북시장),8758,4688,4070
7,2023-10-16,삼산체육관,12652,6709,5943
7,2023-10-16,굴포천,21215,10479,10736
7,2023-10-16,부평구청,14957,7698,7259
7,2023-10-16,산곡,18757,9820,8937
7,2023-10-16,석남(거북시장),15329,8210,7119
7,2023-10-17,삼산체육관,13191,6944,6247
7,2023-10-17,굴포천,21847,10760,11087
7,2023-10-17,부평구청,15059,7729,7330
7,2023-10-17,산곡,18766,9788,8978
7,2023-10-17,석남(거북시장),15459,8332,7127
7,2023-10-18,삼산체육관,13418,7051,6367
7,2023-10-18,굴포천,21898,10616,11282
7,2023-10-18,부평구청,15425,7840,7585
7,2023-10-18,산곡,19109,10000,9109
7,2023-10-18,석남(거북시장),15177,8148,7029
7,2023-10-19,삼산체육관,12745,6758,5987
7,2023-10-19,굴포천,21217,10348,10869
7,2023-10-19,부평구청,15189,7819,7370
7,2023-10-19,산곡,18216,9472,8744
7,2023-10-19,석남(거북시장),14975,7996,6979
7,2023-10-20,삼산체육관,13634,7138,6496
7,2023-10-20,굴포천,22577,10963,11614
7,2023-10-20,부평구청,15675,8162,7513
7,2023-10-20,산곡,19113,9924,9189
7,2023-10-20,석남(거북시장),15930,8459,7471
7,2023-10-21,삼산체육관,10656,5537,5119
7,2023-10-21,굴포천,15958,7914,8044
7,2023-10-21,부평구청,10403,5553,4850
7,2023-10-21,산곡,12360,6382,5978
7,2023-10-21,석남(거북시장),11471,6050,5421
7,2023-10-22,삼산체육관,10188,5203,4985
7,2023-10-22,굴포천,11749,5813,5936
7,2023-10-22,부평구청,7522,4013,3509
7,2023-10-22,산곡,8574,4386,4188
7,2023-10-22,석남(거북시장),8492,4559,3933
7,2023-10-23,삼산체육관,12848,6915,5933
7,2023-10-23,굴포천,21253,10404,10849
7,2023-10-23,부평구청,15137,7812,7325
7,2023-10-23,산곡,18491,9668,8823
7,2023-10-23,석남(거북시장),15124,8194,6930
7,2023-10-24,삼산체육관,13095,6860,6235
7,2023-10-24,굴포천,21433,10508,10925
7,2023-10-24,부평구청,15295,7858,7437
7,2023-10-24,산곡,18605,9699,8906
7,2023-10-24,석남(거북시장),15043,8033,7010
7,2023-10-25,삼산체육관,13284,7018,6266
7,2023-10-25,굴포천,21834,10715,11119
7,2023-10-25,부평구청,15357,7975,7382
7,2023-10-25,산곡,18801,9769,9032
7,2023-10-25,석남(거북시장),15286,8203,7083
7,2023-10-26,삼산체육관,14853,7775,7078
7,2023-10-26,굴포천,21662,10537,11125
7,2023-10-26,부평구청,15411,8008,7403
7,2023-10-26,산곡,18547,9654,8893
7,2023-10-26,석남(거북시장),15045,8077,6968
7,2023-10-27,삼산체육관,13038,6945,6093
7,2023-10-27,굴포천,22063,10729,11334
7,2023-10-27,부평구청,15610,8089,7521
7,2023-10-27,산곡,19178,9990,9188
7,2023-10-27,석남(거북시장),15761,8360,7401
7,2023-10-28,삼산체육관,9598,5034,4564
7,2023-10-28,굴포천,16234,8018,8216
7,2023-10-28,부평구청,10368,5478,4890
7,2023-10-28,산곡,12365,6405,5960
7,2023-10-28,석남(거북시장),11792,6217,5575
7,2023-10-29,삼산체육관,6832,3526,3306
7,2023-10-29,굴포천,11402,5665,5737
7,2023-10-29,부평구청,7551,4044,3507
7,2023-10-29,산곡,8590,4399,4191
7,2023-10-29,석남(거북시장),8568,4590,3978
7,2023-10-30,삼산체육관,12565,6657,5908
7,2023-10-30,굴포천,21156,10360,10796
7,2023-10-30,부평구청,15141,7885,7256
7,2023-10-30,산곡,18250,9509,8741
7,2023-10-30,석남(거북시장),15032,8128,6904
7,2023-10-31,삼산체육관,13028,6785,6243
7,2023-10-31,굴포천,21591,10555,11036
7,2023-10-31,부평구청,15045,7741,7304
7,2023-10-31,산곡,18627,9732,8895
7,2023-10-31,석남(거북시장),14968,8025,6943
7,2023-11-01,삼산체육관,12653,6751,5902
7,2023-11-01,굴포천,21193,10301,10892
7,2023-11-01,부평구청,14905,7676,7229
7,2023-11-01,산곡,18557,9702,8855
7,2023-11-01,석남(거북시장),14897,7967,6930
7,2023-11-02,삼산체육관,13601,7177,6424
7,2023-11-02,굴포천,21754,10530,11224
7,2023-11-02,부평구청,15308,7921,7387
7,2023-11-02,산곡,18914,9830,9084
7,2023-11-02,석남(거북시장),15228,8111,7117
7,2023-11-03,삼산체육관,13277,7074,6203
7,2023-11-03,굴포천,21548,10427,11121
7,2023-11-03,부평구청,14990,7718,7272
7,2023-11-03,산곡,18710,9772,8938
7,2023-11-03,석남(거북시장),15444,8177,7267
7,2023-11-04,삼산체육관,12019,6076,5943
7,2023-11-04,굴포천,16685,8258,8427
7,2023-11-04,부평구청,9913,5245,4668
7,2023-11-04,산곡,12339,6406,5933
7,2023-11-04,석남(거북시장),11385,5899,5486
7,2023-11-05,삼산체육관,6199,3228,2971
7,2023-11-05,굴포천,10564,5231,5333
7,2023-11-05,부평구청,6705,3560,3145
7,2023-11-05,산곡,7917,3999,3918
7,2023-11-05,석남(거북시장),7465,4057,3408
7,2023-11-06,삼산체육관,12014,6344,5670
7,2023-11-06,굴포천,20720,10163,10557
7,2023-11-06,부평구청,14375,7453,6922
7,2023-11-06,산곡,18037,9485,8552
7,2023-11-06,석남(거북시장),14377,7799,6578
7,2023-11-07,삼산체육관,12926,6803,6123
7,2023-11-07,굴포천,21368,10502,10866
7,2023-11-07,부평구청,14953,7651,7302
7,2023-11-07,산곡,18863,9854,9009
7,2023-11-07,석남(거북시장),14971,7939,7032
7,2023-11-08,삼산체육관,13148,6879,6269
7,2023-11-08,굴포천,21619,10559,11060
7,2023-11-08,부평구청,15129,7763,7366
7,2023-11-08,산곡,18963,9880,9083
7,2023-11-08,석남(거북시장),15010,8080,6930
7,2023-11-09,삼산체육관,13029,6812,6217
7,2023-11-09,굴포천,21233,10432,10801
7,2023-11-09,부평구청,15011,7690,7321
7,2023-11-09,산곡,18934,9876,9058
7,2023-11-09,석남(거북시장),14810,7965,6845
7,2023-11-10,삼산체육관,12664,6649,6015
7,2023-11-10,굴포천,22417,10845,11572
7,2023-11-10,부평구청,15141,7890,7251
7,2023-11-10,산곡,18901,9931,8970
7,2023-11-10,석남(거북시장),15405,8142,7263
7,2023-11-11,삼산체육관,8838,4564,4274
7,2023-11-11,굴포천,15797,7738,8059
7,2023-11-11,부평구청,9895,5318,4577
7,2023-11-11,산곡,11867,6077,5790
7,2023-11-11,석남(거북시장),11200,5919,5281
7,2023-11-12,삼산체육관,8873,4434,4439
7,2023-11-12,굴포천,11256,5716,5540
7,2023-11-12,부평구청,7135,3792,3343
7,2023-11-12,산곡,8178,4110,4068
7,2023-11-12,석남(거북시장),8251,4371,3880
7,2023-11-13,삼산체육관,12378,6441,5937
7,2023-11-13,굴포천,20665,10100,10565
7,2023-11-13,부평구청,14727,7648,7079
7,2023-11-13,산곡,18484,9664,8820
7,2023-11-13,석남(거북시장),14726,7996,6730
7,2023-11-14,삼산체육관,12728,6704,6024
7,2023-11-14,굴포천,21378,10510,10868
7,2023-11-14,부평구청,14921,7726,7195
7,2023-11-14,산곡,19243,10011,9232
7,2023-11-14,석남(거북시장),14693,7831,6862
7,2023-11-15,삼산체육관,13083,6921,6162
7,2023-11-15,굴포천,21885,10699,11186
7,2023-11-15,부평구청,15261,7900,7361
7,2023-11-15,산곡,19722,10250,9472
7,2023-11-15,석남(거북시장),15210,8135,7075
7,2023-11-16,삼산체육관,12121,6385,5736
7,2023-11-16,굴포천,20534,9985,10549
7,2023-11-16,부평구청,14417,7440,6977
7,2023-11-16,산곡,17959,9321,8638
7,2023-11-16,석남(거북시장),13993,7470,6523
7,2023-11-17,삼산체육관,15472,7954,7518
7,2023-11-17,굴포천,22304,10852,11452
7,2023-11-17,부평구청,15078,7945,7133
7,2023-11-17,산곡,19493,10212,9281
7,2023-11-17,석남(거북시장),15258,8092,7166
7,2023-11-18,삼산체육관,8702,4503,4199
7,2023-11-18,굴포천,15443,7639,7804
7,2023-11-18,부평구청,9926,5329,4597
7,2023-11-18,산곡,11670,6063,5607
7,2023-11-18,석남(거북시장),10872,5753,5119
7,2023-11-19,삼산체육관,6555,3358,3197
7,2023-11-19,굴포천,11195,5561,5634
7,2023-11-19,부평구청,7316,3847,3469
7,2023-11-19,산곡,8641,4422,4219
7,2023-11-19,석남(거북시장),8098,4302,3796
7,2023-11-20,삼산체육관,12365,6600,5765
7,2023-11-20,굴포천,20749,10128,10621
7,2023-11-20,부평구청,14524,7525,6999
7,2023-11-20,산곡,19020,9924,9096
7,2023-11-20,석남(거북시장),14961,8143,6818
7,2023-11-21,삼산체육관,13033,6894,6139
7,2023-11-21,굴포천,21266,10381,10885
7,2023-11-21,부평구청,15472,8023,7449
7,2023-11-21,산곡,19738,10286,9452
7,2023-11-21,석남(거북시장),14985,7985,7000
7,2023-11-22,삼산체육관,12853,6824,6029
7,2023-11-22,굴포천,21714,10522,11192
7,2023-11-22,부평구청,14958,7734,7224
7,2023-11-22,산곡,19617,10195,9422
7,2023-11-22,석남(거북시장),15431,8258,7173
7,2023-11-23,삼산체육관,13097,6858,6239
7,2023-11-23,굴포천,21522,10474,11048
7,2023-11-23,부평구청,15043,7812,7231
7,2023-11-23,산곡,19568,10127,9441
7,2023-11-23,석남(거북시장),15079,8127,6952
7,2023-11-24,삼산체육관,13223,6857,6366
7,2023-11-24,굴포천,21783,10613,11170
7,2023-11-24,부평구청,15011,7755,7256
7,2023-11-24,산곡,18946,9915,9031
7,2023-11-24,석남(거북시장),15521,8251,7270
7,2023-11-25,삼산체육관,11330,5803,5527
7,2023-11-25,굴포천,16475,8137,8338
7,2023-11-25,부평구청,9823,5195,4628
7,2023-11-25,산곡,11739,6025,5714
7,2023-11-25,석남(거북시장),11127,5846,5281
7,2023-11-26,삼산체육관,6030,3126,2904
7,2023-11-26,굴포천,10602,5305,5297
7,2023-11-26,부평구청,7075,3775,3300
7,2023-11-26,산곡,8467,4341,4126
7,2023-11-26,석남(거북시장),8196,4355,3841
7,2023-11-27,삼산체육관,12393,6546,5847
7,2023-11-27,굴포천,20850,10218,10632
7,2023-11-27,부평구청,14393,7407,6986
7,2023-11-27,산곡,19036,10015,9021
7,2023-11-27,석남(거북시장),14603,7854,6749
7,2023-11-28,삼산체육관,13126,6879,6247
7,2023-11-28,굴포천,21439,10488,10951
7,2023-11-28,부평구청,15514,8014,7500
7,2023-11-28,산곡,20028,10422,9606
7,2023-11-28,석남(거북시장),14988,8061,6927
7,2023-11-29,삼산체육관,12729,6690,6039
7,2023-11-29,굴포천,21510,10508,11002
7,2023-11-29,부평구청,14938,7708,7230
7,2023-11-29,산곡,19755,10247,9508
7,2023-11-29,석남(거북시장),14899,7969,6930
7,2023-11-30,삼산체육관,12793,6699,6094
7,2023-11-30,굴포천,20972,10274,10698
7,2023-11-30,부평구청,14774,7744,7030
7,2023-11-30,산곡,19483,10141,9342
7,2023-11-30,석남(거북시장),14605,7805,6800
7,2023-12-01,삼산체육관,12438,6533,5905
7,2023-12-01,굴포천,21908,10673,11235
7,2023-12-01,부평구청,15193,7872,7321
7,2023-12-01,산곡,19826,10349,9477
7,2023-12-01,석남(거북시장),15140,7980,7160
7,2023-12-02,삼산체육관,8699,4499,4200
7,2023-12-02,굴포천,16140,7943,8197
7,2023-12-02,부평구청,9951,5313,4638
7,2023-12-02,산곡,12264,6354,5910
7,2023-12-02,석남(거북시장),11337,5942,5395
7,2023-12-03,삼산체육관,6538,3420,3118
7,2023-12-03,굴포천,10949,5496,5453
7,2023-12-03,부평구청,7312,3906,3406
7,2023-12-03,산곡,8863,4544,4319
7,2023-12-03,석남(거북시장),8138,4385,3753
7,2023-12-04,삼산체육관,12321,6592,5729
7,2023-12-04,굴포천,20900,10187,10713
7,2023-12-04,부평구청,14610,7617,6993
7,2023-12-04,산곡,19625,10209,9416
7,2023-12-04,석남(거북시장),14788,8018,6770
7,2023-12-05,삼산체육관,14768,7743,7025
7,2023-12-05,굴포천,22362,10929,11433
7,2023-12-05,부평구청,15384,7919,7465
7,2023-12-05,산곡,20419,10624,9795
7,2023-12-05,석남(거북시장),15043,8056,6987
7,2023-12-06,삼산체육관,12657,6669,5988
7,2023-12-06,굴포천,21733,10583,11150
7,2023-12-06,부평구청,14852,7661,7191
7,2023-12-06,산곡,20055,10419,9636
7,2023-12-06,석남(거북시장),14688,7816,6872
7,2023-12-07,삼산체육관,13162,6952,6210
7,2023-12-07,굴포천,21978,10754,11224
7,2023-12-07,부평구청,15293,7916,7377
7,2023-12-07,산곡,20515,10640,9875
7,2023-12-07,석남(거북시장),14926,8046,6880
7,2023-12-08,삼산체육관,13218,7047,6171
7,2023-12-08,굴포천,22915,11285,11630
7,2023-12-08,부평구청,15529,8110,7419
7,2023-12-08,산곡,20445,10641,9804
7,2023-12-08,석남(거북시장),15605,8275,7330
7,2023-12-09,삼산체육관,12059,6194,5865
7,2023-12-09,굴포천,17224,8482,8742
7,2023-12-09,부평구청,10614,5648,4966
7,2023-12-09,산곡,13534,7072,6462
7,2023-12-09,석남(거북시장),11874,6284,5590
7,2023-12-10,삼산체육관,6470,3341,3129
7,2023-12-10,굴포천,11154,5592,5562
7,2023-12-10,부평구청,7280,3839,3441
7,2023-12-10,산곡,9178,4690,4488
7,2023-12-10,석남(거북시장),8422,4523,3899
7,2023-12-11,삼산체육관,11790,6224,5566
7,2023-12-11,굴포천,20787,10047,10740
7,2023-12-11,부평구청,14289,7418,6871
7,2023-12-11,산곡,19454,10151,9303
7,2023-12-11,석남(거북시장),14183,7600,6583
7,2023-12-12,삼산체육관,12998,6834,6164
7,2023-12-12,굴포천,21463,10483,10980
7,2023-12-12,부평구청,14960,7786,7174
7,2023-12-12,산곡,20601,10731,9870
7,2023-12-12,석남(거북시장),14997,8078,6919
7,2023-12-13,삼산체육관,13306,6997,6309
7,2023-12-13,굴포천,21728,10535,11193
7,2023-12-13,부평구청,15335,7970,7365
7,2023-12-13,산곡,20946,10959,9987
7,2023-12-13,석남(거북시장),15237,8143,7094
7,2023-12-14,삼산체육관,15324,7889,7435
7,2023-12-14,굴포천,21497,10501,10996
7,2023-12-14,부평구청,14739,7632,7107
7,2023-12-14,산곡,19991,10381,9610
7,2023-12-14,석남(거북시장),14460,7755,6705
7,2023-12-15,삼산체육관,12344,6574,5770
7,2023-12-15,굴포천,21714,10527,11187
7,2023-12-15,부평구청,14690,7650,7040
7,2023-12-15,산곡,19854,10369,9485
7,2023-12-15,석남(거북시장),14979,7919,7060
7,2023-12-16,삼산체육관,8961,4666,4295
7,2023-12-16,굴포천,17304,8407,8897
7,2023-12-16,부평구청,10559,5653,4906
7,2023-12-16,산곡,13836,7085,6751
7,2023-12-16,석남(거북시장),12241,6429,5812
7,2023-12-17,삼산체육관,6053,3096,2957
7,2023-12-17,굴포천,11550,5776,5774
7,2023-12-17,부평구청,6894,3629,3265
7,2023-12-17,산곡,8742,4381,4361
7,2023-12-17,석남(거북시장),7996,4240,3756
7,2023-12-18,삼산체육관,12010,6303,5707
7,2023-12-18,굴포천,20457,10078,10379
7,2023-12-18,부평구청,13953,7238,6715
7,2023-12-18,산곡,19492,10149,9343
7,2023-12-18,석남(거북시장),14085,7551,6534
7,2023-12-19,삼산체육관,12787,6732,6055
7,2023-12-19,굴포천,21749,10608,11141
7,2023-12-19,부평구청,14854,7685,7169
7,2023-12-19,산곡,20516,10640,9876
7,2023-12-19,석남(거북시장),14729,7864,6865
7,2023-12-20,삼산체육관,15646,8155,7491
7,2023-12-20,굴포천,22626,11104,11522
7,2023-12-20,부평구청,15120,7784,7336
7,2023-12-20,산곡,20865,10857,10008
7,2023-12-20,석남(거북시장),15081,8014,7067
7,2023-12-21,삼산체육관,12729,6748,5981
7,2023-12-21,굴포천,20925,10301,10624
7,2023-12-21,부평구청,14193,7350,6843
7,2023-12-21,산곡,19439,10217,9222
7,2023-12-21,석남(거북시장),13881,7356,6525
7,2023-12-22,삼산체육관,12156,6443,5713
7,2023-12-22,굴포천,21737,10622,11115
7,2023-12-22,부평구청,14360,7499,6861
7,2023-12-22,산곡,19627,10153,9474
7,2023-12-22,석남(거북시장),14881,7880,7001
7,2023-12-23,삼산체육관,8375,4389,3986
7,2023-12-23,굴포천,15126,7381,7745
7,2023-12-23,부평구청,9586,5097,4489
7,2023-12-23,산곡,12587,6465,6122
7,2023-12-23,석남(거북시장),10913,5764,5149
7,2023-12-24,삼산체육관,10532,5375,5157
7,2023-12-24,굴포천,12551,6309,6242
7,2023-12-24,부평구청,7693,4101,3592
7,2023-12-24,산곡,10022,5194,4828
7,2023-12-24,석남(거북시장),8954,4712,4242
7,2023-12-25,삼산체육관,6447,3420,3027
7,2023-12-25,굴포천,11602,5791,5811
7,2023-12-25,부평구청,7056,3748,3308
7,2023-12-25,산곡,9726,4957,4769
7,2023-12-25,석남(거북시장),8511,4546,3965
7,2023-12-26,삼산체육관,12432,6558,5874
7,2023-12-26,굴포천,20536,10018,10518
7,2023-12-26,부평구청,14111,7276,6835
7,2023-12-26,산곡,19952,10304,9648
7,2023-12-26,석남(거북시장),14330,7692,6638
7,2023-12-27,삼산체육관,13095,6891,6204
7,2023-12-27,굴포천,21292,10494,10798
7,2023-12-27,부평구청,14345,7394,6951
7,2023-12-27,산곡,20454,10636,9818
7,2023-12-27,석남(거북시장),14895,7909,6986
7,2023-12-28,삼산체육관,12426,6540,5886
7,2023-12-28,굴포천,20864,10344,10520
7,2023-12-28,부평구청,14239,7455,6784
7,2023-12-28,산곡,19989,10405,9584
7,2023-12-28,석남(거북시장),14191,7526,6665
7,2023-12-29,삼산체육관,11887,6289,5598
7,2023-12-29,굴포천,21002,10179,10823
7,2023-12-29,부평구청,14037,7346,6691
7,2023-12-29,산곡,19674,10225,9449
7,2023-12-29,석남(거북시장),14709,7793,6916
7,2023-12-30,삼산체육관,7501,3913,3588
7,2023-12-30,굴포천,14753,7265,7488
7,2023-12-30,부평구청,8810,4637,4173
7,2023-12-30,산곡,12586,6393,6193
7,2023-12-30,석남(거북시장),9945,5152,4793
7,2023-12-31,삼산체육관,8585,4395,4190
7,2023-12-31,굴포천,11235,5598,5637
7,2023-12-31,부평구청,6787,3582,3205
7,2023-12-31,산곡,8997,4643,4354
7,2023-12-31,석남(거북시장),8143,4326,3817
7,2024-01-01,삼산체육관,4377,2289,2088
7,2024-01-01,굴포천,8440,4231,4209
7,2024-01-01,부평구청,5324,2816,2508
7,2024-01-01,산곡,6845,3494,3351
7,2024-01-01,석남(거북시장),6490,3435,3055
7,2024-01-02,삼산체육관,11896,6279,5617
7,2024-01-02,굴포천,19769,9648,10121
7,2024-01-02,부평구청,14001,7263,6738
7,2024-01-02,산곡,19910,10357,9553
7,2024-01-02,석남(거북시장),13638,7305,6333
7,2024-01-03,삼산체육관,12217,6453,5764
7,2024-01-03,굴포천,20663,10035,10628
7,2024-01-03,부평구청,14059,7263,6796
7,2024-01-03,산곡,20356,10520,9836
7,2024-01-03,석남(거북시장),14096,7536,6560
7,2024-01-04,삼산체육관,13053,6867,6186
7,2024-01-04,굴포천,20691,10091,10600
7,2024-01-04,부평구청,14540,7454,7086
7,2024-01-04,산곡,20556,10697,9859
7,2024-01-04,석남(거북시장),14257,7644,6613
7,2024-01-05,삼산체육관,12640,6656,5984
7,2024-01-05,굴포천,21818,10665,11153
7,2024-01-05,부평구청,14803,7645,7158
7,2024-01-05,산곡,21092,10903,10189
7,2024-01-05,석남(거북시장),15124,8045,7079
7,2024-01-06,삼산체육관,8164,4233,3931
7,2024-01-06,굴포천,15306,7488,7818
7,2024-01-06,부평구청,9490,5004,4486
7,2024-01-06,산곡,13215,6764,6451
7,2024-01-06,석남(거북시장),11291,5929,5362
7,2024-01-07,삼산체육관,5716,2924,2792
7,2024-01-07,굴포천,10177,5026,5151
7,2024-01-07,부평구청,6708,3514,3194
7,2024-01-07,산곡,8816,4473,4343
7,2024-01-07,석남(거북시장),7827,4118,3709
7,2024-01-08,삼산체육관,11633,6113,5520
7,2024-01-08,굴포천,20543,10049,10494
7,2024-01-08,부평구청,14192,7394,6798
7,2024-01-08,산곡,20183,10505,9678
7,2024-01-08,석남(거북시장),14030,7482,6548
7,2024-01-09,삼산체육관,12554,6611,5943
7,2024-01-09,굴포천,22145,10791,11354
7,2024-01-09,부평구청,15064,7772,7292
7,2024-01-09,산곡,21429,11137,10292
7,2024-01-09,석남(거북시장),14574,7766,6808
7,2024-01-10,삼산체육관,12520,6573,5947
7,2024-01-10,굴포천,21829,10679,11150
7,2024-01-10,부평구청,15057,7834,7223
7,2024-01-10,산곡,21102,10926,10176
7,2024-01-10,석남(거북시장),14615,7787,6828
7,2024-01-11,삼산체육관,12820,6751,6069
7,2024-01-11,굴포천,21529,10596,10933
7,2024-01-11,부평구청,14946,7701,7245
7,2024-01-11,산곡,20977,10968,10009
7,2024-01-11,석남(거북시장),14374,7650,6724
7,2024-01-12,삼산체육관,15379,8042,7337
7,2024-01-12,굴포천,23069,11165,11904
7,2024-01-12,부평구청,15159,7795,7364
7,2024-01-12,산곡,21631,11318,10313
7,2024-01-12,석남(거북시장),15206,8065,7141
7,2024-01-13,삼산체육관,8755,4573,4182
7,2024-01-13,굴포천,15361,7544,7817
7,2024-01-13,부평구청,10076,5299,4777
7,2024-01-13,산곡,13658,6996,6662
7,2024-01-13,석남(거북시장),11241,5949,5292
7,2024-01-14,삼산체육관,5673,2984,2689
7,2024-01-14,굴포천,9740,4885,4855
7,2024-01-14,부평구청,6654,3494,3160
7,2024-01-14,산곡,8423,4229,4194
7,2024-01-14,석남(거북시장),7602,4048,3554
7,2024-01-15,삼산체육관,11841,6215,5626
7,2024-01-15,굴포천,20311,9978,10333
7,2024-01-15,부평구청,14017,7284,6733
7,2024-01-15,산곡,20582,10699,9883
7,2024-01-15,석남(거북시장),14227,7665,6562
7,2024-01-16,삼산체육관,12366,6577,5789
7,2024-01-16,굴포천,21207,10306,10901
7,2024-01-16,부평구청,14640,7609,7031
7,2024-01-16,산곡,20837,10863,9974
7,2024-01-16,석남(거북시장),14309,7670,6639
7,2024-01-17,삼산체육관,12313,6409,5904
7,2024-01-17,굴포천,21222,10430,10792
7,2024-01-17,부평구청,14350,7360,6990
7,2024-01-17,산곡,20816,10805,10011
7,2024-01-17,석남(거북시장),14318,7688,6630
7,2024-01-18,삼산체육관,12561,6618,5943
7,2024-01-18,굴포천,21204,10363,10841
7,2024-01-18,부평구청,14650,7572,7078
7,2024-01-18,산곡,21147,11027,10120
7,2024-01-18,석남(거북시장),14478,7748,6730
7,2024-01-19,삼산체육관,12487,6596,5891
7,2024-01-19,굴포천,22024,10721,11303
7,2024-01-19,부평구청,15307,7879,7428
7,2024-01-19,산곡,21533,11252,10281
7,2024-01-19,석남(거북시장),14960,7972,6988
7,2024-01-20,삼산체육관,8447,4425,4022
7,2024-01-20,굴포천,15286,7472,7814
7,2024-01-20,부평구청,9807,5210,4597
7,2024-01-20,산곡,13275,6738,6537
7,2024-01-20,석남(거북시장),10996,5719,5277
7,2024-01-21,삼산체육관,5858,2991,2867
7,2024-01-21,굴포천,10344,5155,5189
7,2024-01-21,부평구청,6983,3671,3312
7,2024-01-21,산곡,8964,4497,4467
7,2024-01-21,석남(거북시장),8145,4374,3771
7,2024-01-22,삼산체육관,11300,5946,5354
7,2024-01-22,굴포천,20674,10066,10608
7,2024-01-22,부평구청,13875,7160,6715
7,2024-01-22,산곡,20314,10535,9779
7,2024-01-22,석남(거북시장),13537,7302,6235
7,2024-01-23,삼산체육관,11287,5878,5409
7,2024-01-23,굴포천,20300,9977,10323
7,2024-01-23,부평구청,13431,6910,6521
7,2024-01-23,산곡,19569,10138,9431
7,2024-01-23,석남(거북시장),12991,6950,6041
7,2024-01-24,삼산체육관,12061,6328,5733
7,2024-01-24,굴포천,21024,10282,10742
7,2024-01-24,부평구청,14060,7220,6840
7,2024-01-24,산곡,20212,10493,9719
7,2024-01-24,석남(거북시장),13482,7254,6228
7,2024-01-25,삼산체육관,12121,6370,5751
7,2024-01-25,굴포천,21334,10442,10892
7,2024-01-25,부평구청,14530,7545,6985
7,2024-01-25,산곡,20879,10866,10013
7,2024-01-25,석남(거북시장),13943,7538,6405
7,2024-01-26,삼산체육관,12170,6443,5727
7,2024-01-26,굴포천,21989,10681,11308
7,2024-01-26,부평구청,14718,7619,7099
7,2024-01-26,산곡,21406,11129,10277
7,2024-01-26,석남(거북시장),14851,7898,6953
7,2024-01-27,삼산체육관,13231,6762,6469
7,2024-01-27,굴포천,16486,8122,8364
7,2024-01-27,부평구청,9749,5126,4623
7,2024-01-27,산곡,13406,6860,6546
7,2024-01-27,석남(거북시장),10901,5710,5191
7,2024-01-28,삼산체육관,5815,2977,2838
7,2024-01-28,굴포천,10208,5117,5091
7,2024-01-28,부평구청,6701,3490,3211
7,2024-01-28,산곡,8948,4550,4398
7,2024-01-28,석남(거북시장),8086,4281,3805
7,2024-01-29,삼산체육관,11739,6206,5533
7,2024-01-29,굴포천,20738,10208,10530
7,2024-01-29,부평구청,14189,7320,6869
7,2024-01-29,산곡,21173,10955,10218
7,2024-01-29,석남(거북시장),14060,7559,6501
7,2024-01-30,삼산체육관,12159,6413,5746
7,2024-01-30,굴포천,21194,10293,10901
7,2024-01-30,부평구청,14607,7549,7058
7,2024-01-30,산곡,21598,11201,10397
7,2024-01-30,석남(거북시장),14324,7695,6629
7,2024-01-31,삼산체육관,12140,6407,5733
7,2024-01-31,굴포천,21335,10423,10912
7,2024-01-31,부평구청,14117,7209,6908
7,2024-01-31,산곡,21556,11195,10361
7,2024-01-31,석남(거북시장),14416,7725,6691
7,2024-02-01,삼산체육관,12354,6488,5866
7,2024-02-01,굴포천,20954,10339,10615
7,2024-02-01,부평구청,14755,7579,7176
7,2024-02-01,산곡,21474,11174,10300
7,2024-02-01,석남(거북시장),14361,7630,6731
7,2024-02-02,삼산체육관,12247,6478,5769
7,2024-02-02,굴포천,21611,10536,11075
7,2024-02-02,부평구청,14697,7648,7049
7,2024-02-02,산곡,21679,11275,10404
7,2024-02-02,석남(거북시장),15249,8025,7224
7,2024-02-03,삼산체육관,8008,4174,3834
7,2024-02-03,굴포천,14703,7277,7426
7,2024-02-03,부평구청,9275,4905,4370
7,2024-02-03,산곡,13284,6816,6468
7,2024-02-03,석남(거북시장),10858,5680,5178
7,2024-02-04,삼산체육관,6063,3161,2902
7,2024-02-04,굴포천,10527,5178,5349
7,2024-02-04,부평구청,6895,3637,3258
7,2024-02-04,산곡,9438,4766,4672
7,2024-02-04,석남(거북시장),7966,4268,3698
7,2024-02-05,삼산체육관,11741,6112,5629
7,2024-02-05,굴포천,20377,9949,10428
7,2024-02-05,부평구청,14075,7322,6753
7,2024-02-05,산곡,20819,10815,10004
7,2024-02-05,석남(거북시장),13701,7363,6338
7,2024-02-06,삼산체육관,12598,6669,5929
7,2024-02-06,굴포천,21397,10451,10946
7,2024-02-06,부평구청,15052,7830,7222
7,2024-02-06,산곡,21654,11281,10373
7,2024-02-06,석남(거북시장),14371,7709,6662
7,2024-02-07,삼산체육관,12402,6558,5844
7,2024-02-07,굴포천,21089,10333,10756
7,2024-02-07,부평구청,14531,7584,6947
7,2024-02-07,산곡,21395,11163,10232
7,2024-02-07,석남(거북시장),14604,7771,6833
7,2024-02-08,삼산체육관,14786,7646,7140
7,2024-02-08,굴포천,21225,10357,10868
7,2024-02-08,부평구청,14196,7404,6792
7,2024-02-08,산곡,20461,10657,9804
7,2024-02-08,석남(거북시장),14563,7715,6848
7,2024-02-09,삼산체육관,4512,2279,2233
7,2024-02-09,굴포천,8878,4332,4546
7,2024-02-09,부평구청,5693,2961,2732
7,2024-02-09,산곡,7419,3718,3701
7,2024-02-09,석남(거북시장),7269,3746,3523
7,2024-02-10,삼산체육관,3983,2065,1918
7,2024-02-10,굴포천,7900,3871,4029
7,2024-02-10,부평구청,4977,2618,2359
7,2024-02-10,산곡,6663,3333,3330
7,2024-02-10,석남(거북시장),7104,3693,3411
7,2024-02-11,삼산체육관,5190,2736,2454
7,2024-02-11,굴포천,9573,4717,4856
7,2024-02-11,부평구청,5945,3183,2762
7,2024-02-11,산곡,8133,4144,3989
7,2024-02-11,석남(거북시장),7870,4119,3751
7,2024-02-12,삼산체육관,5669,3039,2630
7,2024-02-12,굴포천,10265,5115,5150
7,2024-02-12,부평구청,6734,3541,3193
7,2024-02-12,산곡,8858,4610,4248
7,2024-02-12,석남(거북시장),7460,3973,3487
7,2024-02-13,삼산체육관,11856,6245,5611
7,2024-02-13,굴포천,20008,9848,10160
7,2024-02-13,부평구청,13897,7185,6712
7,2024-02-13,산곡,20524,10589,9935
7,2024-02-13,석남(거북시장),14043,7512,6531
7,2024-02-14,삼산체육관,13003,6839,6164
7,2024-02-14,굴포천,21497,10471,11026
7,2024-02-14,부평구청,14644,7685,6959
7,2024-02-14,산곡,22011,11391,10620
7,2024-02-14,석남(거북시장),14800,7923,6877
7,2024-02-15,삼산체육관,15252,7875,7377
7,2024-02-15,굴포천,21141,10203,10938
7,2024-02-15,부평구청,14712,7473,7239
7,2024-02-15,산곡,21088,10933,10155
7,2024-02-15,석남(거북시장),14100,7556,6544
7,2024-02-16,삼산체육관,12868,6770,6098
7,2024-02-16,굴포천,22212,10837,11375
7,2024-02-16,부평구청,15333,7980,7353
7,2024-02-16,산곡,22383,11733,10650
7,2024-02-16,석남(거북시장),15284,8121,7163
7,2024-02-17,삼산체육관,8954,4684,4270
7,2024-02-17,굴포천,15930,7796,8134
7,2024-02-17,부평구청,10374,5471,4903
7,2024-02-17,산곡,14407,7384,7023
7,2024-02-17,석남(거북시장),11366,5948,5418
7,2024-02-18,삼산체육관,6220,3218,3002
7,2024-02-18,굴포천,10637,5239,5398
7,2024-02-18,부평구청,7342,3890,3452
7,2024-02-18,산곡,9251,4695,4556
7,2024-02-18,석남(거북시장),8002,4255,3747
7,2024-02-19,삼산체육관,11870,6279,5591
7,2024-02-19,굴포천,20172,9978,10194
7,2024-02-19,부평구청,14178,7346,6832
7,2024-02-19,산곡,20980,10900,10080
7,2024-02-19,석남(거북시장),13707,7365,6342
7,2024-02-20,삼산체육관,14463,7493,6970
7,2024-02-20,굴포천,21572,10536,11036
7,2024-02-20,부평구청,14743,7696,7047
7,2024-02-20,산곡,21802,11315,10487
7,2024-02-20,석남(거북시장),14208,7642,6566
7,2024-02-21,삼산체육관,12275,6427,5848
7,2024-02-21,굴포천,20904,10109,10795
7,2024-02-21,부평구청,14584,7491,7093
7,2024-02-21,산곡,21057,10943,10114
7,2024-02-21,석남(거북시장),13812,7367,6445
7,2024-02-22,삼산체육관,13185,6947,6238
7,2024-02-22,굴포천,22278,10959,11319
7,2024-02-22,부평구청,15292,8009,7283
7,2024-02-22,산곡,22613,11842,10771
7,2024-02-22,석남(거북시장),14371,7677,6694
7,2024-02-23,삼산체육관,12483,6659,5824
7,2024-02-23,굴포천,22179,10845,11334
7,2024-02-23,부평구청,15130,7820,7310
7,2024-02-23,산곡,22404,11682,10722
7,2024-02-23,석남(거북시장),15097,8043,7054
7,2024-02-24,삼산체육관,9370,4858,4512
7,2024-02-24,굴포천,16095,7895,8200
7,2024-02-24,부평구청,10120,5354,4766
7,2024-02-24,산곡,14468,7472,6996
7,2024-02-24,석남(거북시장),11386,6035,5351
7,2024-02-25,삼산체육관,6566,3373,3193
7,2024-02-25,굴포천,11079,5617,5462
7,2024-02-25,부평구청,7212,3688,3524
7,2024-02-25,산곡,9732,4907,4825
7,2024-02-25,석남(거북시장),8201,4328,3873
7,2024-02-26,삼산체육관,12129,6451,5678
7,2024-02-26,굴포천,21331,10451,10880
7,2024-02-26,부평구청,14515,7547,6968
7,2024-02-26,산곡,22035,11449,10586
7,2024-02-26,석남(거북시장),14628,7885,6743
7,2024-02-27,삼산체육관,12874,6833,6041
7,2024-02-27,굴포천,21558,10600,10958
7,2024-02-27,부평구청,15120,7817,7303
7,2024-02-27,산곡,22344,11602,10742
7,2024-02-27,석남(거북시장),14978,7997,6981
7,2024-02-28,삼산체육관,12676,6692,5984
7,2024-02-28,굴포천,21800,10711,11089
7,2024-02-28,부평구청,14958,7781,7177
7,2024-02-28,산곡,22389,11683,10706
7,2024-02-28,석남(거북시장),14939,7942,6997
7,2024-02-29,삼산체육관,13127,6970,6157
7,2024-02-29,굴포천,22145,10803,11342
7,2024-02-29,부평구청,14847,7788,7059
7,2024-02-29,산곡,21943,11412,10531
7,2024-02-29,석남(거북시장),15383,8252,7131
7,2024-03-01,삼산체육관,10476,5288,5188
7,2024-03-01,굴포천,13172,6492,6680
7,2024-03-01,부평구청,8267,4322,3945
7,2024-03-01,산곡,11414,5816,5598
7,2024-03-01,석남(거북시장),9740,5071,4669
7,2024-03-02,삼산체육관,7013,3642,3371
7,2024-03-02,굴포천,13517,6668,6849
7,2024-03-02,부평구청,8595,4549,4046
7,2024-03-02,산곡,11869,5993,5876
7,2024-03-02,석남(거북시장),9854,5125,4729
7,2024-03-03,삼산체육관,6032,3139,2893
7,2024-03-03,굴포천,10495,5242,5253
7,2024-03-03,부평구청,7261,3807,3454
7,2024-03-03,산곡,9122,4691,4431
7,2024-03-03,석남(거북시장),8007,4309,3698
7,2024-03-04,삼산체육관,12763,6787,5976
7,2024-03-04,굴포천,21135,10338,10797
7,2024-03-04,부평구청,14783,7620,7163
7,2024-03-04,산곡,22257,11582,10675
7,2024-03-04,석남(거북시장),15572,8349,7223
7,2024-03-05,삼산체육관,13198,6990,6208
7,2024-03-05,굴포천,21212,10303,10909
7,2024-03-05,부평구청,15208,7855,7353
7,2024-03-05,산곡,22595,11756,10839
7,2024-03-05,석남(거북시장),15563,8312,7251
7,2024-03-06,삼산체육관,13534,7140,6394
7,2024-03-06,굴포천,21716,10723,10993
7,2024-03-06,부평구청,15486,7997,7489
7,2024-03-06,산곡,23143,12055,11088
7,2024-03-06,석남(거북시장),15801,8401,7400
7,2024-03-07,삼산체육관,13295,6975,6320
7,2024-03-07,굴포천,21589,10562,11027
7,2024-03-07,부평구청,15335,7828,7507
7,2024-03-07,산곡,22583,11782,10801
7,2024-03-07,석남(거북시장),15244,8148,7096
7,2024-03-08,삼산체육관,13538,7105,6433
7,2024-03-08,굴포천,22368,10927,11441
7,2024-03-08,부평구청,15700,8047,7653
7,2024-03-08,산곡,22837,11909,10928
7,2024-03-08,석남(거북시장),15993,8436,7557
7,2024-03-09,삼산체육관,8979,4685,4294
7,2024-03-09,굴포천,16086,8005,8081
7,2024-03-09,부평구청,10278,5423,4855
7,2024-03-09,산곡,14020,7222,6798
7,2024-03-09,석남(거북시장),11696,6179,5517
7,2024-03-10,삼산체육관,6105,3162,2943
7,2024-03-10,굴포천,10524,5249,5275
7,2024-03-10,부평구청,7419,3909,3510
7,2024-03-10,산곡,9709,4983,4726
7,2024-03-10,석남(거북시장),8468,4535,3933
7,2024-03-11,삼산체육관,12951,6844,6107
7,2024-03-11,굴포천,21132,10378,10754
7,2024-03-11,부평구청,14778,7654,7124
7,2024-03-11,산곡,22816,11911,10905
7,2024-03-11,석남(거북시장),15732,8413,7319
7,2024-03-12,삼산체육관,13247,6982,6265
7,2024-03-12,굴포천,21186,10364,10822
7,2024-03-12,부평구청,14926,7667,7259
7,2024-03-12,산곡,22640,11774,10866
7,2024-03-12,석남(거북시장),15402,8186,7216
7,2024-03-13,삼산체육관,13359,7044,6315
7,2024-03-13,굴포천,21956,10760,11196
7,2024-03-13,부평구청,15179,7759,7420
7,2024-03-13,산곡,23151,12087,11064
7,2024-03-13,석남(거북시장),15884,8486,7398
7,2024-03-14,삼산체육관,13763,7264,6499
7,2024-03-14,굴포천,22118,10821,11297
7,2024-03-14,부평구청,15284,7914,7370
7,2024-03-14,산곡,22964,11912,11052
7,2024-03-14,석남(거북시장),15682,8324,7358
7,2024-03-15,삼산체육관,16434,8551,7883
7,2024-03-15,굴포천,22930,11141,11789
7,2024-03-15,부평구청,15174,7752,7422
7,2024-03-15,산곡,23110,12048,11062
7,2024-03-15,석남(거북시장),16174,8483,7691
7,2024-03-16,삼산체육관,9355,4950,4405
7,2024-03-16,굴포천,16425,8069,8356
7,2024-03-16,부평구청,10419,5465,4954
7,2024-03-16,산곡,14755,7558,7197
7,2024-03-16,석남(거북시장),11946,6215,5731
7,2024-03-17,삼산체육관,6429,3356,3073
7,2024-03-17,굴포천,11193,5611,5582
7,2024-03-17,부평구청,7440,3872,3568
7,2024-03-17,산곡,10016,5105,4911
7,2024-03-17,석남(거북시장),8804,4734,4070
7,2024-03-18,삼산체육관,13005,6905,6100
7,2024-03-18,굴포천,20940,10290,10650
7,2024-03-18,부평구청,14677,7587,7090
7,2024-03-18,산곡,22777,11799,10978
7,2024-03-18,석남(거북시장),15432,8322,7110
7,2024-03-19,삼산체육관,13252,6961,6291
7,2024-03-19,굴포천,21373,10479,10894
7,2024-03-19,부평구청,15118,7863,7255
7,2024-03-19,산곡,22799,11851,10948
7,2024-03-19,석남(거북시장),15254,8171,7083
7,2024-03-20,삼산체육관,13843,7262,6581
7,2024-03-20,굴포천,21723,10760,10963
7,2024-03-20,부평구청,15235,7810,7425
7,2024-03-20,산곡,23315,12166,11149
7,2024-03-20,석남(거북시장),15702,8368,7334
7,2024-03-21,삼산체육관,13660,7140,6520
7,2024-03-21,굴포천,21860,10686,11174
7,2024-03-21,부평구청,15197,7840,7357
7,2024-03-21,산곡,22729,11840,10889
7,2024-03-21,석남(거북시장),15825,8427,7398
7,2024-03-22,삼산체육관,16548,8601,7947
7,2024-03-22,굴포천,22385,10886,11499
7,2024-03-22,부평구청,14964,7698,7266
7,2024-03-22,산곡,22866,11902,10964
7,2024-03-22,석남(거북시장),15974,8468,7506
7,2024-03-23,삼산체육관,9676,5017,4659
7,2024-03-23,굴포천,16364,8096,8268
7,2024-03-23,부평구청,10466,5606,4860
7,2024-03-23,산곡,14536,7529,7007
7,2024-03-23,석남(거북시장),11913,6186,5727
7,2024-03-24,삼산체육관,6695,3464,3231
7,2024-03-24,굴포천,10821,5419,5402
7,2024-03-24,부평구청,7508,4028,3480
7,2024-03-24,산곡,10200,5196,5004
7,2024-03-24,석남(거북시장),8838,4763,4075
7,2024-03-25,삼산체육관,12930,6836,6094
7,2024-03-25,굴포천,21372,10488,10884
7,2024-03-25,부평구청,14476,7556,6920
7,2024-03-25,산곡,22135,11541,10594
7,2024-03-25,석남(거북시장),15057,8111,6946
7,2024-03-26,삼산체육관,16502,8532,7970
7,2024-03-26,굴포천,22060,10769,11291
7,2024-03-26,부평구청,15159,7820,7339
7,2024-03-26,산곡,22892,11896,10996
7,2024-03-26,석남(거북시장),15304,8187,7117
7,2024-03-27,삼산체육관,13834,7322,6512
7,2024-03-27,굴포천,21941,10802,11139
7,2024-03-27,부평구청,15539,8078,7461
7,2024-03-27,산곡,23899,12452,11447
7,2024-03-27,석남(거북시장),15834,8480,7354
7,2024-03-28,삼산체육관,13337,6970,6367
7,2024-03-28,굴포천,21797,10642,11155
7,2024-03-28,부평구청,15039,7692,7347
7,2024-03-28,산곡,22824,11976,10848
7,2024-03-28,석남(거북시장),15045,8030,7015
7,2024-03-29,삼산체육관,13409,7077,6332
7,2024-03-29,굴포천,22028,10772,11256
7,2024-03-29,부평구청,14816,7635,7181
7,2024-03-29,산곡,22411,11733,10678
7,2024-03-29,석남(거북시장),16030,8454,7576
7,2024-03-30,삼산체육관,9171,4749,4422
7,2024-03-30,굴포천,16500,8115,8385
7,2024-03-30,부평구청,10206,5375,4831
7,2024-03-30,산곡,14715,7643,7072
7,2024-03-30,석남(거북시장),12653,6406,6247
7,2024-03-31,삼산체육관,7276,3831,3445
7,2024-03-31,굴포천,11686,5884,5802
7,2024-03-31,부평구청,8067,4281,3786
7,2024-03-31,산곡,10781,5513,5268
7,2024-03-31,석남(거북시장),9652,5222,4430
7,2024-04-01,삼산체육관,17670,9085,8585
7,2024-04-01,굴포천,22325,10895,11430
7,2024-04-01,부평구청,14968,7798,7170
7,2024-04-01,산곡,22933,11989,10944
7,2024-04-01,석남(거북시장),15437,8371,7066
7,2024-04-02,삼산체육관,14095,7461,6634
7,2024-04-02,굴포천,21824,10770,11054
7,2024-04-02,부평구청,15187,7923,7264
7,2024-04-02,산곡,23507,12199,11308
7,2024-04-02,석남(거북시장),15738,8431,7307
7,2024-04-03,삼산체육관,13823,7270,6553
7,2024-04-03,굴포천,21463,10479,10984
7,2024-04-03,부평구청,14950,7760,7190
7,2024-04-03,산곡,23311,12102,11209
7,2024-04-03,석남(거북시장),15659,8327,7332
7,2024-04-04,삼산체육관,14098,7460,6638
7,2024-04-04,굴포천,22377,10988,11389
7,2024-04-04,부평구청,15243,7931,7312
7,2024-04-04,산곡,23680,12405,11275
7,2024-04-04,석남(거북시장),15743,8384,7359
7,2024-04-05,삼산체육관,13896,7313,6583
7,2024-04-05,굴포천,22499,10922,11577
7,2024-04-05,부평구청,15514,8084,7430
7,2024-04-05,산곡,23371,12149,11222
7,2024-04-05,석남(거북시장),16281,8663,7618
7,2024-04-06,삼산체육관,10018,5145,4873
7,2024-04-06,굴포천,17011,8373,8638
7,2024-04-06,부평구청,10966,5811,5155
7,2024-04-06,산곡,15502,8101,7401
7,2024-04-06,석남(거북시장),13092,6866,6226
7,2024-04-07,삼산체육관,7446,3890,3556
7,2024-04-07,굴포천,12690,6243,6447
7,2024-04-07,부평구청,8342,4383,3959
7,2024-04-07,산곡,11086,5681,5405
7,2024-04-07,석남(거북시장),10066,5371,4695
7,2024-04-08,삼산체육관,13576,7202,6374
7,2024-04-08,굴포천,21303,10402,10901
7,2024-04-08,부평구청,14713,7687,7026
7,2024-04-08,산곡,23351,12191,11160
7,2024-04-08,석남(거북시장),15835,8483,7352
7,2024-04-09,삼산체육관,14162,7567,6595
7,2024-04-09,굴포천,22642,11080,11562
7,2024-04-09,부평구청,15509,8090,7419
7,2024-04-09,산곡,23920,12513,11407
7,2024-04-09,석남(거북시장),16589,8797,7792
7,2024-04-10,삼산체육관,7919,4077,3842
7,2024-04-10,굴포천,12887,6401,6486
7,2024-04-10,부평구청,8523,4525,3998
7,2024-04-10,산곡,12187,6255,5932
7,2024-04-10,석남(거북시장),9705,5058,4647
7,2024-04-11,삼산체육관,13621,7179,6442
7,2024-04-11,굴포천,21303,10474,10829
7,2024-04-11,부평구청,14780,7650,7130
7,2024-04-11,산곡,22770,11835,10935
7,2024-04-11,석남(거북시장),15298,8237,7061
7,2024-04-12,삼산체육관,13796,7275,6521
7,2024-04-12,굴포천,22320,10935,11385
7,2024-04-12,부평구청,15217,7893,7324
7,2024-04-12,산곡,23301,12085,11216
7,2024-04-12,석남(거북시장),16011,8471,7540
7,2024-04-13,삼산체육관,9457,4923,4534
7,2024-04-13,굴포천,16200,8111,8089
7,2024-04-13,부평구청,10480,5563,4917
7,2024-04-13,산곡,14912,7699,7213
7,2024-04-13,석남(거북시장),11922,6219,5703
7,2024-04-14,삼산체육관,6604,3465,3139
7,2024-04-14,굴포천,10496,5268,5228
7,2024-04-14,부평구청,7837,4090,3747
7,2024-04-14,산곡,10141,5172,4969
7,2024-04-14,석남(거북시장),8819,4673,4146
7,2024-04-15,삼산체육관,12707,6726,5981
7,2024-04-15,굴포천,20375,9967,10408
7,2024-04-15,부평구청,13726,7114,6612
7,2024-04-15,산곡,21722,11283,10439
7,2024-04-15,석남(거북시장),14516,7728,6788
7,2024-04-16,삼산체육관,13849,7243,6606
7,2024-04-16,굴포천,21694,10623,11071
7,2024-04-16,부평구청,15091,7810,7281
7,2024-04-16,산곡,23021,11989,11032
7,2024-04-16,석남(거북시장),15321,8240,7081
7,2024-04-17,삼산체육관,14085,7426,6659
7,2024-04-17,굴포천,21989,10833,11156
7,2024-04-17,부평구청,15273,7894,7379
7,2024-04-17,산곡,23656,12305,11351
7,2024-04-17,석남(거북시장),15710,8373,7337
7,2024-04-18,삼산체육관,13807,7266,6541
7,2024-04-18,굴포천,21952,10737,11215
7,2024-04-18,부평구청,15385,7956,7429
7,2024-04-18,산곡,23258,12107,11151
7,2024-04-18,석남(거북시장),15654,8391,7263
7,2024-04-19,삼산체육관,13672,7251,6421
7,2024-04-19,굴포천,22419,10936,11483
7,2024-04-19,부평구청,15588,8113,7475
7,2024-04-19,산곡,23470,12232,11238
7,2024-04-19,석남(거북시장),15882,8432,7450
7,2024-04-20,삼산체육관,8362,4313,4049
7,2024-04-20,굴포천,15225,7479,7746
7,2024-04-20,부평구청,9675,5115,4560
7,2024-04-20,산곡,13077,6742,6335
7,2024-04-20,석남(거북시장),10799,5631,5168
7,2024-04-21,삼산체육관,6198,3220,2978
7,2024-04-21,굴포천,11016,5493,5523
7,2024-04-21,부평구청,7498,3967,3531
7,2024-04-21,산곡,9751,4964,4787
7,2024-04-21,석남(거북시장),8681,4575,4106
7,2024-04-22,삼산체육관,13608,7225,6383
7,2024-04-22,굴포천,21117,10338,10779
7,2024-04-22,부평구청,14614,7537,7077
7,2024-04-22,산곡,22736,11861,10875
7,2024-04-22,석남(거북시장),15200,8141,7059
7,2024-04-23,삼산체육관,13667,7166,6501
7,2024-04-23,굴포천,21780,10672,11108
7,2024-04-23,부평구청,15356,7955,7401
7,2024-04-23,산곡,23462,12150,11312
7,2024-04-23,석남(거북시장),15466,8265,7201
7,2024-04-24,삼산체육관,13221,6928,6293
7,2024-04-24,굴포천,21326,10375,10951
7,2024-04-24,부평구청,15034,7801,7233
7,2024-04-24,산곡,22738,11766,10972
7,2024-04-24,석남(거북시장),15159,8133,7026
7,2024-04-25,삼산체육관,13844,7273,6571
7,2024-04-25,굴포천,21981,10744,11237
7,2024-04-25,부평구청,15271,7918,7353
7,2024-04-25,산곡,23340,12192,11148
7,2024-04-25,석남(거북시장),15598,8294,7304
7,2024-04-26,삼산체육관,13692,7311,6381
7,2024-04-26,굴포천,22472,11002,11470
7,2024-04-26,부평구청,15854,8256,7598
7,2024-04-26,산곡,23658,12341,11317
7,2024-04-26,석남(거북시장),16155,8534,7621
7,2024-04-27,삼산체육관,10079,5272,4807
7,2024-04-27,굴포천,16680,8265,8415
7,2024-04-27,부평구청,10832,5690,5142
7,2024-04-27,산곡,15234,7959,7275
7,2024-04-27,석남(거북시장),11913,6201,5712
7,2024-04-28,삼산체육관,6674,3520,3154
7,2024-04-28,굴포천,11251,5714,5537
7,2024-04-28,부평구청,7759,4078,3681
7,2024-04-28,산곡,10532,5348,5184
7,2024-04-28,석남(거북시장),8929,4811,4118
7,2024-04-29,삼산체육관,13310,7032,6278
7,2024-04-29,굴포천,21295,10468,10827
7,2024-04-29,부평구청,14745,7657,7088
7,2024-04-29,산곡,22932,11937,10995
7,2024-04-29,석남(거북시장),15508,8348,7160
7,2024-04-30,삼산체육관,13914,7459,6455
7,2024-04-30,굴포천,22377,11026,11351
7,2024-04-30,부평구청,15818,8213,7605
7,2024-04-30,산곡,23923,12502,11421
7,2024-04-30,석남(거북시장),16151,8648,7503
7,2024-05-01,삼산체육관,9096,4744,4352
7,2024-05-01,굴포천,14506,7141,7365
7,2024-05-01,부평구청,10116,5228,4888
7,2024-05-01,산곡,14450,7396,7054
7,2024-05-01,석남(거북시장),10717,5686,5031
7,2024-05-02,삼산체육관,13802,7244,6558
7,2024-05-02,굴포천,21629,10565,11064
7,2024-05-02,부평구청,15389,7892,7497
7,2024-05-02,산곡,23778,12364,11414
7,2024-05-02,석남(거북시장),15507,8317,7190
7,2024-05-03,삼산체육관,14632,7720,6912
7,2024-05-03,굴포천,22343,10953,11390
7,2024-05-03,부평구청,15708,8023,7685
7,2024-05-03,산곡,23725,12322,11403
7,2024-05-03,석남(거북시장),16328,8666,7662
7,2024-05-04,삼산체육관,9246,4857,4389
7,2024-05-04,굴포천,15202,7515,7687
7,2024-05-04,부평구청,9886,5190,4696
7,2024-05-04,산곡,13916,7232,6684
7,2024-05-04,석남(거북시장),11379,5937,5442
7,2024-05-05,삼산체육관,5657,2895,2762
7,2024-05-05,굴포천,9728,4714,5014
7,2024-05-05,부평구청,6368,3365,3003
7,2024-05-05,산곡,8095,4114,3981
7,2024-05-05,석남(거북시장),7465,3924,3541
7,2024-05-06,삼산체육관,6032,3172,2860
7,2024-05-06,굴포천,10634,5316,5318
7,2024-05-06,부평구청,6745,3537,3208
7,2024-05-06,산곡,9267,4797,4470
7,2024-05-06,석남(거북시장),8193,4453,3740
7,2024-05-07,삼산체육관,13462,7140,6322
7,2024-05-07,굴포천,21274,10395,10879
7,2024-05-07,부평구청,15034,7765,7269
7,2024-05-07,산곡,22861,11925,10936
7,2024-05-07,석남(거북시장),15079,8140,6939
7,2024-05-08,삼산체육관,14017,7461,6556
7,2024-05-08,굴포천,22401,10940,11461
7,2024-05-08,부평구청,15733,8132,7601
7,2024-05-08,산곡,23597,12287,11310
7,2024-05-08,석남(거북시장),15969,8496,7473
7,2024-05-09,삼산체육관,13980,7377,6603
7,2024-05-09,굴포천,21918,10819,11099
7,2024-05-09,부평구청,15407,7938,7469
7,2024-05-09,산곡,23817,12349,11468
7,2024-05-09,석남(거북시장),15913,8531,7382
7,2024-05-10,삼산체육관,14508,7704,6804
7,2024-05-10,굴포천,22833,11155,11678
7,2024-05-10,부평구청,16080,8282,7798
7,2024-05-10,산곡,24003,12438,11565
7,2024-05-10,석남(거북시장),16523,8764,7759
7,2024-05-11,삼산체육관,8712,4451,4261
7,2024-05-11,굴포천,14977,7441,7536
7,2024-05-11,부평구청,9923,5285,4638
7,2024-05-11,산곡,13327,6857,6470
7,2024-05-11,석남(거북시장),11112,5810,5302
7,2024-05-12,삼산체육관,6904,3652,3252
7,2024-05-12,굴포천,11047,5541,5506
7,2024-05-12,부평구청,7932,4205,3727
7,2024-05-12,산곡,10445,5341,5104
7,2024-05-12,석남(거북시장),8862,4825,4037
7,2024-05-13,삼산체육관,13766,7264,6502
7,2024-05-13,굴포천,21407,10542,10865
7,2024-05-13,부평구청,15040,7695,7345
7,2024-05-13,산곡,23344,12151,11193
7,2024-05-13,석남(거북시장),15504,8276,7228
7,2024-05-14,삼산체육관,14117,7516,6601
7,2024-05-14,굴포천,22548,11096,11452
7,2024-05-14,부평구청,15993,8295,7698
7,2024-05-14,산곡,24066,12650,11416
7,2024-05-14,석남(거북시장),16435,8827,7608
7,2024-05-15,삼산체육관,6757,3500,3257
7,2024-05-15,굴포천,11358,5527,5831
7,2024-05-15,부평구청,7460,3919,3541
7,2024-05-15,산곡,10499,5316,5183
7,2024-05-15,석남(거북시장),8313,4333,3980
7,2024-05-16,삼산체육관,14134,7443,6691
7,2024-05-16,굴포천,21923,10733,11190
7,2024-05-16,부평구청,15502,8025,7477
7,2024-05-16,산곡,23507,12148,11359
7,2024-05-16,석남(거북시장),15779,8483,7296
7,2024-05-17,삼산체육관,15292,7981,7311
7,2024-05-17,굴포천,22507,10986,11521
7,2024-05-17,부평구청,15856,8190,7666
7,2024-05-17,산곡,23763,12364,11399
7,2024-05-17,석남(거북시장),16513,8671,7842
7,2024-05-18,삼산체육관,9731,5131,4600
7,2024-05-18,굴포천,16480,8139,8341
7,2024-05-18,부평구청,10890,5728,5162
7,2024-05-18,산곡,14861,7678,7183
7,2024-05-18,석남(거북시장),12098,6410,5688
7,2024-05-19,삼산체육관,7191,3776,3415
7,2024-05-19,굴포천,11369,5653,5716
7,2024-05-19,부평구청,7875,4179,3696
7,2024-05-19,산곡,10546,5365,5181
7,2024-05-19,석남(거북시장),9171,4928,4243
7,2024-05-20,삼산체육관,13329,7023,6306
7,2024-05-20,굴포천,21092,10345,10747
7,2024-05-20,부평구청,14653,7654,6999
7,2024-05-20,산곡,23063,11977,11086
7,2024-05-20,석남(거북시장),15371,8303,7068
7,2024-05-21,삼산체육관,14388,7510,6878
7,2024-05-21,굴포천,22053,10862,11191
7,2024-05-21,부평구청,15553,7993,7560
7,2024-05-21,산곡,23834,12267,11567
7,2024-05-21,석남(거북시장),15346,8196,7150
7,2024-05-22,삼산체육관,14137,7466,6671
7,2024-05-22,굴포천,21602,10604,10998
7,2024-05-22,부평구청,15582,8042,7540
7,2024-05-22,산곡,23372,12118,11254
7,2024-05-22,석남(거북시장),15537,8310,7227
7,2024-05-23,삼산체육관,14437,7547,6890
7,2024-05-23,굴포천,21804,10717,11087
7,2024-05-23,부평구청,15649,8028,7621
7,2024-05-23,산곡,23401,12213,11188
7,2024-05-23,석남(거북시장),15681,8430,7251
7,2024-05-24,삼산체육관,18612,9708,8904
7,2024-05-24,굴포천,22327,10840,11487
7,2024-05-24,부평구청,16685,8658,8027
7,2024-05-24,산곡,24283,12631,11652
7,2024-05-24,석남(거북시장),16077,8563,7514
7,2024-05-25,삼산체육관,10634,5557,5077
7,2024-05-25,굴포천,16437,8078,8359
7,2024-05-25,부평구청,10994,5730,5264
7,2024-05-25,산곡,15171,7858,7313
7,2024-05-25,석남(거북시장),12339,6419,5920
7,2024-05-26,삼산체육관,6448,3310,3138
7,2024-05-26,굴포천,10739,5372,5367
7,2024-05-26,부평구청,7059,3733,3326
7,2024-05-26,산곡,9354,4790,4564
7,2024-05-26,석남(거북시장),8429,4443,3986
7,2024-05-27,삼산체육관,13385,7083,6302
7,2024-05-27,굴포천,21165,10426,10739
7,2024-05-27,부평구청,14914,7703,7211
7,2024-05-27,산곡,23052,12021,11031
7,2024-05-27,석남(거북시장),15336,8300,7036
7,2024-05-28,삼산체육관,14352,7508,6844
7,2024-05-28,굴포천,21801,10659,11142
7,2024-05-28,부평구청,15810,8199,7611
7,2024-05-28,산곡,23717,12385,11332
7,2024-05-28,석남(거북시장),15398,8276,7122
7,2024-05-29,삼산체육관,14122,7502,6620
7,2024-05-29,굴포천,21863,10774,11089
7,2024-05-29,부평구청,15353,7957,7396
7,2024-05-29,산곡,23706,12423,11283
7,2024-05-29,석남(거북시장),15996,8484,7512
7,2024-05-30,삼산체육관,14170,7547,6623
7,2024-05-30,굴포천,21860,10752,11108
7,2024-05-30,부평구청,15543,8044,7499
7,2024-05-30,산곡,23146,12008,11138
7,2024-05-30,석남(거북시장),15481,8205,7276
7,2024-05-31,삼산체육관,13998,7403,6595
7,2024-05-31,굴포천,22200,10849,11351
7,2024-05-31,부평구청,15409,7938,7471
7,2024-05-31,산곡,23298,12136,11162
7,2024-05-31,석남(거북시장),16262,8626,7636
7,2024-06-01,삼산체육관,9720,5054,4666
7,2024-06-01,굴포천,15606,7697,7909
7,2024-06-01,부평구청,10779,5708,5071
7,2024-06-01,산곡,14379,7492,6887
7,2024-06-01,석남(거북시장),11955,6275,5680
7,2024-06-02,삼산체육관,6573,3391,3182
7,2024-06-02,굴포천,11103,5523,5580
7,2024-06-02,부평구청,7549,3944,3605
7,2024-06-02,산곡,10371,5253,5118
7,2024-06-02,석남(거북시장),8730,4687,4043
7,2024-06-03,삼산체육관,13619,7146,6473
7,2024-06-03,굴포천,21228,10439,10789
7,2024-06-03,부평구청,14795,7708,7087
7,2024-06-03,산곡,23071,11999,11072
7,2024-06-03,석남(거북시장),15519,8300,7219
7,2024-06-04,삼산체육관,13968,7400,6568
7,2024-06-04,굴포천,21541,10561,10980
7,2024-06-04,부평구청,15451,7962,7489
7,2024-06-04,산곡,23522,12246,11276
7,2024-06-04,석남(거북시장),15488,8276,7212
7,2024-06-05,삼산체육관,15340,8327,7013
7,2024-06-05,굴포천,22290,10954,11336
7,2024-06-05,부평구청,15799,8235,7564
7,2024-06-05,산곡,23910,12546,11364
7,2024-06-05,석남(거북시장),16517,8728,7789
7,2024-06-06,삼산체육관,7431,3841,3590
7,2024-06-06,굴포천,12051,5966,6085
7,2024-06-06,부평구청,8292,4361,3931
7,2024-06-06,산곡,11344,5877,5467
7,2024-06-06,석남(거북시장),9403,4918,4485
7,2024-06-07,삼산체육관,12699,6662,6037
7,2024-06-07,굴포천,20281,9843,10438
7,2024-06-07,부평구청,13995,7221,6774
7,2024-06-07,산곡,20640,10656,9984
7,2024-06-07,석남(거북시장),14736,7837,6899
7,2024-06-08,삼산체육관,8200,4253,3947
7,2024-06-08,굴포천,13814,6821,6993
7,2024-06-08,부평구청,9278,4896,4382
7,2024-06-08,산곡,12589,6442,6147
7,2024-06-08,석남(거북시장),10791,5573,5218
7,2024-06-09,삼산체육관,6924,3551,3373
7,2024-06-09,굴포천,10284,5113,5171
7,2024-06-09,부평구청,7366,3930,3436
7,2024-06-09,산곡,9543,4844,4699
7,2024-06-09,석남(거북시장),8772,4700,4072
7,2024-06-10,삼산체육관,13272,6985,6287
7,2024-06-10,굴포천,21301,10414,10887
7,2024-06-10,부평구청,15038,7724,7314
7,2024-06-10,산곡,22957,11877,11080
7,2024-06-10,석남(거북시장),15513,8317,7196
7,2024-06-11,삼산체육관,13750,7216,6534
7,2024-06-11,굴포천,21463,10594,10869
7,2024-06-11,부평구청,15335,7900,7435
7,2024-06-11,산곡,23508,12256,11252
7,2024-06-11,석남(거북시장),15487,8271,7216
7,2024-06-12,삼산체육관,13849,7331,6518
7,2024-06-12,굴포천,21668,10691,10977
7,2024-06-12,부평구청,15400,7891,7509
7,2024-06-12,산곡,23397,12105,11292
7,2024-06-12,석남(거북시장),15601,8300,7301
7,2024-06-13,삼산체육관,13985,7394,6591
7,2024-06-13,굴포천,21401,10467,10934
7,2024-06-13,부평구청,15321,7897,7424
7,2024-06-13,산곡,23240,12058,11182
7,2024-06-13,석남(거북시장),15735,8413,7322
7,2024-06-14,삼산체육관,13482,7197,6285
7,2024-06-14,굴포천,21847,10700,11147
7,2024-06-14,부평구청,15415,7930,7485
7,2024-06-14,산곡,23329,12156,11173
7,2024-06-14,석남(거북시장),16178,8494,7684
7,2024-06-15,삼산체육관,9262,4807,4455
7,2024-06-15,굴포천,15798,7799,7999
7,2024-06-15,부평구청,10255,5501,4754
7,2024-06-15,산곡,14009,7159,6850
7,2024-06-15,석남(거북시장),11461,5991,5470
7,2024-06-16,삼산체육관,6423,3365,3058
7,2024-06-16,굴포천,10755,5355,5400
7,2024-06-16,부평구청,7436,3861,3575
7,2024-06-16,산곡,10085,5120,4965
7,2024-06-16,석남(거북시장),8666,4551,4115
7,2024-06-17,삼산체육관,13210,6980,6230
7,2024-06-17,굴포천,20791,10268,10523
7,2024-06-17,부평구청,14578,7545,7033
7,2024-06-17,산곡,22605,11721,10884
7,2024-06-17,석남(거북시장),15312,8231,7081
7,2024-06-18,삼산체육관,13338,7022,6316
7,2024-06-18,굴포천,21116,10314,10802
7,2024-06-18,부평구청,15256,7889,7367
7,2024-06-18,산곡,23141,12055,11086
7,2024-06-18,석남(거북시장),15371,8255,7116
7,2024-06-19,삼산체육관,13994,7342,6652
7,2024-06-19,굴포천,21403,10478,10925
7,2024-06-19,부평구청,15330,7929,7401
7,2024-06-19,산곡,22903,11797,11106
7,2024-06-19,석남(거북시장),15580,8311,7269
7,2024-06-20,삼산체육관,13819,7231,6588
7,2024-06-20,굴포천,21325,10501,10824
7,2024-06-20,부평구청,15184,7765,7419
7,2024-06-20,산곡,22906,11924,10982
7,2024-06-20,석남(거북시장),15540,8297,7243
7,2024-06-21,삼산체육관,13948,7343,6605
7,2024-06-21,굴포천,21607,10589,11018
7,2024-06-21,부평구청,15341,7972,7369
7,2024-06-21,산곡,22950,11945,11005
7,2024-06-21,석남(거북시장),16000,8445,7555
7,2024-06-22,삼산체육관,11344,5864,5480
7,2024-06-22,굴포천,14490,7174,7316
7,2024-06-22,부평구청,9720,5100,4620
7,2024-06-22,산곡,12987,6747,6240
7,2024-06-22,석남(거북시장),11103,5752,5351
7,2024-06-23,삼산체육관,8794,4581,4213
7,2024-06-23,굴포천,10423,5232,5191
7,2024-06-23,부평구청,7318,3888,3430
7,2024-06-23,산곡,9949,5013,4936
7,2024-06-23,석남(거북시장),8569,4561,4008
7,2024-06-24,삼산체육관,12991,6801,6190
7,2024-06-24,굴포천,20884,10225,10659
7,2024-06-24,부평구청,14759,7605,7154
7,2024-06-24,산곡,22383,11646,10737
7,2024-06-24,석남(거북시장),15124,8129,6995
7,2024-06-25,삼산체육관,13365,7069,6296
7,2024-06-25,굴포천,21331,10563,10768
7,2024-06-25,부평구청,15070,7803,7267
7,2024-06-25,산곡,23161,12051,11110
7,2024-06-25,석남(거북시장),15121,8070,7051
7,2024-06-26,삼산체육관,13732,7225,6507
7,2024-06-26,굴포천,21453,10509,10944
7,2024-06-26,부평구청,15084,7798,7286
7,2024-06-26,산곡,22946,11920,11026
7,2024-06-26,석남(거북시장),15327,8153,7174
7,2024-06-27,삼산체육관,13699,7180,6519
7,2024-06-27,굴포천,21634,10650,10984
7,2024-06-27,부평구청,15030,7793,7237
7,2024-06-27,산곡,22726,11832,10894
7,2024-06-27,석남(거북시장),15058,8107,6951
7,2024-06-28,삼산체육관,13676,7281,6395
7,2024-06-28,굴포천,22039,10834,11205
7,2024-06-28,부평구청,15356,7933,7423
7,2024-06-28,산곡,22877,11920,10957
7,2024-06-28,석남(거북시장),15989,8505,7484
7,2024-06-29,삼산체육관,9358,4791,4567
7,2024-06-29,굴포천,14903,7351,7552
7,2024-06-29,부평구청,9859,5165,4694
7,2024-06-29,산곡,13412,6856,6556
7,2024-06-29,석남(거북시장),11257,5958,5299
7,2024-06-30,삼산체육관,5477,2824,2653
7,2024-06-30,굴포천,9792,4853,4939
7,2024-06-30,부평구청,6592,3508,3084
7,2024-06-30,산곡,8687,4441,4246
7,2024-06-30,석남(거북시장),7693,3996,3697
